ELECTION;TYPE;ANNEE;TOUR;CODE_CIRCONSCRIPTION;CIRCONSCRIPTION;CODE_COMMUNE;COMMUNE;CODE_INSEE;INSCRITS;ABSTENTIONS;VOTANTS;BLANCS_ET_NULS;EXPRIMES;CANDIDAT_OU_LISTE;SEXE;NOM;PRENOM;CODE_NUANCE;VOIX
Législatives 1997 - 2ème tour;Législatives;1997;2;8;8ème circonscription;48;MEUDON;92048;24248;7258;16990;824;16166;LEVAIN JEAN;M;LEVAIN;JEAN;PRS;7311
Législatives 1993 - 1er tour;Législatives;1993;1;2;2ème circonscription;4;ASNIERES SUR SEINE;92004;37314;11544;25770;852;24918;VIDAL VINCENT;M;VIDAL;VINCENT;DVD;281
Législatives 1997 - 1er tour;Législatives;1997;1;10;10ème circonscription;48;MEUDON;92048;4118;1375;2743;67;2676;CRETET PHILIPPE;M;CRETET;PHILIPPE;EXG;15
Législatives 1993 - 1er tour;Législatives;1993;1;13;13ème circonscription;71;SCEAUX;92071;13127;3574;9553;306;9247;ROSNER ADRIAN;M;ROSNER;ADRIAN;GEC;914
Législatives 1993 - 1er tour;Législatives;1993;1;10;10ème circonscription;12;BOULOGNE BILLANCOURT;92012;4523;1581;2942;133;2809;BITON MARLENE;F;BITON;MARLENE;SOC;477
Législatives 1993 - 1er tour;Législatives;1993;1;7;7ème circonscription;33;GARCHES;92033;11440;3330;8110;328;7782;PACOURET J.RAYMOND;M;PACOURET;J.RAYMOND;COM;297
Législatives 1997 - 1er tour;Législatives;1997;1;12;12ème circonscription;60;LE PLESSIS ROBINSON;92060;13002;3860;9142;204;8938;FOUCHER J.PIERRE;M;FOUCHER;J.PIERRE;UDF;616
Législatives 1993 - 1er tour;Législatives;1993;1;10;10ème circonscription;40;ISSY LES MOULINEAUX;92040;29377;9425;19952;648;19304;LARDOUX BRUNO;M;LARDOUX;BRUNO;EXG;119
Législatives 1993 - 1er tour;Législatives;1993;1;11;11ème circonscription;46;MALAKOFF;92046;19559;6951;12608;416;12192;MACHEREY MONIQUE;F;MACHEREY;MONIQUE;GEC;946
Législatives 1993 - 1er tour;Législatives;1993;1;8;8ème circonscription;47;MARNES LA COQUETTE;92047;1006;246;760;21;739;SUCHIER ANDRE;M;SUCHIER;ANDRE;DIV;24
Législatives 1993 - 1er tour;Législatives;1993;1;8;8ème circonscription;48;MEUDON;92048;25126;7628;17498;529;16969;WOLF HENRY;M;WOLF;HENRY;UDF;4094
Législatives 1997 - 1er tour;Législatives;1997;1;9;9ème circonscription;12;BOULOGNE BILLANCOURT;92012;53287;18902;34385;948;33437;TRIPON CATHERINE;F;TRIPON;CATHERINE;DVD;134
Législatives 1997 - 1er tour;Législatives;1997;1;5;5ème circonscription;44;LEVALLOIS PERRET;92044;28281;9315;18966;650;18316;SEMOUN J.JACQUES;M;SEMOUN;J.JACQUES;DVD;200
Législatives 1997 - 1er tour;Législatives;1997;1;8;8ème circonscription;47;MARNES LA COQUETTE;92047;985;289;696;19;677;AMSALLEM EDDY;M;AMSALLEM;EDDY;EXG;8
Législatives 2002 - 1er tour;Législatives;2002;1;10;10ème circonscription;12;BOULOGNE BILLANCOURT;92012;5551;2367;3184;78;3106;BINDER Sabrina;F;BINDER;Sabrina;DIV;12
Législatives 2002 - 1er tour;Législatives;2002;1;13;13ème circonscription;14;BOURG LA REINE;92014;13381;4391;8990;78;8912;GOURDOL Aimée;F;GOURDOL;Aimée;DVG;79
Législatives 2002 - 1er tour;Législatives;2002;1;2;2ème circonscription;25;COLOMBES;92025;18336;7144;11192;207;10985;VILLIERS Claire;F;VILLIERS;Claire;EXG;356
Législatives 2002 - 1er tour;Législatives;2002;1;3;3ème circonscription;26;COURBEVOIE;92026;49151;19345;29806;541;29265;RAGOT Jean-Louis;M;RAGOT;Jean-Louis;UDFD;3074
Législatives 2002 - 1er tour;Législatives;2002;1;3;3ème circonscription;26;COURBEVOIE;92026;49151;19345;29806;541;29265;CARILLON Rémi;M;CARILLON;Rémi;FN;832
Législatives 2002 - 1er tour;Législatives;2002;1;3;3ème circonscription;35;LA GARENNE COLOMBES;92035;16552;5947;10605;101;10504;CARILLON Rémi;M;CARILLON;Rémi;FN;329
Législatives 2002 - 1er tour;Législatives;2002;1;1;1ère circonscription;36;GENNEVILLIERS;92036;20048;9522;10526;189;10337;POURDIEU Stéphanie;F;POURDIEU;Stéphanie;MAJ;22
Législatives 2002 - 1er tour;Législatives;2002;1;8;8ème circonscription;47;MARNES LA COQUETTE;92047;1074;316;758;5;753;ROY Caroline;F;ROY;Caroline;RDG;71
Législatives 2002 - 1er tour;Législatives;2002;1;11;11ème circonscription;49;MONTROUGE;92049;26595;9698;16897;213;16684;SAUVANAUD Juliette;F;SAUVANAUD;Juliette;EXG;58
Législatives 2002 - 1er tour;Législatives;2002;1;6;6ème circonscription;51;NEUILLY SUR SEINE;92051;39134;14738;24396;185;24211;CORTI Martine;F;CORTI;Martine;ECO;123
Législatives 2002 - 1er tour;Législatives;2002;1;13;13ème circonscription;71;SCEAUX;92071;14129;4679;9450;74;9376;DEVEDJIAN Patrick;M;DEVEDJIAN;Patrick;UMP;4344
Législatives 1997 - 2ème tour;Législatives;1997;2;8;8ème circonscription;48;MEUDON;92048;24248;7258;16990;824;16166;GUILLET J.JACQUES;M;GUILLET;J.JACQUES;RPR;8855
Législatives 1997 - 1er tour;Législatives;1997;1;10;10ème circonscription;40;ISSY LES MOULINEAUX;92040;30164;10899;19265;543;18722;BELLAIRE VALERIE;F;BELLAIRE;VALERIE;DIV;1
Législatives 1997 - 1er tour;Législatives;1997;1;10;10ème circonscription;40;ISSY LES MOULINEAUX;92040;30164;10899;19265;543;18722;LOUSTAU AXEL;M;LOUSTAU;AXEL;FRN;1976
Législatives 1997 - 1er tour;Législatives;1997;1;1;1ère circonscription;36;GENNEVILLIERS;92036;19277;7226;12051;295;11756;LECLERCQ ARNAUD;M;LECLERCQ;ARNAUD;DVD;65
Législatives 2012 - 1er tour;Législatives;2012;1;11;11ème circonscription;7;BAGNEUX;92007;20609;9648;10961;145;10816;HAUJARD Sébastien;M;HAUJARD;Sébastien;DVD;18
Législatives 2017 - 1er tour;Législatives;2017;1;1;1ère circonscription;36;GENNEVILLIERS;92036;22174;13223;8951;243;8708;BONNEFOND Olivier;M;BONNEFOND;Olivier;DVD;202
Législatives 2017 - 1er tour;Législatives;2017;1;1;1ère circonscription;25;COLOMBES;92025;27867;16420;11447;405;11042;FRONTIGNY Nadia;F;FRONTIGNY;Nadia;LR;1382
Législatives 2017 - 1er tour;Législatives;2017;1;1;1ère circonscription;25;COLOMBES;92025;27867;16420;11447;405;11042;DJELLAB Nora;F;DJELLAB;Nora;DVD;287
Législatives 2017 - 1er tour;Législatives;2017;1;1;1ère circonscription;25;COLOMBES;92025;27867;16420;11447;405;11042;ANOU Tommy;M;ANOU;Tommy;FN;784
Législatives 2017 - 1er tour;Législatives;2017;1;6;6ème circonscription;51;NEUILLY SUR SEINE;92051;37215;15249;21966;119;21847;KARSENTY Philippe;M;KARSENTY;Philippe;DVD;1444
Législatives 2017 - 1er tour;Législatives;2017;1;6;6ème circonscription;62;PUTEAUX;92062;28983;11794;17189;436;16753;CUIGNET Emmanuelle;F;CUIGNET;Emmanuelle;FN;937
Législatives 2017 - 1er tour;Législatives;2017;1;3;3ème circonscription;35;LA GARENNE COLOMBES;92035;18829;8238;10591;114;10477;FOURNET Arnaud;M;FOURNET;Arnaud;EXD;32
Législatives 2017 - 1er tour;Législatives;2017;1;5;5ème circonscription;44;LEVALLOIS PERRET;92044;41751;17632;24119;255;23864;BEAUDOIN Franck;M;BEAUDOIN;Franck;DIV;91
Législatives 2017 - 1er tour;Législatives;2017;1;5;5ème circonscription;24;CLICHY;92024;28620;14628;13992;265;13727;LAMBERT Mireille;F;LAMBERT;Mireille;EXG;163
Législatives 2017 - 1er tour;Législatives;2017;1;4;4ème circonscription;73;SURESNES;92073;28524;12725;15799;423;15376;SALLES Laurent;M;SALLES;Laurent;FN;855
Législatives 2017 - 1er tour;Législatives;2017;1;4;4ème circonscription;73;SURESNES;92073;28524;12725;15799;423;15376;ROBIN Joey;M;ROBIN;Joey;DIV;136
Législatives 2017 - 1er tour;Législatives;2017;1;3;3ème circonscription;26;COURBEVOIE;92026;44322;19890;24432;415;24017;COURMONT Chloé;F;COURMONT;Chloé;COM;135
Législatives 2017 - 1er tour;Législatives;2017;1;3;3ème circonscription;26;COURBEVOIE;92026;44322;19890;24432;415;24017;FOURNET Arnaud;M;FOURNET;Arnaud;EXD;68
Législatives 2017 - 1er tour;Législatives;2017;1;4;4ème circonscription;50;NANTERRE;92050;47651;26455;21196;432;20764;MARTIN Alexis;M;MARTIN;Alexis;ECO;711
Législatives 2017 - 1er tour;Législatives;2017;1;5;5ème circonscription;44;LEVALLOIS PERRET;92044;41751;17632;24119;255;23864;BIEUVILLE François-Xavier;M;BIEUVILLE;François-Xavier;DVD;4499
Législatives 2017 - 1er tour;Législatives;2017;1;10;10ème circonscription;75;VANVES;92075;18507;7626;10881;125;10756;SOUBELET Bertrand;M;SOUBELET;Bertrand;DIV;438
Législatives 2017 - 1er tour;Législatives;2017;1;11;11ème circonscription;7;BAGNEUX;92007;21911;12424;9487;167;9320;TAUTHUI Stéphane;M;TAUTHUI;Stéphane;DVD;24
Législatives 2017 - 1er tour;Législatives;2017;1;11;11ème circonscription;49;MONTROUGE;92049;28914;12071;16843;175;16668;PARAIN Philippe;M;PARAIN;Philippe;UDI;2476
Législatives 2017 - 1er tour;Législatives;2017;1;12;12ème circonscription;23;CLAMART;92023;35342;15954;19388;238;19150;YVENAT Damien;M;YVENAT;Damien;FN;824
Législatives 2017 - 1er tour;Législatives;2017;1;12;12ème circonscription;32;FONTENAY AUX ROSES;92032;16049;7756;8293;93;8200;BAHLOUL Madeleine;F;BAHLOUL;Madeleine;FI;884
Législatives 2017 - 1er tour;Législatives;2017;1;12;12ème circonscription;32;FONTENAY AUX ROSES;92032;16049;7756;8293;93;8200;GARCIA-BADIN Théo;M;GARCIA-BADIN;Théo;ECO;344
Législatives 2017 - 1er tour;Législatives;2017;1;13;13ème circonscription;14;BOURG LA REINE;92014;13736;5356;8380;81;8299;YANEZ Jérôme;M;YANEZ;Jérôme;DIV;56
Législatives 2017 - 1er tour;Législatives;2017;1;13;13ème circonscription;19;CHATENAY MALABRY;92019;18752;8166;10586;245;10341;SIFFREDI Georges;M;SIFFREDI;Georges;LR;3269
Législatives 2017 - 2ème tour;Législatives;2017;2;10;10ème circonscription;48;MEUDON;92048;6011;3166;2845;253;2592;COSTE Jeremy;M;COSTE;Jeremy;UDI;901
Législatives 2017 - 2ème tour;Législatives;2017;2;11;11ème circonscription;46;MALAKOFF;92046;18448;9121;9327;443;8884;ROSSI Laurianne;F;ROSSI;Laurianne;REM;3817
Législatives 2017 - 1er tour;Législatives;2017;1;8;8ème circonscription;47;MARNES LA COQUETTE;92047;1215;451;764;4;760;PAILLARD Christophe;M;PAILLARD;Christophe;DVD;5
Législatives 2017 - 1er tour;Législatives;2017;1;8;8ème circonscription;77;VILLE D'AVRAY;92077;7440;2857;4583;44;4539;SCHNEIDER Frédéric;M;SCHNEIDER;Frédéric;DIV;16
Législatives 2017 - 1er tour;Législatives;2017;1;8;8ème circonscription;77;VILLE D'AVRAY;92077;7440;2857;4583;44;4539;MACHILLOT Alexandre;M;MACHILLOT;Alexandre;DIV;31
Législatives 2017 - 1er tour;Législatives;2017;1;10;10ème circonscription;12;BOULOGNE BILLANCOURT;92012;9082;4562;4520;114;4406;MOREAU Nicolas;M;MOREAU;Nicolas;DVG;28
Législatives 2017 - 1er tour;Législatives;2017;1;10;10ème circonscription;48;MEUDON;92048;6009;2545;3464;38;3426;ZAZOUN Messaoud;M;ZAZOUN;Messaoud;DIV;37
Législatives 2017 - 1er tour;Législatives;2017;1;8;8ème circonscription;47;MARNES LA COQUETTE;92047;1215;451;764;4;760;EPPLING Robin;M;EPPLING;Robin;DIV;26
Législatives 2017 - 1er tour;Législatives;2017;1;1;1ère circonscription;78;VILLENEUVE LA GARENNE;92078;12445;8430;4015;143;3872;CLAUX Bertille;F;CLAUX;Bertille;UDI;0
Législatives 2017 - 1er tour;Législatives;2017;1;3;3ème circonscription;9;BOIS COLOMBES;92009;17921;7869;10052;437;9615;GAULTIER Stéphane;M;GAULTIER;Stéphane;EXG;15
Législatives 2017 - 1er tour;Législatives;2017;1;3;3ème circonscription;9;BOIS COLOMBES;92009;17921;7869;10052;437;9615;BANCHET Julien;M;BANCHET;Julien;DIV;42
Législatives 2017 - 1er tour;Législatives;2017;1;3;3ème circonscription;9;BOIS COLOMBES;92009;17921;7869;10052;437;9615;DORE Patricia;F;DORE;Patricia;ECO;48
Présidentielles 1995 - 1er tour;Présidentielles;1995;1;;;19;CHATENAY MALABRY;92019;18227;5121;13106;238;12868;CHEMINADE JACQUES;M;CHEMINADE;JACQUES;;26
Présidentielles 1995 - 1er tour;Présidentielles;1995;1;;;22;CHAVILLE;92022;12177;2870;9307;170;9137;VILLIERS DE PHILIPPE;M;VILLIERS DE;PHILIPPE;;346
Présidentielles 1995 - 1er tour;Présidentielles;1995;1;;;33;GARCHES;92033;11689;2941;8748;172;8576;CHEMINADE JACQUES;M;CHEMINADE;JACQUES;;17
Présidentielles 1995 - 1er tour;Présidentielles;1995;1;;;40;ISSY LES MOULINEAUX;92040;30054;8139;21915;444;21471;LAGUILLER ARLETTE;F;LAGUILLER;ARLETTE;;1100
Présidentielles 1995 - 1er tour;Présidentielles;1995;1;;;44;LEVALLOIS PERRET;92044;29477;6881;22596;402;22194;HUE ROBERT;M;HUE;ROBERT;;1330
Présidentielles 1995 - 1er tour;Présidentielles;1995;1;;;46;MALAKOFF;92046;19489;5677;13812;258;13554;BALLADUR EDOUARD;M;BALLADUR;EDOUARD;;1574
Présidentielles 1995 - 1er tour;Présidentielles;1995;1;;;63;RUEIL MALMAISON;92063;44438;10571;33867;718;33149;JOSPIN LIONEL;M;JOSPIN;LIONEL;;7289
Présidentielles 1995 - 1er tour;Présidentielles;1995;1;;;64;SAINT CLOUD;92064;18989;5119;13870;179;13691;CHEMINADE JACQUES;M;CHEMINADE;JACQUES;;26
Présidentielles 1995 - 1er tour;Présidentielles;1995;1;;;71;SCEAUX;92071;13371;3073;10298;170;10128;CHIRAC JACQUES;M;CHIRAC;JACQUES;;2974
Présidentielles 1995 - 1er tour;Présidentielles;1995;1;;;76;VAUCRESSON;92076;5529;1334;4195;65;4130;JOSPIN LIONEL;M;JOSPIN;LIONEL;;603
Présidentielles 1995 - 2ème tour;Présidentielles;1995;2;;;12;BOULOGNE BILLANCOURT;92012;58255;11792;46463;1522;44941;CHIRAC JACQUES;M;CHIRAC;JACQUES;;30788
Présidentielles 1995 - 2ème tour;Présidentielles;1995;2;;;73;SURESNES;92073;21968;4886;17082;803;16279;CHIRAC JACQUES;M;CHIRAC;JACQUES;;6823
Présidentielles 1995 - 1er tour;Présidentielles;1995;1;;;9;BOIS COLOMBES;92009;14922;3871;11051;199;10852;HUE ROBERT;M;HUE;ROBERT;;560
Législatives 2007 - 1er tour;Législatives;2007;1;7;7ème circonscription;64;SAINT CLOUD;92064;19115;6812;12303;93;12210;CHOLLOU Sylvia;F;CHOLLOU;Sylvia;DIV;0
Législatives 2007 - 1er tour;Législatives;2007;1;4;4ème circonscription;73;SURESNES;92073;24666;8949;15717;206;15511;ZEBDI-GHORAB Faouzia;F;ZEBDI-GHORAB;Faouzia;DIV;87
Législatives 2007 - 1er tour;Législatives;2007;1;10;10ème circonscription;75;VANVES;92075;17351;5929;11422;137;11285;VIGUIE Laurence;F;VIGUIE;Laurence;EXG;51
Législatives 2007 - 1er tour;Législatives;2007;1;8;8ème circonscription;77;VILLE D'AVRAY;92077;7475;2429;5046;60;4986;CYROULNIK Marie-France;F;CYROULNIK;Marie-France;EXG;36
Législatives 2007 - 1er tour;Législatives;2007;1;8;8ème circonscription;76;VAUCRESSON;92076;6076;2206;3870;46;3824;CYROULNIK Marie-France;F;CYROULNIK;Marie-France;EXG;25
Législatives 2007 - 1er tour;Législatives;2007;1;10;10ème circonscription;75;VANVES;92075;17351;5929;11422;137;11285;VENTURINI Jean-Michel;M;VENTURINI;Jean-Michel;DIV;1
Législatives 2007 - 2ème tour;Législatives;2007;2;10;10ème circonscription;40;ISSY LES MOULINEAUX;92040;38521;16323;22198;726;21472;SANTINI André;M;SANTINI;André;MAJ;12615
Législatives 2007 - 1er tour;Législatives;2007;1;8;8ème circonscription;77;VILLE D'AVRAY;92077;7475;2429;5046;60;4986;RAFFALI Danielle;F;RAFFALI;Danielle;ECO;29
Législatives 2007 - 2ème tour;Législatives;2007;2;1;1ère circonscription;25;COLOMBES;92025;26192;13032;13160;475;12685;VIGNON Véronique;F;VIGNON;Véronique;UMP;5177
Législatives 2007 - 2ème tour;Législatives;2007;2;13;13ème circonscription;2;ANTONY;92002;39811;15865;23946;885;23061;CANET Michèle;F;CANET;Michèle;SOC;10307
Législatives 2007 - 2ème tour;Législatives;2007;2;10;10ème circonscription;48;MEUDON;92048;5066;2270;2796;58;2738;SANTINI André;M;SANTINI;André;MAJ;1574
Législatives 2007 - 1er tour;Législatives;2007;1;2;2ème circonscription;4;ASNIERES SUR SEINE;92004;44110;17783;26327;312;26015;JOURDAN Pascal;M;JOURDAN;Pascal;ECO;358
Législatives 2007 - 1er tour;Législatives;2007;1;11;11ème circonscription;7;BAGNEUX;92007;20520;8538;11982;178;11804;KADRI Malika;F;KADRI;Malika;DIV;103
Législatives 2007 - 1er tour;Législatives;2007;1;9;9ème circonscription;12;BOULOGNE BILLANCOURT;92012;60773;22422;38351;535;37816;LORBER Anne-Charlotte;F;LORBER;Anne-Charlotte;MPF;420
Législatives 2007 - 1er tour;Législatives;2007;1;13;13ème circonscription;14;BOURG LA REINE;92014;13381;4391;8990;78;8912;BRAULT Chantal;F;BRAULT;Chantal;UDFD;1504
Législatives 2007 - 1er tour;Législatives;2007;1;1;1ère circonscription;36;GENNEVILLIERS;92036;20048;9522;10526;189;10337;RABIER Marie-Cécile;F;RABIER;Marie-Cécile;FN;431
Législatives 2007 - 1er tour;Législatives;2007;1;8;8ème circonscription;22;CHAVILLE;92022;12928;4682;8246;120;8126;GUILLET Jean-Jacques;M;GUILLET;Jean-Jacques;UMP;3634
Législatives 2007 - 1er tour;Législatives;2007;1;5;5ème circonscription;24;CLICHY;92024;28799;12380;16419;297;16122;BALKANY Patrick;M;BALKANY;Patrick;UMP;3709
Législatives 2007 - 1er tour;Législatives;2007;1;3;3ème circonscription;35;LA GARENNE COLOMBES;92035;16552;5947;10605;101;10504;BARNONCEL Michel;M;BARNONCEL;Michel;VEC;287
Législatives 2007 - 1er tour;Législatives;2007;1;7;7ème circonscription;64;SAINT CLOUD;92064;19115;6812;12303;93;12210;BORNETTE Bernard;M;BORNETTE;Bernard;EXD;47
Législatives 2007 - 1er tour;Législatives;2007;1;8;8ème circonscription;72;SEVRES;92072;14460;5279;9181;151;9030;SUCHARD Sophie;F;SUCHARD;Sophie;EXG;21
Législatives 2007 - 1er tour;Législatives;2007;1;1;1ère circonscription;25;COLOMBES;92025;26192;12273;13919;366;13553;ROBERT Bertrand;M;ROBERT;Bertrand;EXD;56
Législatives 2007 - 1er tour;Législatives;2007;1;2;2ème circonscription;25;COLOMBES;92025;18336;7144;11192;207;10985;FISCHER Josiane;F;FISCHER;Josiane;DVD;188
Législatives 2007 - 1er tour;Législatives;2007;1;4;4ème circonscription;73;SURESNES;92073;24666;8949;15717;206;15511;BOUKHEDIMI Yvonne;F;BOUKHEDIMI;Yvonne;EXG;24
Présidentielles 2002 - 1er tour;Présidentielles;2002;1;;;7;BAGNEUX;92007;18489;5873;12616;519;12097;MEGRET BRUNO;M;MEGRET;BRUNO;;214
Présidentielles 2002 - 1er tour;Présidentielles;2002;1;;;9;BOIS COLOMBES;92009;13996;4554;9442;200;9242;MAMERE NOEL;M;MAMERE;NOEL;;582
Présidentielles 2002 - 1er tour;Présidentielles;2002;1;;;14;BOURG LA REINE;92014;12075;3519;8556;149;8407;CHIRAC JACQUES;M;CHIRAC;JACQUES;;2073
Présidentielles 2002 - 1er tour;Présidentielles;2002;1;;;14;BOURG LA REINE;92014;12075;3519;8556;149;8407;MADELIN ALAIN;M;MADELIN;ALAIN;;445
Présidentielles 2002 - 1er tour;Présidentielles;2002;1;;;19;CHATENAY MALABRY;92019;15965;4483;11482;241;11241;SAINT-JOSSE JEAN;M;SAINT-JOSSE;JEAN;;77
Présidentielles 2002 - 1er tour;Présidentielles;2002;1;;;23;CLAMART;92023;31130;10977;20153;427;19726;CHEVENEMENT JEAN-PIERRE;M;CHEVENEMENT;JEAN-PIERRE;;1350
Présidentielles 2002 - 1er tour;Présidentielles;2002;1;;;32;FONTENAY AUX ROSES;92032;14148;4309;9839;204;9635;TAUBIRA CHRISTIANE;F;TAUBIRA;CHRISTIANE;;416
Présidentielles 2002 - 1er tour;Présidentielles;2002;1;;;35;LA GARENNE COLOMBES;92035;15006;5167;9839;227;9612;MEGRET BRUNO;M;MEGRET;BRUNO;;218
Présidentielles 2002 - 1er tour;Présidentielles;2002;1;;;40;ISSY LES MOULINEAUX;92040;32059;9424;22635;510;22125;LEPAGE CORINNE;F;LEPAGE;CORINNE;;588
Présidentielles 2002 - 1er tour;Présidentielles;2002;1;;;40;ISSY LES MOULINEAUX;92040;32059;9424;22635;510;22125;BESANCENOT OLIVIER;M;BESANCENOT;OLIVIER;;718
Présidentielles 2002 - 1er tour;Présidentielles;2002;1;;;48;MEUDON;92048;28283;9341;18942;321;18621;LEPAGE CORINNE;F;LEPAGE;CORINNE;;507
Présidentielles 2002 - 1er tour;Présidentielles;2002;1;;;49;MONTROUGE;92049;23382;8142;15240;301;14939;HUE ROBERT;M;HUE;ROBERT;;459
Présidentielles 2002 - 1er tour;Présidentielles;2002;1;;;50;NANTERRE;92050;37590;13303;24287;669;23618;LE PEN JEAN-MARIE;M;LE PEN;JEAN-MARIE;;3168
Présidentielles 2002 - 1er tour;Présidentielles;2002;1;;;51;NEUILLY SUR SEINE;92051;34066;10108;23958;309;23649;TAUBIRA CHRISTIANE;F;TAUBIRA;CHRISTIANE;;233
Présidentielles 2002 - 1er tour;Présidentielles;2002;1;;;60;LE PLESSIS ROBINSON;92060;14503;4736;9767;230;9537;BOUTIN CHRISTINE;F;BOUTIN;CHRISTINE;;86
Présidentielles 2002 - 1er tour;Présidentielles;2002;1;;;63;RUEIL MALMAISON;92063;48302;17158;31144;693;30451;CHEVENEMENT JEAN-PIERRE;M;CHEVENEMENT;JEAN-PIERRE;;2112
Présidentielles 2002 - 1er tour;Présidentielles;2002;1;;;64;SAINT CLOUD;92064;17818;6028;11790;141;11649;BAYROU FRANCOIS;M;BAYROU;FRANCOIS;;1409
Présidentielles 2002 - 1er tour;Présidentielles;2002;1;;;64;SAINT CLOUD;92064;17818;6028;11790;141;11649;MADELIN ALAIN;M;MADELIN;ALAIN;;1125
Présidentielles 2002 - 1er tour;Présidentielles;2002;1;;;73;SURESNES;92073;22099;7156;14943;329;14614;CHEVENEMENT JEAN-PIERRE;M;CHEVENEMENT;JEAN-PIERRE;;886
Présidentielles 2002 - 1er tour;Présidentielles;2002;1;;;78;VILLENEUVE LA GARENNE;92078;11406;4746;6660;180;6480;MAMERE NOEL;M;MAMERE;NOEL;;377
Présidentielles 2012 - 1er tour;Présidentielles;2012;1;;;2;ANTONY;92002;40169;7755;32414;674;31740;DUPONT-AIGNAN Nicolas;M;DUPONT-AIGNAN;Nicolas;;443
Présidentielles 2012 - 1er tour;Présidentielles;2012;1;;;20;CHATILLON;92020;21656;4298;17358;265;17093;POUTOU Philippe;M;POUTOU;Philippe;;138
Présidentielles 2012 - 1er tour;Présidentielles;2012;1;;;20;CHATILLON;92020;21656;4298;17358;265;17093;DUPONT-AIGNAN Nicolas;M;DUPONT-AIGNAN;Nicolas;;264
Présidentielles 2012 - 1er tour;Présidentielles;2012;1;;;22;CHAVILLE;92022;12768;2527;10241;147;10094;BAYROU François;M;BAYROU;François;;1368
Présidentielles 2012 - 1er tour;Présidentielles;2012;1;;;22;CHAVILLE;92022;12768;2527;10241;147;10094;HOLLANDE François;M;HOLLANDE;François;;3024
Présidentielles 2012 - 1er tour;Présidentielles;2012;1;;;25;COLOMBES;92025;44741;10181;34560;526;34034;JOLY Eva;F;JOLY;Eva;;922
Présidentielles 2012 - 1er tour;Présidentielles;2012;1;;;35;LA GARENNE COLOMBES;92035;17300;3509;13791;212;13579;ARTHAUD Nathalie;F;ARTHAUD;Nathalie;;32
Présidentielles 2012 - 1er tour;Présidentielles;2012;1;;;36;GENNEVILLIERS;92036;20990;5264;15726;342;15384;DUPONT-AIGNAN Nicolas;M;DUPONT-AIGNAN;Nicolas;;155
Présidentielles 2012 - 1er tour;Présidentielles;2012;1;;;36;GENNEVILLIERS;92036;20990;5264;15726;342;15384;HOLLANDE François;M;HOLLANDE;François;;6199
Présidentielles 2012 - 1er tour;Présidentielles;2012;1;;;50;NANTERRE;92050;44307;10435;33872;654;33218;HOLLANDE François;M;HOLLANDE;François;;13340
Présidentielles 2012 - 1er tour;Présidentielles;2012;1;;;60;LE PLESSIS ROBINSON;92060;18767;3621;15146;260;14886;DUPONT-AIGNAN Nicolas;M;DUPONT-AIGNAN;Nicolas;;273
Présidentielles 2012 - 1er tour;Présidentielles;2012;1;;;64;SAINT CLOUD;92064;18973;3529;15444;153;15291;POUTOU Philippe;M;POUTOU;Philippe;;66
Présidentielles 2012 - 1er tour;Présidentielles;2012;1;;;75;VANVES;92075;17512;3079;14433;161;14272;POUTOU Philippe;M;POUTOU;Philippe;;95
Présidentielles 2007 - 1er tour;Présidentielles;2007;1;;;2;ANTONY;92002;39316;4695;34621;413;34208;LE PEN Jean-Marie;M;LE PEN;Jean-Marie;;1745
Présidentielles 2007 - 1er tour;Présidentielles;2007;1;;;7;BAGNEUX;92007;20438;2809;17629;261;17368;VOYNET Dominique;F;VOYNET;Dominique;;223
Présidentielles 2007 - 1er tour;Présidentielles;2007;1;;;9;BOIS COLOMBES;92009;16113;2534;13579;152;13427;BAYROU François;M;BAYROU;François;;2974
Présidentielles 2007 - 1er tour;Présidentielles;2007;1;;;12;BOULOGNE BILLANCOURT;92012;64709;7685;57024;546;56478;BESANCENOT Olivier;M;BESANCENOT;Olivier;;771
Présidentielles 2007 - 1er tour;Présidentielles;2007;1;;;12;BOULOGNE BILLANCOURT;92012;64709;7685;57024;546;56478;LE PEN Jean-Marie;M;LE PEN;Jean-Marie;;2520
Présidentielles 2007 - 1er tour;Présidentielles;2007;1;;;19;CHATENAY MALABRY;92019;17598;2318;15280;229;15051;VOYNET Dominique;F;VOYNET;Dominique;;237
Présidentielles 2007 - 1er tour;Présidentielles;2007;1;;;19;CHATENAY MALABRY;92019;17598;2318;15280;229;15051;NIHOUS Frédéric;M;NIHOUS;Frédéric;;37
Présidentielles 2007 - 1er tour;Présidentielles;2007;1;;;22;CHAVILLE;92022;12743;1700;11043;119;10924;BUFFET Marie-George;F;BUFFET;Marie-George;;165
Présidentielles 2007 - 1er tour;Présidentielles;2007;1;;;25;COLOMBES;92025;44025;7536;36489;501;35988;BAYROU François;M;BAYROU;François;;7116
Présidentielles 2007 - 1er tour;Présidentielles;2007;1;;;32;FONTENAY AUX ROSES;92032;15234;2027;13207;123;13084;SARKOZY Nicolas;M;SARKOZY;Nicolas;;3942
Présidentielles 2007 - 1er tour;Présidentielles;2007;1;;;35;LA GARENNE COLOMBES;92035;16350;1826;14524;117;14407;LAGUILLER Arlette;F;LAGUILLER;Arlette;;112
Présidentielles 2007 - 1er tour;Présidentielles;2007;1;;;36;GENNEVILLIERS;92036;19890;3536;16354;259;16095;LAGUILLER Arlette;F;LAGUILLER;Arlette;;205
Présidentielles 2007 - 1er tour;Présidentielles;2007;1;;;46;MALAKOFF;92046;18259;2640;15619;178;15441;BUFFET Marie-George;F;BUFFET;Marie-George;;1210
Présidentielles 2007 - 1er tour;Présidentielles;2007;1;;;46;MALAKOFF;92046;18259;2640;15619;178;15441;de VILLIERS Philippe;M;de VILLIERS;Philippe;;198
Présidentielles 2007 - 1er tour;Présidentielles;2007;1;;;46;MALAKOFF;92046;18259;2640;15619;178;15441;NIHOUS Frédéric;M;NIHOUS;Frédéric;;42
Présidentielles 2007 - 1er tour;Présidentielles;2007;1;;;47;MARNES LA COQUETTE;92047;1054;91;963;9;954;NIHOUS Frédéric;M;NIHOUS;Frédéric;;3
Présidentielles 2007 - 1er tour;Présidentielles;2007;1;;;48;MEUDON;92048;29936;4129;25807;223;25584;BUFFET Marie-George;F;BUFFET;Marie-George;;347
Présidentielles 2007 - 1er tour;Présidentielles;2007;1;;;49;MONTROUGE;92049;26299;3093;23206;219;22987;LE PEN Jean-Marie;M;LE PEN;Jean-Marie;;1231
Présidentielles 2007 - 1er tour;Présidentielles;2007;1;;;51;NEUILLY SUR SEINE;92051;37647;4032;33615;154;33461;VOYNET Dominique;F;VOYNET;Dominique;;257
Présidentielles 2007 - 1er tour;Présidentielles;2007;1;;;64;SAINT CLOUD;92064;18455;1926;16529;91;16438;SCHIVARDI Gérard;M;SCHIVARDI;Gérard;;14
Présidentielles 2007 - 1er tour;Présidentielles;2007;1;;;64;SAINT CLOUD;92064;18455;1926;16529;91;16438;BOVÉ José;M;BOVÉ;José;;71
Présidentielles 2007 - 1er tour;Présidentielles;2007;1;;;72;SEVRES;92072;14178;1738;12440;129;12311;LE PEN Jean-Marie;M;LE PEN;Jean-Marie;;551
Présidentielles 2007 - 1er tour;Présidentielles;2007;1;;;76;VAUCRESSON;92076;5902;781;5121;42;5079;SCHIVARDI Gérard;M;SCHIVARDI;Gérard;;4
Présidentielles 2017 - 1er tour;Présidentielles;2017;1;;;14;BOURG LA REINE;92014;13769;2202;11567;212;11355;POUTOU Philippe;M;POUTOU;Philippe;;62
Présidentielles 2017 - 1er tour;Présidentielles;2017;1;;;19;CHATENAY MALABRY;92019;18708;3336;15372;454;14918;FILLON François;M;FILLON;François;;3275
Présidentielles 2017 - 1er tour;Présidentielles;2017;1;;;22;CHAVILLE;92022;13493;2042;11451;183;11267;LE PEN Marine;F;LE PEN;Marine;;823
Présidentielles 2017 - 1er tour;Présidentielles;2017;1;;;25;COLOMBES;92025;47454;9714;37740;907;36833;ASSELINEAU François;M;ASSELINEAU;François;;491
Présidentielles 2017 - 1er tour;Présidentielles;2017;1;;;26;COURBEVOIE;92026;52391;9609;42782;817;41965;FILLON François;M;FILLON;François;;13291
Présidentielles 2017 - 1er tour;Présidentielles;2017;1;;;47;MARNES LA COQUETTE;92047;1215;171;1044;5;1039;POUTOU Philippe;M;POUTOU;Philippe;;3
Présidentielles 2017 - 1er tour;Présidentielles;2017;1;;;50;NANTERRE;92050;47568;10655;36913;884;36029;ASSELINEAU François;M;ASSELINEAU;François;;644
Présidentielles 2017 - 1er tour;Présidentielles;2017;1;;;60;LE PLESSIS ROBINSON;92060;19141;2947;16194;344;15850;ASSELINEAU François;M;ASSELINEAU;François;;180
Présidentielles 2017 - 1er tour;Présidentielles;2017;1;;;63;RUEIL MALMAISON;92063;54426;9298;45128;713;44414;HAMON Benoît;M;HAMON;Benoît;;2686
Présidentielles 2017 - 1er tour;Présidentielles;2017;1;;;71;SCEAUX;92071;15052;2914;12138;145;11993;LASSALLE Jean;M;LASSALLE;Jean;;77
Présidentielles 2017 - 1er tour;Présidentielles;2017;1;;;75;VANVES;92075;18500;3228;15272;248;15024;MACRON Emmanuel;M;MACRON;Emmanuel;;5375
Présidentielles 2017 - 1er tour;Présidentielles;2017;1;;;76;VAUCRESSON;92076;6176;835;5341;72;5269;ASSELINEAU François;M;ASSELINEAU;François;;36
Présidentielles 2017 - 1er tour;Présidentielles;2017;1;;;76;VAUCRESSON;92076;6176;835;5341;72;5269;DUPONT-AIGNAN Nicolas;M;DUPONT-AIGNAN;Nicolas;;108
Présidentielles 2017 - 1er tour;Présidentielles;2017;1;;;77;VILLE D'AVRAY;92077;7433;837;6596;89;6507;FILLON François;M;FILLON;François;;2593
Présidentielles 2017 - 1er tour;Présidentielles;2017;1;;;77;VILLE D'AVRAY;92077;7433;837;6596;89;6507;POUTOU Philippe;M;POUTOU;Philippe;;18
Présidentielles 2002 - 2ème tour;Présidentielles;2002;2;;;75;VANVES;92075;15504;2463;13041;460;12581;LE PEN JEAN-MARIE;M;LE PEN;JEAN-MARIE;;1296
Présidentielles 2007 - 2ème tour;Présidentielles;2007;2;;;14;BOURG LA REINE;92014;13120;1590;11530;424;11106;ROYAL Ségolène;F;ROYAL;Ségolène;;5056
Présidentielles 2017 - 2ème tour;Présidentielles;2017;2;;;51;NEUILLY SUR SEINE;92051;37186;6787;30399;2384;28015;MACRON Emmanuel;M;MACRON;Emmanuel;;24871
Présidentielles 2017 - 2ème tour;Présidentielles;2017;2;;;71;SCEAUX;92071;15052;3631;11421;934;10487;MACRON Emmanuel;M;MACRON;Emmanuel;;9329
Présidentielles 2017 - 2ème tour;Présidentielles;2017;2;;;72;SEVRES;92072;15143;2971;12172;998;11174;MACRON Emmanuel;M;MACRON;Emmanuel;;9833
Présidentielles 2012 - 2ème tour;Présidentielles;2012;2;;;4;ASNIERES SUR SEINE;92004;45078;7965;37113;1429;35684;SARKOZY Nicolas;M;SARKOZY;Nicolas;;17029
Législatives 1993 - 1er tour;Législatives;1993;1;12;12ème circonscription;20;CHATILLON;92020;15705;4455;11250;435;10815;LEGOEUIL ANNETTE;F;LEGOEUIL;ANNETTE;SOC;113
Législatives 1993 - 1er tour;Législatives;1993;1;12;12ème circonscription;23;CLAMART;92023;30899;9896;21003;704;20299;FOUCHER J.PIERRE;M;FOUCHER;J.PIERRE;UDF;9257
Législatives 1993 - 1er tour;Législatives;1993;1;8;8ème circonscription;22;CHAVILLE;92022;12345;3904;8441;296;8145;BRISSAUD SOPHIE;F;BRISSAUD;SOPHIE;FRN;1019
Législatives 1993 - 1er tour;Législatives;1993;1;5;5ème circonscription;24;CLICHY;92024;25172;9290;15882;514;15368;VIVANT ROGER;M;VIVANT;ROGER;DVD;173
Législatives 1993 - 1er tour;Législatives;1993;1;7;7ème circonscription;63;RUEIL MALMAISON;92063;42219;12104;30115;1049;29066;WAGNER JACQUES;M;WAGNER;JACQUES;DVD;138
Législatives 1993 - 1er tour;Législatives;1993;1;3;3ème circonscription;26;COURBEVOIE;92026;34737;9916;24821;828;23993;MARSAULT PHILIPPE;M;MARSAULT;PHILIPPE;EXG;370
Législatives 1993 - 1er tour;Législatives;1993;1;3;3ème circonscription;26;COURBEVOIE;92026;34737;9916;24821;828;23993;PEREZ CHRISTIAN;M;PEREZ;CHRISTIAN;FRN;3452
Législatives 1993 - 1er tour;Législatives;1993;1;1;1ère circonscription;78;VILLENEUVE LA GARENNE;92078;11604;4168;7436;212;7224;GUICHARROUSSE HUBERT;M;GUICHARROUSSE;HUBERT;VEC;372
Législatives 1993 - 1er tour;Législatives;1993;1;1;1ère circonscription;78;VILLENEUVE LA GARENNE;92078;11604;4168;7436;212;7224;PREVOT ROGER;M;PREVOT;ROGER;UDF;3057
Législatives 1993 - 1er tour;Législatives;1993;1;1;1ère circonscription;78;VILLENEUVE LA GARENNE;92078;11604;4168;7436;212;7224;MAS J.LOUIS;M;MAS;J.LOUIS;DVD;48
Législatives 1993 - 1er tour;Législatives;1993;1;9;9ème circonscription;12;BOULOGNE BILLANCOURT;92012;53509;17387;36122;1224;34898;GORSE GEORGES;M;GORSE;GEORGES;RPR;19715
Législatives 1993 - 1er tour;Législatives;1993;1;11;11ème circonscription;7;BAGNEUX;92007;21150;7754;13396;474;12922;ROBERT ALAIN;M;ROBERT;ALAIN;RPR;3641
Législatives 1993 - 1er tour;Législatives;1993;1;6;6ème circonscription;51;NEUILLY SUR SEINE;92051;35806;10146;25660;620;25040;LE PEN M.CAROLINE;F;LE PEN;M.CAROLINE;FRN;2657
Législatives 1993 - 1er tour;Législatives;1993;1;10;10ème circonscription;75;VANVES;92075;15286;4324;10962;394;10568;DENIAU RAYMOND;M;DENIAU;RAYMOND;EXG;659
Législatives 1993 - 1er tour;Législatives;1993;1;1;1ère circonscription;36;GENNEVILLIERS;92036;19185;6818;12367;395;11972;LE GALLOU J.YVES;M;LE GALLOU;J.YVES;FRN;2229
Législatives 1993 - 1er tour;Législatives;1993;1;10;10ème circonscription;40;ISSY LES MOULINEAUX;92040;29377;9425;19952;648;19304;PEYNAUD JEAN;M;PEYNAUD;JEAN;MAJ;246
Législatives 1993 - 1er tour;Législatives;1993;1;8;8ème circonscription;48;MEUDON;92048;25126;7628;17498;529;16969;KONOPNICKI GUY;M;KONOPNICKI;GUY;GEC;1653
Législatives 1993 - 1er tour;Législatives;1993;1;10;10ème circonscription;48;MEUDON;92048;4225;1396;2829;92;2737;PEYNAUD JEAN;M;PEYNAUD;JEAN;MAJ;60
Législatives 1993 - 1er tour;Législatives;1993;1;8;8ème circonscription;72;SEVRES;92072;13536;3690;9846;336;9510;MARGUERITES HARRY;M;MARGUERITES;HARRY;MAJ;118
Législatives 1993 - 1er tour;Législatives;1993;1;4;4ème circonscription;73;SURESNES;92073;21292;6457;14835;522;14313;ALLAIN MICHEL;M;ALLAIN;MICHEL;EXG;87
Législatives 2002 - 1er tour;Législatives;2002;1;13;13ème circonscription;2;ANTONY;92002;39807;13942;25865;456;25409;FIE Dominique;M;FIE;Dominique;COM;791
Législatives 2002 - 1er tour;Législatives;2002;1;13;13ème circonscription;2;ANTONY;92002;39807;13942;25865;456;25409;DEVEDJIAN Patrick;M;DEVEDJIAN;Patrick;UMP;12052
Législatives 2002 - 1er tour;Législatives;2002;1;11;11ème circonscription;7;BAGNEUX;92007;20520;8538;11982;178;11804;DE PABLO Carmelina;F;DE PABLO;Carmelina;VEC;364
Législatives 2002 - 1er tour;Législatives;2002;1;3;3ème circonscription;9;BOIS COLOMBES;92009;16245;6561;9684;288;9396;TRIBOULET Catherine;F;TRIBOULET;Catherine;DIV;24
Législatives 2002 - 1er tour;Législatives;2002;1;9;9ème circonscription;12;BOULOGNE BILLANCOURT;92012;60773;22422;38351;535;37816;BOLLIET Marie-Pierre;F;BOLLIET;Marie-Pierre;DIV;30
Législatives 2002 - 1er tour;Législatives;2002;1;10;10ème circonscription;12;BOULOGNE BILLANCOURT;92012;5551;2367;3184;78;3106;NAVIAUX Catherine;F;NAVIAUX;Catherine;VEC;117
Législatives 2002 - 1er tour;Législatives;2002;1;13;13ème circonscription;14;BOURG LA REINE;92014;13381;4391;8990;78;8912;BRAULT Chantal;F;BRAULT;Chantal;UDFD;1504
Législatives 2002 - 1er tour;Législatives;2002;1;12;12ème circonscription;20;CHATILLON;92020;20661;7083;13578;137;13441;BENARD Paul;M;BENARD;Paul;EXG;43
Législatives 2002 - 1er tour;Législatives;2002;1;12;12ème circonscription;20;CHATILLON;92020;20661;7083;13578;137;13441;ZANOLIN Ludovic;F;ZANOLIN;Ludovic;COM;337
Législatives 2002 - 1er tour;Législatives;2002;1;12;12ème circonscription;20;CHATILLON;92020;20661;7083;13578;137;13441;DELMATTO Geneviève;F;DELMATTO;Geneviève;EXD;51
Législatives 2002 - 1er tour;Législatives;2002;1;8;8ème circonscription;22;CHAVILLE;92022;12928;4682;8246;120;8126;BEZAULT Christine;F;BEZAULT;Christine;DIV;42
Législatives 2002 - 1er tour;Législatives;2002;1;8;8ème circonscription;22;CHAVILLE;92022;12928;4682;8246;120;8126;BOUCHARD Renaud;M;BOUCHARD;Renaud;DIV;4
Législatives 2002 - 1er tour;Législatives;2002;1;1;1ère circonscription;25;COLOMBES;92025;26192;12273;13919;366;13553;GRIMAL Jean;M;GRIMAL;Jean;EXG;55
Législatives 2002 - 1er tour;Législatives;2002;1;1;1ère circonscription;25;COLOMBES;92025;26192;12273;13919;366;13553;DENJEAN Jean-Marc;M;DENJEAN;Jean-Marc;VEC;337
Législatives 2002 - 1er tour;Législatives;2002;1;3;3ème circonscription;26;COURBEVOIE;92026;49151;19345;29806;541;29265;HERBIN Annick;F;HERBIN;Annick;COM;359
Législatives 2002 - 1er tour;Législatives;2002;1;3;3ème circonscription;26;COURBEVOIE;92026;49151;19345;29806;541;29265;TRIBOULET Catherine;F;TRIBOULET;Catherine;DIV;29
Législatives 2002 - 1er tour;Législatives;2002;1;3;3ème circonscription;26;COURBEVOIE;92026;49151;19345;29806;541;29265;PELISSIER Hélène;F;PELISSIER;Hélène;DIV;129
Législatives 2002 - 1er tour;Législatives;2002;1;3;3ème circonscription;35;LA GARENNE COLOMBES;92035;16552;5947;10605;101;10504;PELISSIER Hélène;F;PELISSIER;Hélène;DIV;69
Législatives 2002 - 1er tour;Législatives;2002;1;5;5ème circonscription;44;LEVALLOIS PERRET;92044;39466;14724;24742;404;24338;GALLAIS Alain;M;GALLAIS;Alain;FN;664
Législatives 2002 - 1er tour;Législatives;2002;1;11;11ème circonscription;46;MALAKOFF;92046;18478;7045;11433;204;11229;BONJEAN Hubert;M;BONJEAN;Hubert;FN;406
Législatives 2002 - 1er tour;Législatives;2002;1;8;8ème circonscription;48;MEUDON;92048;25427;9683;15744;202;15542;LUCET Francis;M;LUCET;Francis;EXG;106
Législatives 2002 - 1er tour;Législatives;2002;1;8;8ème circonscription;48;MEUDON;92048;25427;9683;15744;202;15542;BOUCHARD Renaud;M;BOUCHARD;Renaud;DIV;12
Législatives 2002 - 1er tour;Législatives;2002;1;10;10ème circonscription;48;MEUDON;92048;5066;1864;3202;29;3173;GINISTY Christophe;M;GINISTY;Christophe;UDFD;449
Législatives 2002 - 1er tour;Législatives;2002;1;4;4ème circonscription;50;NANTERRE;92050;42631;18721;23910;314;23596;LE TOUZE Estelle;F;LE TOUZE;Estelle;VEC;674
Législatives 2002 - 1er tour;Législatives;2002;1;7;7ème circonscription;64;SAINT CLOUD;92064;19115;6812;12303;93;12210;BITTERLIN Anne;F;BITTERLIN;Anne;ECO;64
Législatives 2002 - 1er tour;Législatives;2002;1;13;13ème circonscription;71;SCEAUX;92071;14129;4679;9450;74;9376;FONTAN Huguette;F;FONTAN;Huguette;DIV;0
Législatives 2002 - 1er tour;Législatives;2002;1;4;4ème circonscription;73;SURESNES;92073;24666;8949;15717;206;15511;CREUZET Pierre;M;CREUZET;Pierre;UDFD;1755
Législatives 2002 - 1er tour;Législatives;2002;1;8;8ème circonscription;77;VILLE D'AVRAY;92077;7475;2429;5046;60;4986;FILLOUX Delphine;F;FILLOUX;Delphine;DIV;73
Législatives 2002 - 1er tour;Législatives;2002;1;8;8ème circonscription;77;VILLE D'AVRAY;92077;7475;2429;5046;60;4986;LEHIDEUX Bernard;M;LEHIDEUX;Bernard;UDFD;861
Législatives 1997 - 1er tour;Législatives;1997;1;1;1ère circonscription;36;GENNEVILLIERS;92036;19277;7226;12051;295;11756;LOBRY MAURICE;M;LOBRY;MAURICE;SOC;978
Législatives 1997 - 1er tour;Législatives;1997;1;13;13ème circonscription;14;BOURG LA REINE;92014;12587;4431;8156;266;7890;SCHNEITER LEONORE;F;SCHNEITER;LEONORE;ECO;133
Législatives 1997 - 1er tour;Législatives;1997;1;13;13ème circonscription;19;CHATENAY MALABRY;92019;17859;6462;11397;367;11030;ANSQUER VIRGINIE;F;ANSQUER;VIRGINIE;EXG;28
Législatives 1997 - 1er tour;Législatives;1997;1;9;9ème circonscription;12;BOULOGNE BILLANCOURT;92012;53287;18902;34385;948;33437;PICHON OLIVIER;M;PICHON;OLIVIER;FRN;3405
Législatives 1997 - 1er tour;Législatives;1997;1;3;3ème circonscription;26;COURBEVOIE;92026;35738;12354;23384;653;22731;LE RET CHRISTOPHE;M;LE RET;CHRISTOPHE;DVD;327
Législatives 1997 - 1er tour;Législatives;1997;1;3;3ème circonscription;26;COURBEVOIE;92026;35738;12354;23384;653;22731;LAHEURTE RENAUD;M;LAHEURTE;RENAUD;SOC;4809
Législatives 1997 - 1er tour;Législatives;1997;1;1;1ère circonscription;25;COLOMBES;92025;26238;10153;16085;513;15572;LE GALLOU J.YVES;M;LE GALLOU;J.YVES;FRN;3240
Législatives 1997 - 1er tour;Législatives;1997;1;1;1ère circonscription;25;COLOMBES;92025;26238;10153;16085;513;15572;GAZEAU STEPHANE;M;GAZEAU;STEPHANE;DIV;0
Législatives 1997 - 1er tour;Législatives;1997;1;3;3ème circonscription;26;COURBEVOIE;92026;35738;12354;23384;653;22731;HABY J.YVES;M;HABY;J.YVES;UDF;5286
Législatives 1997 - 1er tour;Législatives;1997;1;3;3ème circonscription;9;BOIS COLOMBES;92009;14757;5447;9310;293;9017;PEREZ CHRISTIAN;M;PEREZ;CHRISTIAN;FRN;1321
Législatives 1997 - 1er tour;Législatives;1997;1;7;7ème circonscription;64;SAINT CLOUD;92064;18908;7095;11813;417;11396;MARECHAL CHRISTIAN;M;MARECHAL;CHRISTIAN;FRN;1356
Législatives 1997 - 1er tour;Législatives;1997;1;8;8ème circonscription;72;SEVRES;92072;13776;4413;9363;352;9011;MARKOVITCH ISABELLE;F;MARKOVITCH;ISABELLE;DVD;0
Législatives 1997 - 1er tour;Législatives;1997;1;13;13ème circonscription;71;SCEAUX;92071;13168;3887;9281;266;9015;ANSQUER VIRGINIE;F;ANSQUER;VIRGINIE;EXG;22
Législatives 1997 - 1er tour;Législatives;1997;1;7;7ème circonscription;63;RUEIL MALMAISON;92063;44715;14813;29902;1094;28808;MORTIMORE STEPHANIE;F;MORTIMORE;STEPHANIE;DVD;588
Législatives 1997 - 1er tour;Législatives;1997;1;8;8ème circonscription;76;VAUCRESSON;92076;5546;1861;3685;139;3546;ETILE L.CHRISTOPHE;M;ETILE;L.CHRISTOPHE;DVD;32
Législatives 1997 - 1er tour;Législatives;1997;1;10;10ème circonscription;75;VANVES;92075;15446;4682;10764;329;10435;CRETET PHILIPPE;M;CRETET;PHILIPPE;EXG;57
Législatives 1997 - 1er tour;Législatives;1997;1;4;4ème circonscription;73;SURESNES;92073;20985;7217;13768;441;13327;GEORGES BRUNO;M;GEORGES;BRUNO;DVD;370
Législatives 1997 - 1er tour;Législatives;1997;1;12;12ème circonscription;23;CLAMART;92023;30471;10310;20161;590;19571;PEYRONNEAU GASTON;M;PEYRONNEAU;GASTON;COM;1447
Législatives 1997 - 1er tour;Législatives;1997;1;8;8ème circonscription;22;CHAVILLE;92022;12268;3930;8338;262;8076;ARIA D DANIELA;F;ARIA D;DANIELA;DIV;0
Législatives 1997 - 1er tour;Législatives;1997;1;12;12ème circonscription;20;CHATILLON;92020;16406;5234;11172;367;10805;GRIELEN ALAIN;M;GRIELEN;ALAIN;DVG;40
Législatives 1997 - 1er tour;Législatives;1997;1;4;4ème circonscription;50;NANTERRE;92050;38533;13799;24734;766;23968;MEYER M.LAURE;F;MEYER;M.LAURE;SOC;3587
Législatives 1997 - 2ème tour;Législatives;1997;2;12;12ème circonscription;20;CHATILLON;92020;16406;4481;11925;489;11436;FOUCHER J.PIERRE;M;FOUCHER;J.PIERRE;UDF;5804
Législatives 1997 - 2ème tour;Législatives;1997;2;3;3ème circonscription;35;LA GARENNE COLOMBES;92035;13992;4607;9385;405;8980;HABY J.YVES;M;HABY;J.YVES;UDF;1681
Législatives 2012 - 1er tour;Législatives;2012;1;13;13ème circonscription;2;ANTONY;92002;40941;15088;25853;361;25492;LE NEOUANNIC Pascale;F;LE NEOUANNIC;Pascale;FG;1581
Législatives 2012 - 1er tour;Législatives;2012;1;13;13ème circonscription;2;ANTONY;92002;40941;15088;25853;361;25492;DE ZAYAS Marie;F;DE ZAYAS;Marie;DVD;187
Législatives 2012 - 1er tour;Législatives;2012;1;11;11ème circonscription;7;BAGNEUX;92007;20609;9648;10961;145;10816;SAUVANAUD Juliette;F;SAUVANAUD;Juliette;EXG;31
Législatives 2012 - 1er tour;Législatives;2012;1;8;8ème circonscription;22;CHAVILLE;92022;12808;4688;8120;75;8045;SEGUI Miguel;M;SEGUI;Miguel;EXG;21
Législatives 2012 - 1er tour;Législatives;2012;1;5;5ème circonscription;24;CLICHY;92024;29276;13521;15755;274;15481;SAUGE Jean-Michel;M;SAUGE;Jean-Michel;EXG;67
Législatives 2012 - 1er tour;Législatives;2012;1;5;5ème circonscription;24;CLICHY;92024;29276;13521;15755;274;15481;MOUTONGO-BLACK Alvine;F;MOUTONGO-BLACK;Alvine;CEN;451
Législatives 2012 - 1er tour;Législatives;2012;1;5;5ème circonscription;24;CLICHY;92024;29276;13521;15755;274;15481;BALKANY Patrick;M;BALKANY;Patrick;UMP;2766
Législatives 2012 - 1er tour;Législatives;2012;1;1;1ère circonscription;25;COLOMBES;92025;26337;13144;13193;209;12984;GRIMAL Jean;M;GRIMAL;Jean;EXG;47
Législatives 2012 - 1er tour;Législatives;2012;1;1;1ère circonscription;25;COLOMBES;92025;26337;13144;13193;209;12984;BACHELAY Alexis;M;BACHELAY;Alexis;SOC;5219
Législatives 2012 - 1er tour;Législatives;2012;1;1;1ère circonscription;25;COLOMBES;92025;26337;13144;13193;209;12984;SABAN Muriel;F;SABAN;Muriel;NCE;0
Législatives 2012 - 1er tour;Législatives;2012;1;12;12ème circonscription;32;FONTENAY AUX ROSES;92032;15230;5971;9259;85;9174;DOUCET Blanche;F;DOUCET;Blanche;FN;647
Législatives 2012 - 1er tour;Législatives;2012;1;1;1ère circonscription;36;GENNEVILLIERS;92036;20795;10523;10272;192;10080;MOURRE Odile;F;MOURRE;Odile;EXG;15
Législatives 2012 - 1er tour;Législatives;2012;1;10;10ème circonscription;40;ISSY LES MOULINEAUX;92040;42014;16484;25530;277;25253;VIGUIE Laurence;F;VIGUIE;Laurence;EXG;46
Législatives 2012 - 1er tour;Législatives;2012;1;8;8ème circonscription;47;MARNES LA COQUETTE;92047;1085;330;755;2;753;HENIQUE Philippe;M;HENIQUE;Philippe;EXG;0
Législatives 2012 - 1er tour;Législatives;2012;1;8;8ème circonscription;47;MARNES LA COQUETTE;92047;1085;330;755;2;753;VIERA Lydia;F;VIERA;Lydia;ECO;0
Législatives 2012 - 1er tour;Législatives;2012;1;8;8ème circonscription;47;MARNES LA COQUETTE;92047;1085;330;755;2;753;GUILLET Jean-Jacques;M;GUILLET;Jean-Jacques;UMP;460
Législatives 2012 - 1er tour;Législatives;2012;1;8;8ème circonscription;48;MEUDON;92048;25002;9709;15293;150;15143;VIERA Lydia;F;VIERA;Lydia;ECO;47
Législatives 2012 - 1er tour;Législatives;2012;1;10;10ème circonscription;48;MEUDON;92048;5576;2083;3493;26;3467;BUNOT Sandrine;F;BUNOT;Sandrine;FN;215
Législatives 2012 - 1er tour;Législatives;2012;1;12;12ème circonscription;60;LE PLESSIS ROBINSON;92060;18785;6274;12511;101;12410;BAVAY Francine;F;BAVAY;Francine;VEC;330
Législatives 2012 - 1er tour;Législatives;2012;1;7;7ème circonscription;63;RUEIL MALMAISON;92063;52518;20526;31992;298;31694;ROCHERON Bertrand;M;ROCHERON;Bertrand;SOC;10085
Législatives 2012 - 1er tour;Législatives;2012;1;8;8ème circonscription;72;SEVRES;92072;14861;5785;9076;101;8975;SEGUI Miguel;M;SEGUI;Miguel;EXG;28
Législatives 2012 - 1er tour;Législatives;2012;1;8;8ème circonscription;72;SEVRES;92072;14861;5785;9076;101;8975;CASTERA Stéphane;M;CASTERA;Stéphane;AUT;84
Législatives 2012 - 1er tour;Législatives;2012;1;10;10ème circonscription;75;VANVES;92075;17559;6347;11212;104;11108;ALEZARD Lysiane;F;ALEZARD;Lysiane;FG;694
Législatives 2012 - 1er tour;Législatives;2012;1;8;8ème circonscription;76;VAUCRESSON;92076;6093;2463;3630;39;3591;CHETAILLE Romain;M;CHETAILLE;Romain;DVD;406
Législatives 2012 - 1er tour;Législatives;2012;1;8;8ème circonscription;77;VILLE D'AVRAY;92077;7169;2468;4701;48;4653;BENIERE Louise;F;BENIERE;Louise;DVD;23
Législatives 2012 - 2ème tour;Législatives;2012;2;5;5ème circonscription;24;CLICHY;92024;29276;13662;15614;926;14688;BALKANY Patrick;M;BALKANY;Patrick;UMP;4571
Législatives 2012 - 2ème tour;Législatives;2012;2;6;6ème circonscription;26;COURBEVOIE;92026;8123;3901;4222;154;4068;LEPIDI Bernard;M;LEPIDI;Bernard;DVD;629
Législatives 2002 - 2ème tour;Législatives;2002;2;12;12ème circonscription;20;CHATILLON;92020;18170;6361;11809;330;11479;PEMEZEC PHILIPPE;M;PEMEZEC;PHILIPPE;RPF;6033
Législatives 2002 - 2ème tour;Législatives;2002;2;12;12ème circonscription;23;CLAMART;92023;31363;11807;19556;666;18890;BAVAY FRANCINE;F;BAVAY;FRANCINE;VEC;8850
Législatives 2002 - 2ème tour;Législatives;2002;2;1;1ère circonscription;25;COLOMBES;92025;23420;10885;12535;369;12166;BARTHE CECILE;F;BARTHE;CECILE;UMP;5489
Législatives 1997 - 2ème tour;Législatives;1997;2;7;7ème circonscription;64;SAINT CLOUD;92064;18908;6982;11926;480;11446;BAUMEL JACQUES;M;BAUMEL;JACQUES;RPR;8427
Présidentielles 1995 - 2ème tour;Présidentielles;1995;2;;;49;MONTROUGE;92049;22293;5222;17071;788;16283;JOSPIN LIONEL;M;JOSPIN;LIONEL;;7562
Présidentielles 2002 - 2ème tour;Présidentielles;2002;2;;;19;CHATENAY MALABRY;92019;15957;2451;13506;460;13046;CHIRAC JACQUES;M;CHIRAC;JACQUES;;11569
Présidentielles 1995 - 1er tour;Présidentielles;1995;1;;;78;VILLENEUVE LA GARENNE;92078;11588;3130;8458;196;8262;CHIRAC JACQUES;M;CHIRAC;JACQUES;;1770
Présidentielles 1995 - 1er tour;Présidentielles;1995;1;;;77;VILLE D'AVRAY;92077;7139;1490;5649;74;5575;VOYNET DOMINIQUE;F;VOYNET;DOMINIQUE;;178
Présidentielles 1995 - 1er tour;Présidentielles;1995;1;;;76;VAUCRESSON;92076;5529;1334;4195;65;4130;LAGUILLER ARLETTE;F;LAGUILLER;ARLETTE;;116
Présidentielles 1995 - 1er tour;Présidentielles;1995;1;;;75;VANVES;92075;15499;3343;12156;236;11920;LAGUILLER ARLETTE;F;LAGUILLER;ARLETTE;;590
Législatives 1993 - 1er tour;Législatives;1993;1;13;13ème circonscription;2;ANTONY;92002;36749;10226;26523;1007;25516;AUBRY ANDRE;M;AUBRY;ANDRE;COM;2794
Législatives 1993 - 1er tour;Législatives;1993;1;12;12ème circonscription;32;FONTENAY AUX ROSES;92032;15091;4963;10128;341;9787;LARCHER ROBERT;M;LARCHER;ROBERT;EXG;149
Législatives 1993 - 1er tour;Législatives;1993;1;4;4ème circonscription;73;SURESNES;92073;21292;6457;14835;522;14313;KERSUZAN NICOLE;F;KERSUZAN;NICOLE;DIV;417
Législatives 1993 - 1er tour;Législatives;1993;1;10;10ème circonscription;75;VANVES;92075;15286;4324;10962;394;10568;DORLIN MICHEL;M;DORLIN;MICHEL;FRN;1131
Législatives 1993 - 1er tour;Législatives;1993;1;10;10ème circonscription;12;BOULOGNE BILLANCOURT;92012;4523;1581;2942;133;2809;DENIAU RAYMOND;M;DENIAU;RAYMOND;EXG;40
Législatives 1993 - 1er tour;Législatives;1993;1;11;11ème circonscription;7;BAGNEUX;92007;21150;7754;13396;474;12922;BONELLI PIERRE;M;BONELLI;PIERRE;MAJ;135
Législatives 1993 - 1er tour;Législatives;1993;1;11;11ème circonscription;7;BAGNEUX;92007;21150;7754;13396;474;12922;AYOUB SERGE;M;AYOUB;SERGE;EXD;24
Législatives 1993 - 1er tour;Législatives;1993;1;12;12ème circonscription;20;CHATILLON;92020;15705;4455;11250;435;10815;FOUCHER J.PIERRE;M;FOUCHER;J.PIERRE;UDF;4692
Législatives 1993 - 1er tour;Législatives;1993;1;12;12ème circonscription;23;CLAMART;92023;30899;9896;21003;704;20299;MOURIER J.PIERRE;M;MOURIER;J.PIERRE;DIV;368
Législatives 1993 - 1er tour;Législatives;1993;1;5;5ème circonscription;44;LEVALLOIS PERRET;92044;27392;7486;19906;624;19282;VIVANT ROGER;M;VIVANT;ROGER;DVD;426
Législatives 1993 - 1er tour;Législatives;1993;1;1;1ère circonscription;36;GENNEVILLIERS;92036;19185;6818;12367;395;11972;BRETON MICHEL;M;BRETON;MICHEL;EXG;194
Législatives 1997 - 1er tour;Législatives;1997;1;2;2ème circonscription;4;ASNIERES SUR SEINE;92004;37154;13729;23425;737;22688;RENAUD GEORGES;M;RENAUD;GEORGES;DVD;31
Législatives 2017 - 1er tour;Législatives;2017;1;1;1ère circonscription;25;COLOMBES;92025;27867;16420;11447;405;11042;BEN M'BAREK Hassan;M;BEN M'BAREK;Hassan;DIV;59
Législatives 2017 - 1er tour;Législatives;2017;1;1;1ère circonscription;25;COLOMBES;92025;27867;16420;11447;405;11042;ARIAS Jacques;M;ARIAS;Jacques;ECO;28
Législatives 2017 - 1er tour;Législatives;2017;1;7;7ème circonscription;64;SAINT CLOUD;92064;19410;7490;11920;102;11818;GUERY Jérôme;M;GUERY;Jérôme;EXD;171
Législatives 2017 - 1er tour;Législatives;2017;1;8;8ème circonscription;47;MARNES LA COQUETTE;92047;1215;451;764;4;760;CHETAILLE Romain;M;CHETAILLE;Romain;DVD;12
Législatives 2017 - 1er tour;Législatives;2017;1;8;8ème circonscription;47;MARNES LA COQUETTE;92047;1215;451;764;4;760;THOMAS Marc;M;THOMAS;Marc;FN;27
Législatives 2017 - 1er tour;Législatives;2017;1;8;8ème circonscription;72;SEVRES;92072;15144;6343;8801;149;8652;DE SAINT ALBIN Stéphane;M;DE SAINT ALBIN;Stéphane;DVD;138
Législatives 2017 - 1er tour;Législatives;2017;1;8;8ème circonscription;76;VAUCRESSON;92076;6187;2474;3713;42;3671;ROURE Françoise;F;ROURE;Françoise;RDG;74
Législatives 2017 - 1er tour;Législatives;2017;1;8;8ème circonscription;76;VAUCRESSON;92076;6187;2474;3713;42;3671;MEROUCHI Sandra;F;MEROUCHI;Sandra;DIV;23
Législatives 2017 - 1er tour;Législatives;2017;1;9;9ème circonscription;12;BOULOGNE BILLANCOURT;92012;64984;30321;34663;987;33676;NOUAILLE Eliott;M;NOUAILLE;Eliott;DVG;619
Législatives 2017 - 1er tour;Législatives;2017;1;10;10ème circonscription;12;BOULOGNE BILLANCOURT;92012;9082;4562;4520;114;4406;LECOCQ Laurence;F;LECOCQ;Laurence;DIV;13
Législatives 2017 - 1er tour;Législatives;2017;1;10;10ème circonscription;40;ISSY LES MOULINEAUX;92040;45375;19009;26366;517;25849;COUVENT Pauline;F;COUVENT;Pauline;ECO;1189
Législatives 2017 - 1er tour;Législatives;2017;1;11;11ème circonscription;7;BAGNEUX;92007;21911;12424;9487;167;9320;EL-BOUZAÏDI CHEIKHI Aze-Dine;M;EL-BOUZAÏDI CHEIKHI;Aze-Dine;ECO;29
Législatives 2017 - 1er tour;Législatives;2017;1;11;11ème circonscription;7;BAGNEUX;92007;21911;12424;9487;167;9320;LEMÉTAIS François;M;LEMÉTAIS;François;DIV;104
Législatives 2017 - 1er tour;Législatives;2017;1;11;11ème circonscription;7;BAGNEUX;92007;21911;12424;9487;167;9320;OUJIBOU Saïd;M;OUJIBOU;Saïd;DVD;48
Législatives 2017 - 1er tour;Législatives;2017;1;11;11ème circonscription;46;MALAKOFF;92046;18448;8148;10300;133;10167;TEIXEIRA Dominique;M;TEIXEIRA;Dominique;EXG;24
Législatives 2017 - 1er tour;Législatives;2017;1;11;11ème circonscription;46;MALAKOFF;92046;18448;8148;10300;133;10167;CUDENNEC Lionel;M;CUDENNEC;Lionel;DIV;51
Législatives 2017 - 1er tour;Législatives;2017;1;11;11ème circonscription;49;MONTROUGE;92049;28914;12071;16843;175;16668;BOUDJENAH Yasmine;F;BOUDJENAH;Yasmine;FI;2072
Législatives 2017 - 1er tour;Législatives;2017;1;12;12ème circonscription;60;LE PLESSIS ROBINSON;92060;19154;7496;11658;130;11528;CANTAT Julien;M;CANTAT;Julien;DIV;59
Législatives 2017 - 1er tour;Législatives;2017;1;13;13ème circonscription;14;BOURG LA REINE;92014;13736;5356;8380;81;8299;DELRIEU Denis;M;DELRIEU;Denis;ECO;520
Législatives 2017 - 2ème tour;Législatives;2017;2;2;2ème circonscription;4;ASNIERES SUR SEINE;92004;48340;25571;22769;1662;21107;AESCHLIMANN Marie-Do;F;AESCHLIMANN;Marie-Do;LR;7998
Législatives 2017 - 2ème tour;Législatives;2017;2;4;4ème circonscription;50;NANTERRE;92050;47651;31219;16432;2247;14185;FLORENNES Isabelle;F;FLORENNES;Isabelle;REM;9474
Législatives 2017 - 2ème tour;Législatives;2017;2;8;8ème circonscription;48;MEUDON;92048;25242;13349;11893;962;10931;MAIRE Jacques;M;MAIRE;Jacques;REM;6460
Législatives 2017 - 1er tour;Législatives;2017;1;3;3ème circonscription;9;BOIS COLOMBES;92009;17921;7869;10052;437;9615;KENLER Virginie;F;KENLER;Virginie;FI;666
Législatives 2017 - 1er tour;Législatives;2017;1;2;2ème circonscription;25;COLOMBES;92025;19668;8354;11314;229;11085;GAROYAN Fabrice;M;GAROYAN;Fabrice;DLF;129
Législatives 2017 - 1er tour;Législatives;2017;1;2;2ème circonscription;25;COLOMBES;92025;19668;8354;11314;229;11085;PARIS Fabienne;F;PARIS;Fabienne;EXG;63
Législatives 2017 - 1er tour;Législatives;2017;1;2;2ème circonscription;25;COLOMBES;92025;19668;8354;11314;229;11085;TAQUET Adrien;M;TAQUET;Adrien;REM;5427
Législatives 2017 - 1er tour;Législatives;2017;1;1;1ère circonscription;78;VILLENEUVE LA GARENNE;92078;12445;8430;4015;143;3872;DJELLAB Nora;F;DJELLAB;Nora;DVD;36
Législatives 2017 - 1er tour;Législatives;2017;1;2;2ème circonscription;4;ASNIERES SUR SEINE;92004;48340;22557;25783;414;25369;TAQUET Adrien;M;TAQUET;Adrien;REM;11709
Législatives 2017 - 1er tour;Législatives;2017;1;1;1ère circonscription;78;VILLENEUVE LA GARENNE;92078;12445;8430;4015;143;3872;JAN Corinne;F;JAN;Corinne;EXG;6
Législatives 2017 - 1er tour;Législatives;2017;1;1;1ère circonscription;25;COLOMBES;92025;27867;16420;11447;405;11042;GRIMAL Jean;M;GRIMAL;Jean;EXG;17
Législatives 2017 - 1er tour;Législatives;2017;1;5;5ème circonscription;44;LEVALLOIS PERRET;92044;41751;17632;24119;255;23864;LAMBERT Mireille;F;LAMBERT;Mireille;EXG;53
Législatives 2017 - 1er tour;Législatives;2017;1;5;5ème circonscription;44;LEVALLOIS PERRET;92044;41751;17632;24119;255;23864;TERCHI Aïssa;M;TERCHI;Aïssa;FI;1236
Législatives 2017 - 1er tour;Législatives;2017;1;4;4ème circonscription;50;NANTERRE;92050;47651;26455;21196;432;20764;BIGDADE Habiba;F;BIGDADE;Habiba;SOC;1153
Législatives 2017 - 1er tour;Législatives;2017;1;4;4ème circonscription;73;SURESNES;92073;28524;12725;15799;423;15376;BRUNET Antoine;M;BRUNET;Antoine;EXG;10
Législatives 2017 - 1er tour;Législatives;2017;1;5;5ème circonscription;24;CLICHY;92024;28620;14628;13992;265;13727;TOBIANO Michel;M;TOBIANO;Michel;ECO;51
Législatives 2017 - 1er tour;Législatives;2017;1;6;6ème circonscription;51;NEUILLY SUR SEINE;92051;37215;15249;21966;119;21847;LAGARDE Patrick;M;LAGARDE;Patrick;DLF;154
Législatives 2017 - 1er tour;Législatives;2017;1;5;5ème circonscription;44;LEVALLOIS PERRET;92044;41751;17632;24119;255;23864;CALVEZ Céline;F;CALVEZ;Céline;REM;10441
Législatives 2017 - 1er tour;Législatives;2017;1;6;6ème circonscription;26;COURBEVOIE;92026;8107;4228;3879;107;3772;LAGARDE Patrick;M;LAGARDE;Patrick;DLF;59
Législatives 2017 - 1er tour;Législatives;2017;1;7;7ème circonscription;33;GARCHES;92033;12777;5514;7263;115;7148;BERDOATI Eric;M;BERDOATI;Eric;LR;2112
Présidentielles 2002 - 1er tour;Présidentielles;2002;1;;;24;CLICHY;92024;24491;8395;16096;399;15697;MEGRET BRUNO;M;MEGRET;BRUNO;;363
Présidentielles 2002 - 1er tour;Présidentielles;2002;1;;;24;CLICHY;92024;24491;8395;16096;399;15697;LE PEN JEAN-MARIE;M;LE PEN;JEAN-MARIE;;2377
Présidentielles 2002 - 1er tour;Présidentielles;2002;1;;;24;CLICHY;92024;24491;8395;16096;399;15697;CHEVENEMENT JEAN-PIERRE;M;CHEVENEMENT;JEAN-PIERRE;;1093
Présidentielles 2002 - 1er tour;Présidentielles;2002;1;;;25;COLOMBES;92025;39608;13654;25954;571;25383;BAYROU FRANCOIS;M;BAYROU;FRANCOIS;;1676
Présidentielles 2002 - 1er tour;Présidentielles;2002;1;;;32;FONTENAY AUX ROSES;92032;14148;4309;9839;204;9635;JOSPIN LIONEL;M;JOSPIN;LIONEL;;1938
Présidentielles 2002 - 1er tour;Présidentielles;2002;1;;;33;GARCHES;92033;11708;3920;7788;137;7651;CHIRAC JACQUES;M;CHIRAC;JACQUES;;2412
Présidentielles 2002 - 1er tour;Présidentielles;2002;1;;;36;GENNEVILLIERS;92036;18213;6933;11280;303;10977;GLUCKSTEIN DANIEL;M;GLUCKSTEIN;DANIEL;;57
Présidentielles 2002 - 2ème tour;Présidentielles;2002;2;;;44;LEVALLOIS PERRET;92044;33618;5548;28070;800;27270;CHIRAC JACQUES;M;CHIRAC;JACQUES;;24153
Présidentielles 2002 - 2ème tour;Présidentielles;2002;2;;;71;SCEAUX;92071;12919;1935;10984;295;10689;LE PEN JEAN-MARIE;M;LE PEN;JEAN-MARIE;;976
Présidentielles 2002 - 2ème tour;Présidentielles;2002;2;;;73;SURESNES;92073;22099;4188;17911;579;17332;LE PEN JEAN-MARIE;M;LE PEN;JEAN-MARIE;;2056
Présidentielles 2002 - 2ème tour;Présidentielles;2002;2;;;76;VAUCRESSON;92076;5854;1104;4750;105;4645;LE PEN JEAN-MARIE;M;LE PEN;JEAN-MARIE;;539
Présidentielles 2017 - 2ème tour;Présidentielles;2017;2;;;7;BAGNEUX;92007;21878;6554;15324;1399;13925;MACRON Emmanuel;M;MACRON;Emmanuel;;11506
Présidentielles 2017 - 2ème tour;Présidentielles;2017;2;;;24;CLICHY;92024;28589;7000;21589;1881;19708;MACRON Emmanuel;M;MACRON;Emmanuel;;17052
Présidentielles 2017 - 2ème tour;Présidentielles;2017;2;;;44;LEVALLOIS PERRET;92044;41716;8651;33065;2640;30425;MACRON Emmanuel;M;MACRON;Emmanuel;;26166
Présidentielles 2017 - 2ème tour;Présidentielles;2017;2;;;49;MONTROUGE;92049;28903;5913;22990;1855;21135;LE PEN Marine;F;LE PEN;Marine;;2590
Présidentielles 2017 - 2ème tour;Présidentielles;2017;2;;;75;VANVES;92075;18500;4079;14421;1175;13246;LE PEN Marine;F;LE PEN;Marine;;1632
Présidentielles 2007 - 2ème tour;Présidentielles;2007;2;;;2;ANTONY;92002;39361;5129;34232;1507;32725;ROYAL Ségolène;F;ROYAL;Ségolène;;15483
Présidentielles 2007 - 2ème tour;Présidentielles;2007;2;;;9;BOIS COLOMBES;92009;16112;2461;13651;517;13134;SARKOZY Nicolas;M;SARKOZY;Nicolas;;7654
Présidentielles 2007 - 2ème tour;Présidentielles;2007;2;;;36;GENNEVILLIERS;92036;19889;3693;16196;493;15703;ROYAL Ségolène;F;ROYAL;Ségolène;;10831
Présidentielles 2007 - 2ème tour;Présidentielles;2007;2;;;62;PUTEAUX;92062;26805;3862;22943;918;22025;SARKOZY Nicolas;M;SARKOZY;Nicolas;;12836
Présidentielles 2007 - 2ème tour;Présidentielles;2007;2;;;77;VILLE D'AVRAY;92077;7272;712;6560;300;6260;SARKOZY Nicolas;M;SARKOZY;Nicolas;;4409
Législatives 2007 - 1er tour;Législatives;2007;1;8;8ème circonscription;77;VILLE D'AVRAY;92077;7475;2429;5046;60;4986;FILLOUX Delphine;F;FILLOUX;Delphine;DIV;73
Législatives 2007 - 1er tour;Législatives;2007;1;8;8ème circonscription;77;VILLE D'AVRAY;92077;7475;2429;5046;60;4986;SUCHARD Sophie;F;SUCHARD;Sophie;EXG;6
Législatives 2007 - 1er tour;Législatives;2007;1;2;2ème circonscription;4;ASNIERES SUR SEINE;92004;44110;17783;26327;312;26015;VILLIERS Claire;F;VILLIERS;Claire;EXG;439
Législatives 2007 - 1er tour;Législatives;2007;1;13;13ème circonscription;2;ANTONY;92002;39807;13942;25865;456;25409;HOLLEBEKE Dominique;F;HOLLEBEKE;Dominique;MPF;277
Législatives 2007 - 1er tour;Législatives;2007;1;13;13ème circonscription;2;ANTONY;92002;39807;13942;25865;456;25409;IORIO Catherine;F;IORIO;Catherine;FN;669
Législatives 2007 - 1er tour;Législatives;2007;1;9;9ème circonscription;12;BOULOGNE BILLANCOURT;92012;60773;22422;38351;535;37816;BAGUET P-Christophe;M;BAGUET;P-Christophe;MAJ;22433
Législatives 2007 - 1er tour;Législatives;2007;1;8;8ème circonscription;72;SEVRES;92072;14460;5279;9181;151;9030;GONNET Nicolas;M;GONNET;Nicolas;COM;158
Législatives 2007 - 1er tour;Législatives;2007;1;2;2ème circonscription;25;COLOMBES;92025;18336;7144;11192;207;10985;AESCHLIMANN Manuel;M;AESCHLIMANN;Manuel;UMP;5185
Législatives 2007 - 1er tour;Législatives;2007;1;6;6ème circonscription;51;NEUILLY SUR SEINE;92051;39134;14738;24396;185;24211;EISENBERG Mathilde;F;EISENBERG;Mathilde;EXG;103
Législatives 2007 - 1er tour;Législatives;2007;1;6;6ème circonscription;51;NEUILLY SUR SEINE;92051;39134;14738;24396;185;24211;HARMAND Alexandre;M;HARMAND;Alexandre;UDFD;1725
Législatives 2007 - 1er tour;Législatives;2007;1;11;11ème circonscription;49;MONTROUGE;92049;26595;9698;16897;213;16684;AMIABLE Marie-Hélène;F;AMIABLE;Marie-Hélène;COM;1668
Législatives 2007 - 1er tour;Législatives;2007;1;11;11ème circonscription;49;MONTROUGE;92049;26595;9698;16897;213;16684;BONJEAN Hubert;M;BONJEAN;Hubert;FN;455
Législatives 2007 - 1er tour;Législatives;2007;1;10;10ème circonscription;40;ISSY LES MOULINEAUX;92040;38520;14017;24503;359;24144;TERRET Eugène;M;TERRET;Eugène;FN;558
Législatives 2007 - 1er tour;Législatives;2007;1;5;5ème circonscription;24;CLICHY;92024;28799;12380;16419;297;16122;CUCULIERE Roger;M;CUCULIERE;Roger;EXD;53
Législatives 2007 - 1er tour;Législatives;2007;1;5;5ème circonscription;24;CLICHY;92024;28799;12380;16419;297;16122;FURON Férial;F;FURON;Férial;DVD;55
Législatives 2007 - 1er tour;Législatives;2007;1;5;5ème circonscription;24;CLICHY;92024;28799;12380;16419;297;16122;GALLAIS Alain;M;GALLAIS;Alain;FN;499
Législatives 2007 - 1er tour;Législatives;2007;1;12;12ème circonscription;20;CHATILLON;92020;20661;7083;13578;137;13441;ZANOLIN Ludovic;F;ZANOLIN;Ludovic;COM;337
Législatives 2007 - 1er tour;Législatives;2007;1;7;7ème circonscription;63;RUEIL MALMAISON;92063;51481;18902;32579;337;32242;INDJIAN Patrick;M;INDJIAN;Patrick;DVG;122
Législatives 2007 - 1er tour;Législatives;2007;1;10;10ème circonscription;40;ISSY LES MOULINEAUX;92040;38520;14017;24503;359;24144;BOTTET Philippe;M;BOTTET;Philippe;EXG;51
Législatives 2007 - 1er tour;Législatives;2007;1;1;1ère circonscription;36;GENNEVILLIERS;92036;20048;9522;10526;189;10337;ROBERT Bertrand;M;ROBERT;Bertrand;EXD;45
Législatives 2007 - 1er tour;Législatives;2007;1;1;1ère circonscription;36;GENNEVILLIERS;92036;20048;9522;10526;189;10337;GRIMAL Jean;M;GRIMAL;Jean;EXG;99
Législatives 2007 - 1er tour;Législatives;2007;1;8;8ème circonscription;47;MARNES LA COQUETTE;92047;1074;316;758;5;753;RUSSO Annick;F;RUSSO;Annick;DIV;0
Législatives 2007 - 2ème tour;Législatives;2007;2;2;2ème circonscription;25;COLOMBES;92025;18336;8059;10277;373;9904;ETCHEBERRY Michèle;F;ETCHEBERRY;Michèle;SOC;4432
Législatives 2007 - 2ème tour;Législatives;2007;2;11;11ème circonscription;49;MONTROUGE;92049;26595;10737;15858;381;15477;METTON Jean-Loup;M;METTON;Jean-Loup;MAJ;8260
Législatives 2017 - 1er tour;Législatives;2017;1;1;1ère circonscription;78;VILLENEUVE LA GARENNE;92078;12445;8430;4015;143;3872;FRONTIGNY Nadia;F;FRONTIGNY;Nadia;LR;422
Législatives 2017 - 1er tour;Législatives;2017;1;1;1ère circonscription;78;VILLENEUVE LA GARENNE;92078;12445;8430;4015;143;3872;FAUCILLON Elsa;F;FAUCILLON;Elsa;COM;255
Législatives 2017 - 1er tour;Législatives;2017;1;1;1ère circonscription;78;VILLENEUVE LA GARENNE;92078;12445;8430;4015;143;3872;MEHARGA Ahcen;M;MEHARGA;Ahcen;ECO;7
Législatives 2017 - 1er tour;Législatives;2017;1;3;3ème circonscription;9;BOIS COLOMBES;92009;17921;7869;10052;437;9615;PARIS Joëlle;F;PARIS;Joëlle;ECO;350
Législatives 2017 - 2ème tour;Législatives;2017;2;1;1ère circonscription;36;GENNEVILLIERS;92036;22174;14091;8083;522;7561;FAUCILLON Elsa;F;FAUCILLON;Elsa;COM;5241
Législatives 2017 - 2ème tour;Législatives;2017;2;3;3ème circonscription;35;LA GARENNE COLOMBES;92035;18829;9723;9106;579;8527;HENNION Christine;F;HENNION;Christine;REM;4848
Législatives 2017 - 2ème tour;Législatives;2017;2;8;8ème circonscription;76;VAUCRESSON;92076;6187;2981;3206;125;3081;MAIRE Jacques;M;MAIRE;Jacques;REM;1683
Législatives 2017 - 2ème tour;Législatives;2017;2;10;10ème circonscription;40;ISSY LES MOULINEAUX;92040;45375;22953;22422;2198;20224;COSTE Jeremy;M;COSTE;Jeremy;UDI;8587
Législatives 2017 - 2ème tour;Législatives;2017;2;12;12ème circonscription;32;FONTENAY AUX ROSES;92032;16049;9154;6895;706;6189;BOURLANGES Jean-Louis;M;BOURLANGES;Jean-Louis;MDM;4005
Législatives 2017 - 2ème tour;Législatives;2017;2;12;12ème circonscription;60;LE PLESSIS ROBINSON;92060;19154;8662;10492;642;9850;PEMEZEC Philippe;M;PEMEZEC;Philippe;LR;5622
Législatives 2017 - 2ème tour;Législatives;2017;2;13;13ème circonscription;71;SCEAUX;92071;15078;7708;7370;551;6819;DUMAS Frédérique;F;DUMAS;Frédérique;REM;4424
Législatives 2007 - 1er tour;Législatives;2007;1;8;8ème circonscription;76;VAUCRESSON;92076;6076;2206;3870;46;3824;GUILLET Jean-Jacques;M;GUILLET;Jean-Jacques;UMP;2605
Législatives 2007 - 1er tour;Législatives;2007;1;4;4ème circonscription;73;SURESNES;92073;24666;8949;15717;206;15511;DUPUY Christian;M;DUPUY;Christian;UMP;8209
Législatives 2002 - 1er tour;Législatives;2002;1;6;6ème circonscription;51;NEUILLY SUR SEINE;92051;39134;14738;24396;185;24211;CECCALDI-RAYNAUD Joëlle;F;CECCALDI-RAYNAUD;Joëlle;UMP;13355
Législatives 2002 - 1er tour;Législatives;2002;1;6;6ème circonscription;51;NEUILLY SUR SEINE;92051;39134;14738;24396;185;24211;STRAUSS Anne-Christine;F;STRAUSS;Anne-Christine;FN;640
Législatives 2002 - 1er tour;Législatives;2002;1;6;6ème circonscription;62;PUTEAUX;92062;26791;8829;17962;396;17566;GRANGER Marie;M;GRANGER;Marie;DIV;0
Législatives 2002 - 1er tour;Législatives;2002;1;7;7ème circonscription;63;RUEIL MALMAISON;92063;51481;18902;32579;337;32242;BARRE Camille;F;BARRE;Camille;COM;489
Législatives 2002 - 1er tour;Législatives;2002;1;7;7ème circonscription;63;RUEIL MALMAISON;92063;51481;18902;32579;337;32242;ROCHERON Bertrand;M;ROCHERON;Bertrand;SOC;5632
Législatives 2002 - 1er tour;Législatives;2002;1;13;13ème circonscription;71;SCEAUX;92071;14129;4679;9450;74;9376;LEPEUVE Stéphane;M;LEPEUVE;Stéphane;EXG;148
Législatives 2002 - 1er tour;Législatives;2002;1;13;13ème circonscription;71;SCEAUX;92071;14129;4679;9450;74;9376;SARFATI André;M;SARFATI;André;DIV;58
Législatives 2002 - 1er tour;Législatives;2002;1;13;13ème circonscription;71;SCEAUX;92071;14129;4679;9450;74;9376;IORIO Catherine;F;IORIO;Catherine;FN;181
Législatives 2002 - 1er tour;Législatives;2002;1;8;8ème circonscription;72;SEVRES;92072;14460;5279;9181;151;9030;GUILLET Jean-Jacques;M;GUILLET;Jean-Jacques;UMP;4294
Législatives 2002 - 1er tour;Législatives;2002;1;4;4ème circonscription;73;SURESNES;92073;24666;8949;15717;206;15511;FRANCOIS Jean-Michel;M;FRANCOIS;Jean-Michel;EXG;22
Législatives 2002 - 1er tour;Législatives;2002;1;4;4ème circonscription;73;SURESNES;92073;24666;8949;15717;206;15511;MARDOCH Brigitte;F;MARDOCH;Brigitte;ECO;97
Législatives 2002 - 1er tour;Législatives;2002;1;4;4ème circonscription;73;SURESNES;92073;24666;8949;15717;206;15511;BONNECHERE Nathalie;F;BONNECHERE;Nathalie;FN;501
Législatives 2002 - 1er tour;Législatives;2002;1;8;8ème circonscription;76;VAUCRESSON;92076;6076;2206;3870;46;3824;BEZAULT Christine;F;BEZAULT;Christine;DIV;20
Législatives 2002 - 1er tour;Législatives;2002;1;1;1ère circonscription;78;VILLENEUVE LA GARENNE;92078;13038;7211;5827;131;5696;MUZEAU Roland;M;MUZEAU;Roland;COM;815
Législatives 2002 - 2ème tour;Législatives;2002;2;5;5ème circonscription;24;CLICHY;92024;24685;10326;14359;540;13819;BALKANY PATRICK;M;BALKANY;PATRICK;DVD;3235
Législatives 2002 - 2ème tour;Législatives;2002;2;1;1ère circonscription;25;COLOMBES;92025;23420;10885;12535;369;12166;BRUNHES JACQUES;M;BRUNHES;JACQUES;COM;6677
Législatives 2002 - 2ème tour;Législatives;2002;2;1;1ère circonscription;36;GENNEVILLIERS;92036;18324;8861;9463;271;9192;BRUNHES JACQUES;M;BRUNHES;JACQUES;COM;6685
Législatives 1997 - 2ème tour;Législatives;1997;2;3;3ème circonscription;35;LA GARENNE COLOMBES;92035;13992;4607;9385;405;8980;KOSSOWSKI JACQUES;M;KOSSOWSKI;JACQUES;DVD;3738
Législatives 1997 - 2ème tour;Législatives;1997;2;7;7ème circonscription;63;RUEIL MALMAISON;92063;44715;15188;29527;1355;28172;MAULION CHRISTIANE;F;MAULION;CHRISTIANE;SOC;10177
Législatives 1997 - 2ème tour;Législatives;1997;2;8;8ème circonscription;72;SEVRES;92072;13776;3819;9957;476;9481;GUILLET J.JACQUES;M;GUILLET;J.JACQUES;RPR;5288
Législatives 2012 - 2ème tour;Législatives;2012;2;13;13ème circonscription;14;BOURG LA REINE;92014;13306;4586;8720;216;8504;DEVEDJIAN Patrick;M;DEVEDJIAN;Patrick;UMP;4157
Législatives 2012 - 2ème tour;Législatives;2012;2;5;5ème circonscription;24;CLICHY;92024;29276;13662;15614;926;14688;CATOIRE Gilles;M;CATOIRE;Gilles;SOC;10117
Législatives 2012 - 2ème tour;Législatives;2012;2;7;7ème circonscription;33;GARCHES;92033;12412;5747;6665;240;6425;ROCHERON Bertrand;M;ROCHERON;Bertrand;SOC;2086
Législatives 2012 - 2ème tour;Législatives;2012;2;8;8ème circonscription;47;MARNES LA COQUETTE;92047;1085;358;727;22;705;LIME-BIFFE Catherine;F;LIME-BIFFE;Catherine;SOC;141
Législatives 2002 - 1er tour;Législatives;2002;1;2;2ème circonscription;4;ASNIERES SUR SEINE;92004;44110;17783;26327;312;26015;GOISET Philippe;M;GOISET;Philippe;EXG;151
Législatives 2002 - 1er tour;Législatives;2002;1;2;2ème circonscription;4;ASNIERES SUR SEINE;92004;44110;17783;26327;312;26015;ECH-CHETOUANI Zouhairr;M;ECH-CHETOUANI;Zouhairr;DIV;365
Législatives 2002 - 1er tour;Législatives;2002;1;2;2ème circonscription;4;ASNIERES SUR SEINE;92004;44110;17783;26327;312;26015;SALLES Laurent;M;SALLES;Laurent;FN;824
Législatives 2002 - 1er tour;Législatives;2002;1;13;13ème circonscription;14;BOURG LA REINE;92014;13381;4391;8990;78;8912;SARFATI André;M;SARFATI;André;DIV;85
Législatives 2012 - 1er tour;Législatives;2012;1;2;2ème circonscription;4;ASNIERES SUR SEINE;92004;45114;18545;26569;310;26259;MALEYRE Alix;F;MALEYRE;Alix;DVD;159
Législatives 2012 - 1er tour;Législatives;2012;1;2;2ème circonscription;4;ASNIERES SUR SEINE;92004;45114;18545;26569;310;26259;L'HUILLIER Guillaume;M;L'HUILLIER;Guillaume;FN;1586
Législatives 2012 - 1er tour;Législatives;2012;1;8;8ème circonscription;22;CHAVILLE;92022;12808;4688;8120;75;8045;PAILLARD Christophe;M;PAILLARD;Christophe;AUT;26
Législatives 2012 - 1er tour;Législatives;2012;1;12;12ème circonscription;23;CLAMART;92023;34173;13440;20733;193;20540;CHIVILO Isabelle;F;CHIVILO;Isabelle;ECO;271
Législatives 2012 - 1er tour;Législatives;2012;1;5;5ème circonscription;24;CLICHY;92024;29276;13521;15755;274;15481;LAMBERT Mireille;F;LAMBERT;Mireille;EXG;99
Législatives 2012 - 1er tour;Législatives;2012;1;5;5ème circonscription;24;CLICHY;92024;29276;13521;15755;274;15481;RONDEPIERRE Geoffroy;M;RONDEPIERRE;Geoffroy;FN;1160
Législatives 2012 - 1er tour;Législatives;2012;1;2;2ème circonscription;25;COLOMBES;92025;18458;7115;11343;114;11229;YADE Rama;F;YADE;Rama;PRV;1977
Législatives 2012 - 1er tour;Législatives;2012;1;12;12ème circonscription;32;FONTENAY AUX ROSES;92032;15230;5971;9259;85;9174;CARRASCO Julia;F;CARRASCO;Julia;DVD;78
Législatives 2012 - 1er tour;Législatives;2012;1;7;7ème circonscription;33;GARCHES;92033;12412;5093;7319;98;7221;PIERSON Jean-Christophe;M;PIERSON;Jean-Christophe;DVD;177
Législatives 2012 - 1er tour;Législatives;2012;1;3;3ème circonscription;35;LA GARENNE COLOMBES;92035;17314;7036;10278;79;10199;LASSERRE Jean-André;M;LASSERRE;Jean-André;SOC;3133
Législatives 2012 - 1er tour;Législatives;2012;1;3;3ème circonscription;35;LA GARENNE COLOMBES;92035;17314;7036;10278;79;10199;EL-BOUZAIDI CHEIKHI Azedine;M;EL-BOUZAIDI CHEIKHI;Azedine;ECO;39
Législatives 2012 - 1er tour;Législatives;2012;1;1;1ère circonscription;36;GENNEVILLIERS;92036;20795;10523;10272;192;10080;CARILLON Rémi;M;CARILLON;Rémi;FN;1042
Législatives 2012 - 1er tour;Législatives;2012;1;10;10ème circonscription;40;ISSY LES MOULINEAUX;92040;42014;16484;25530;277;25253;KNITTEL Gautier;M;KNITTEL;Gautier;AUT;191
Législatives 2012 - 1er tour;Législatives;2012;1;5;5ème circonscription;44;LEVALLOIS PERRET;92044;39546;14667;24879;238;24641;GITTON Mireille;F;GITTON;Mireille;RDG;69
Législatives 2012 - 1er tour;Législatives;2012;1;11;11ème circonscription;46;MALAKOFF;92046;18858;7608;11250;119;11131;DE FONTENAILLES Marie;F;DE FONTENAILLES;Marie;FN;828
Législatives 2012 - 1er tour;Législatives;2012;1;10;10ème circonscription;48;MEUDON;92048;5576;2083;3493;26;3467;LACOMBE Maxime;M;LACOMBE;Maxime;ECO;56
Législatives 2012 - 1er tour;Législatives;2012;1;11;11ème circonscription;49;MONTROUGE;92049;27889;10680;17209;123;17086;SOMMARUGA Julie;F;SOMMARUGA;Julie;SOC;5884
Législatives 2002 - 1er tour;Législatives;2002;1;12;12ème circonscription;23;CLAMART;92023;32916;11487;21429;154;21275;DELOM Christian;M;DELOM;Christian;UDFD;2572
Législatives 2002 - 1er tour;Législatives;2002;1;1;1ère circonscription;25;COLOMBES;92025;26192;12273;13919;366;13553;SARRE Philippe;M;SARRE;Philippe;SOC;4404
Législatives 2002 - 1er tour;Législatives;2002;1;1;1ère circonscription;25;COLOMBES;92025;26192;12273;13919;366;13553;KADUR Alexandre;M;KADUR;Alexandre;DVD;42
Législatives 2002 - 1er tour;Législatives;2002;1;1;1ère circonscription;36;GENNEVILLIERS;92036;20048;9522;10526;189;10337;DARRACQ Michel;M;DARRACQ;Michel;DIV;0
Législatives 2002 - 1er tour;Législatives;2002;1;1;1ère circonscription;36;GENNEVILLIERS;92036;20048;9522;10526;189;10337;LEGHMARA Leïla;F;LEGHMARA;Leïla;UDFD;495
Législatives 2002 - 1er tour;Législatives;2002;1;1;1ère circonscription;36;GENNEVILLIERS;92036;20048;9522;10526;189;10337;VIGNON Véronique;F;VIGNON;Véronique;UMP;1914
Législatives 2002 - 1er tour;Législatives;2002;1;8;8ème circonscription;48;MEUDON;92048;25427;9683;15744;202;15542;GUILLET Jean-Jacques;M;GUILLET;Jean-Jacques;UMP;7135
Législatives 2002 - 1er tour;Législatives;2002;1;10;10ème circonscription;48;MEUDON;92048;5066;1864;3202;29;3173;VENTURINI Jean-Michel;M;VENTURINI;Jean-Michel;DIV;0
Législatives 2002 - 1er tour;Législatives;2002;1;6;6ème circonscription;51;NEUILLY SUR SEINE;92051;39134;14738;24396;185;24211;HARMAND Alexandre;M;HARMAND;Alexandre;UDFD;1725
Législatives 2002 - 1er tour;Législatives;2002;1;12;12ème circonscription;60;LE PLESSIS ROBINSON;92060;16776;5588;11188;123;11065;ANTZENBERGER Philippe;M;ANTZENBERGER;Philippe;EXG;191
Législatives 2002 - 1er tour;Législatives;2002;1;12;12ème circonscription;60;LE PLESSIS ROBINSON;92060;16776;5588;11188;123;11065;DELMATTO Geneviève;F;DELMATTO;Geneviève;EXD;23
Législatives 2002 - 1er tour;Législatives;2002;1;7;7ème circonscription;64;SAINT CLOUD;92064;19115;6812;12303;93;12210;TERRAZZONI Valérie;F;TERRAZZONI;Valérie;DIV;48
Législatives 2002 - 1er tour;Législatives;2002;1;8;8ème circonscription;72;SEVRES;92072;14460;5279;9181;151;9030;BOUCHARD Renaud;M;BOUCHARD;Renaud;DIV;6
Législatives 2002 - 1er tour;Législatives;2002;1;10;10ème circonscription;75;VANVES;92075;17351;5929;11422;137;11285;ALEZARD Lysiane;F;ALEZARD;Lysiane;COM;283
Législatives 2002 - 1er tour;Législatives;2002;1;10;10ème circonscription;75;VANVES;92075;17351;5929;11422;137;11285;BINDER Sabrina;F;BINDER;Sabrina;DIV;73
Législatives 2002 - 1er tour;Législatives;2002;1;10;10ème circonscription;75;VANVES;92075;17351;5929;11422;137;11285;ARIPA Alain;M;ARIPA;Alain;MPF;127
Législatives 2002 - 1er tour;Législatives;2002;1;8;8ème circonscription;76;VAUCRESSON;92076;6076;2206;3870;46;3824;ROY Caroline;F;ROY;Caroline;RDG;426
Législatives 2002 - 1er tour;Législatives;2002;1;1;1ère circonscription;78;VILLENEUVE LA GARENNE;92078;13038;7211;5827;131;5696;DARRACQ Michel;M;DARRACQ;Michel;DIV;0
Législatives 1997 - 1er tour;Législatives;1997;1;11;11ème circonscription;46;MALAKOFF;92046;19124;7233;11891;338;11553;BASSINET PHILIPPE;M;BASSINET;PHILIPPE;SOC;1667
Législatives 1997 - 1er tour;Législatives;1997;1;5;5ème circonscription;44;LEVALLOIS PERRET;92044;28281;9315;18966;650;18316;GALLAIS ALAIN;M;GALLAIS;ALAIN;FRN;2154
Législatives 1997 - 1er tour;Législatives;1997;1;2;2ème circonscription;4;ASNIERES SUR SEINE;92004;37154;13729;23425;737;22688;DEBIONNE ALAIN;M;DEBIONNE;ALAIN;DVD;629
Législatives 1997 - 1er tour;Législatives;1997;1;13;13ème circonscription;71;SCEAUX;92071;13168;3887;9281;266;9015;MERLE J.FRANCOIS;M;MERLE;J.FRANCOIS;SOC;2067
Législatives 1997 - 1er tour;Législatives;1997;1;7;7ème circonscription;64;SAINT CLOUD;92064;18908;7095;11813;417;11396;ARIA D LUIGI;M;ARIA D;LUIGI;DIV;0
Législatives 1997 - 1er tour;Législatives;1997;1;13;13ème circonscription;71;SCEAUX;92071;13168;3887;9281;266;9015;ROMAN INGRID;F;ROMAN;INGRID;DIV;0
Législatives 1997 - 1er tour;Législatives;1997;1;3;3ème circonscription;9;BOIS COLOMBES;92009;14757;5447;9310;293;9017;GALICIER BEATRICE;F;GALICIER;BEATRICE;COM;454
Législatives 1997 - 1er tour;Législatives;1997;1;8;8ème circonscription;22;CHAVILLE;92022;12268;3930;8338;262;8076;AMSALLEM EDDY;M;AMSALLEM;EDDY;EXG;95
Législatives 1997 - 1er tour;Législatives;1997;1;1;1ère circonscription;78;VILLENEUVE LA GARENNE;92078;11471;4645;6826;211;6615;DRUYER J.JACQUES;M;DRUYER;J.JACQUES;DVG;115
Législatives 1997 - 1er tour;Législatives;1997;1;8;8ème circonscription;76;VAUCRESSON;92076;5546;1861;3685;139;3546;AMSALLEM EDDY;M;AMSALLEM;EDDY;EXG;48
Législatives 1997 - 1er tour;Législatives;1997;1;11;11ème circonscription;46;MALAKOFF;92046;19124;7233;11891;338;11553;BAUDRY D'ASSON DE ROLAND;M;BAUDRY D'ASSON DE;ROLAND;DVD;196
Législatives 1997 - 1er tour;Législatives;1997;1;10;10ème circonscription;48;MEUDON;92048;4118;1375;2743;67;2676;DAUJON XAVIER;M;DAUJON;XAVIER;DVD;91
Législatives 1997 - 1er tour;Législatives;1997;1;8;8ème circonscription;72;SEVRES;92072;13776;4413;9363;352;9011;JOURNE SILIAN;M;JOURNE;SILIAN;DVD;375
Législatives 2002 - 2ème tour;Législatives;2002;2;10;10ème circonscription;40;ISSY LES MOULINEAUX;92040;32364;11826;20538;545;19993;SCHMID LUCILE;F;SCHMID;LUCILE;SOC;7525
Législatives 2002 - 2ème tour;Législatives;2002;2;10;10ème circonscription;48;MEUDON;92048;4041;1628;2413;55;2358;SANTINI ANDRE;M;SANTINI;ANDRE;UDF;1382
Législatives 2002 - 2ème tour;Législatives;2002;2;1;1ère circonscription;78;VILLENEUVE LA GARENNE;92078;11470;6358;5112;189;4923;BRUNHES JACQUES;M;BRUNHES;JACQUES;COM;2498
Législatives 1997 - 1er tour;Législatives;1997;1;9;9ème circonscription;12;BOULOGNE BILLANCOURT;92012;53287;18902;34385;948;33437;POIGNANT DU FONTENIOUX ROLAND;M;POIGNANT DU FONTENIOUX;ROLAND;DVD;118
Législatives 1997 - 1er tour;Législatives;1997;1;6;6ème circonscription;51;NEUILLY SUR SEINE;92051;35571;12347;23224;570;22654;ANSART DE LESSAN FRANCOISE;F;ANSART DE LESSAN;FRANCOISE;DVD;1122
Législatives 1997 - 1er tour;Législatives;1997;1;7;7ème circonscription;63;RUEIL MALMAISON;92063;44715;14813;29902;1094;28808;SUJEVIC J.GABRIEL;M;SUJEVIC;J.GABRIEL;DVD;9
Législatives 1997 - 1er tour;Législatives;1997;1;7;7ème circonscription;63;RUEIL MALMAISON;92063;44715;14813;29902;1094;28808;CAGNIER MAURICE;M;CAGNIER;MAURICE;ECO;467
Législatives 1997 - 1er tour;Législatives;1997;1;13;13ème circonscription;14;BOURG LA REINE;92014;12587;4431;8156;266;7890;MERLE J.FRANCOIS;M;MERLE;J.FRANCOIS;SOC;1866
Législatives 1997 - 2ème tour;Législatives;1997;2;13;13ème circonscription;14;BOURG LA REINE;92014;12587;4019;8568;399;8169;MERLE J.FRANCOIS;M;MERLE;J.FRANCOIS;SOC;3245
Législatives 1997 - 2ème tour;Législatives;1997;2;10;10ème circonscription;12;BOULOGNE BILLANCOURT;92012;4529;1615;2914;124;2790;JANVIER GUY;M;JANVIER;GUY;SOC;1466
Législatives 1997 - 2ème tour;Législatives;1997;2;3;3ème circonscription;26;COURBEVOIE;92026;35738;10796;24942;758;24184;LAHEURTE RENAUD;M;LAHEURTE;RENAUD;SOC;8446
Législatives 1997 - 1er tour;Législatives;1997;1;7;7ème circonscription;63;RUEIL MALMAISON;92063;44715;14813;29902;1094;28808;MUGNIER JEANNINE;F;MUGNIER;JEANNINE;EXG;431
Législatives 1997 - 1er tour;Législatives;1997;1;4;4ème circonscription;50;NANTERRE;92050;38533;13799;24734;766;23968;GARDENT OLIVIER;M;GARDENT;OLIVIER;EXG;101
Législatives 1997 - 1er tour;Législatives;1997;1;3;3ème circonscription;9;BOIS COLOMBES;92009;14757;5447;9310;293;9017;POULTIER LAURENT;M;POULTIER;LAURENT;DVD;241
Législatives 1993 - 2ème tour;Législatives;1993;2;11;11ème circonscription;46;MALAKOFF;92046;19559;6884;12675;609;12066;JAMBU JANINE;F;JAMBU;JANINE;COM;7556
Législatives 2012 - 2ème tour;Législatives;2012;2;4;4ème circonscription;50;NANTERRE;92050;44344;22115;22229;757;21472;FRAYSSE Jacqueline;F;FRAYSSE;Jacqueline;FG;15217
Législatives 1997 - 1er tour;Législatives;1997;1;13;13ème circonscription;14;BOURG LA REINE;92014;12587;4431;8156;266;7890;ANSQUER VIRGINIE;F;ANSQUER;VIRGINIE;EXG;29
Législatives 1997 - 1er tour;Législatives;1997;1;10;10ème circonscription;12;BOULOGNE BILLANCOURT;92012;4529;1717;2812;99;2713;JANVIER GUY;M;JANVIER;GUY;SOC;713
Législatives 1993 - 2ème tour;Législatives;1993;2;8;8ème circonscription;76;VAUCRESSON;92076;5515;2711;2804;598;2206;GUILLET J.JACQUES;M;GUILLET;J.JACQUES;RPR;2206
Législatives 2012 - 1er tour;Législatives;2012;1;10;10ème circonscription;40;ISSY LES MOULINEAUX;92040;42014;16484;25530;277;25253;ALEZARD Lysiane;F;ALEZARD;Lysiane;FG;1185
Législatives 2012 - 1er tour;Législatives;2012;1;11;11ème circonscription;46;MALAKOFF;92046;18858;7608;11250;119;11131;BOCHER Aurélie;F;BOCHER;Aurélie;DVD;91
Législatives 2012 - 1er tour;Législatives;2012;1;11;11ème circonscription;49;MONTROUGE;92049;27889;10680;17209;123;17086;AMIABLE Marie-Hélène;F;AMIABLE;Marie-Hélène;FG;2306
Législatives 2012 - 1er tour;Législatives;2012;1;4;4ème circonscription;50;NANTERRE;92050;44344;21046;23298;337;22961;SCHOUMAKER Aurélien;M;SCHOUMAKER;Aurélien;EXG;114
Législatives 2012 - 1er tour;Législatives;2012;1;12;12ème circonscription;60;LE PLESSIS ROBINSON;92060;18785;6274;12511;101;12410;DELOM Christian;M;DELOM;Christian;CEN;238
Législatives 2012 - 1er tour;Législatives;2012;1;12;12ème circonscription;60;LE PLESSIS ROBINSON;92060;18785;6274;12511;101;12410;DOUCET Blanche;F;DOUCET;Blanche;FN;566
Législatives 2012 - 1er tour;Législatives;2012;1;8;8ème circonscription;76;VAUCRESSON;92076;6093;2463;3630;39;3591;RABANY Dominique;F;RABANY;Dominique;FG;49
Législatives 2012 - 1er tour;Législatives;2012;1;8;8ème circonscription;76;VAUCRESSON;92076;6093;2463;3630;39;3591;BECQ Michel;M;BECQ;Michel;DVD;83
Législatives 2012 - 1er tour;Législatives;2012;1;8;8ème circonscription;77;VILLE D'AVRAY;92077;7169;2468;4701;48;4653;SALA Emmanuel;M;SALA;Emmanuel;DVD;29
Législatives 1997 - 1er tour;Législatives;1997;1;2;2ème circonscription;25;COLOMBES;92025;17603;6110;11493;415;11078;CHAZOULE OLIVIER;M;CHAZOULE;OLIVIER;DVD;197
Législatives 1997 - 1er tour;Législatives;1997;1;2;2ème circonscription;25;COLOMBES;92025;17603;6110;11493;415;11078;PONS GUILLAUME;M;PONS;GUILLAUME;DVD;142
Législatives 1997 - 1er tour;Législatives;1997;1;10;10ème circonscription;48;MEUDON;92048;4118;1375;2743;67;2676;HERVO DIDIER;M;HERVO;DIDIER;ECO;158
Législatives 1997 - 1er tour;Législatives;1997;1;12;12ème circonscription;60;LE PLESSIS ROBINSON;92060;13002;3860;9142;204;8938;BREITBURD NICOLAS;M;BREITBURD;NICOLAS;DVD;81
Législatives 1997 - 1er tour;Législatives;1997;1;12;12ème circonscription;60;LE PLESSIS ROBINSON;92060;13002;3860;9142;204;8938;GRIELEN ALAIN;M;GRIELEN;ALAIN;DVG;17
Législatives 1997 - 1er tour;Législatives;1997;1;12;12ème circonscription;60;LE PLESSIS ROBINSON;92060;13002;3860;9142;204;8938;SCRIVE SIMON;M;SCRIVE;SIMON;ECO;273
Législatives 1997 - 1er tour;Législatives;1997;1;4;4ème circonscription;73;SURESNES;92073;20985;7217;13768;441;13327;EDORH LAWSON MARGUERITE;F;EDORH LAWSON;MARGUERITE;DVG;48
Législatives 2012 - 1er tour;Législatives;2012;1;3;3ème circonscription;9;BOIS COLOMBES;92009;16783;6763;10020;331;9689;GOURDOL Aimée;F;GOURDOL;Aimée;DVG;137
Législatives 2012 - 1er tour;Législatives;2012;1;3;3ème circonscription;9;BOIS COLOMBES;92009;16783;6763;10020;331;9689;VILLEDEY Florence;F;VILLEDEY;Florence;ALLI;456
Législatives 2012 - 1er tour;Législatives;2012;1;9;9ème circonscription;12;BOULOGNE BILLANCOURT;92012;61020;24579;36441;340;36101;EVEN Martine;F;EVEN;Martine;SOC;7994
Législatives 2012 - 1er tour;Législatives;2012;1;9;9ème circonscription;12;BOULOGNE BILLANCOURT;92012;61020;24579;36441;340;36101;BOUCHET Christian;M;BOUCHET;Christian;RDG;162
Législatives 2012 - 1er tour;Législatives;2012;1;10;10ème circonscription;12;BOULOGNE BILLANCOURT;92012;6600;2912;3688;126;3562;PIEUCHOT Laurent;M;PIEUCHOT;Laurent;DVG;516
Législatives 2012 - 1er tour;Législatives;2012;1;13;13ème circonscription;14;BOURG LA REINE;92014;13305;4436;8869;87;8782;DEBISSCHOP Magalie;F;DEBISSCHOP;Magalie;EXG;27
Législatives 2012 - 1er tour;Législatives;2012;1;13;13ème circonscription;19;CHATENAY MALABRY;92019;17908;6775;11133;210;10923;DEBISSCHOP Magalie;F;DEBISSCHOP;Magalie;EXG;33
Législatives 2012 - 1er tour;Législatives;2012;1;13;13ème circonscription;19;CHATENAY MALABRY;92019;17908;6775;11133;210;10923;DEVEDJIAN Patrick;M;DEVEDJIAN;Patrick;UMP;4281
Législatives 2012 - 1er tour;Législatives;2012;1;12;12ème circonscription;20;CHATILLON;92020;21681;8265;13416;122;13294;WAHNICH Sophie;F;WAHNICH;Sophie;AUT;34
Législatives 2012 - 1er tour;Législatives;2012;1;12;12ème circonscription;20;CHATILLON;92020;21681;8265;13416;122;13294;BIERENT Rudolph;M;BIERENT;Rudolph;AUT;21
Législatives 2012 - 1er tour;Législatives;2012;1;12;12ème circonscription;20;CHATILLON;92020;21681;8265;13416;122;13294;DOUCET Blanche;F;DOUCET;Blanche;FN;913
Législatives 2012 - 1er tour;Législatives;2012;1;2;2ème circonscription;25;COLOMBES;92025;18458;7115;11343;114;11229;PIETRASANTA Sébastien;M;PIETRASANTA;Sébastien;SOC;3844
Législatives 2012 - 1er tour;Législatives;2012;1;2;2ème circonscription;25;COLOMBES;92025;18458;7115;11343;114;11229;GUILLARD Laurent;M;GUILLARD;Laurent;VEC;570
Législatives 1997 - 1er tour;Législatives;1997;1;13;13ème circonscription;19;CHATENAY MALABRY;92019;17859;6462;11397;367;11030;ROMAN INGRID;F;ROMAN;INGRID;DIV;0
Législatives 1997 - 1er tour;Législatives;1997;1;11;11ème circonscription;7;BAGNEUX;92007;20284;7388;12896;374;12522;METTON J.LOUP;M;METTON;J.LOUP;UDF;2532
Législatives 1997 - 1er tour;Législatives;1997;1;8;8ème circonscription;77;VILLE D'AVRAY;92077;7112;2283;4829;139;4690;BALLOT LENA CAROLINE;F;BALLOT LENA;CAROLINE;DVD;142
Législatives 1997 - 1er tour;Législatives;1997;1;8;8ème circonscription;77;VILLE D'AVRAY;92077;7112;2283;4829;139;4690;MARKOVITCH ISABELLE;F;MARKOVITCH;ISABELLE;DVD;9
Législatives 1997 - 1er tour;Législatives;1997;1;8;8ème circonscription;76;VAUCRESSON;92076;5546;1861;3685;139;3546;BALLOT LENA CAROLINE;F;BALLOT LENA;CAROLINE;DVD;115
Législatives 1997 - 1er tour;Législatives;1997;1;8;8ème circonscription;77;VILLE D'AVRAY;92077;7112;2283;4829;139;4690;GUILLET J.JACQUES;M;GUILLET;J.JACQUES;RPR;2472
Législatives 1997 - 1er tour;Législatives;1997;1;8;8ème circonscription;76;VAUCRESSON;92076;5546;1861;3685;139;3546;JOURNE SILIAN;M;JOURNE;SILIAN;DVD;212
Législatives 1997 - 1er tour;Législatives;1997;1;10;10ème circonscription;75;VANVES;92075;15446;4682;10764;329;10435;DAUJON XAVIER;M;DAUJON;XAVIER;DVD;229
Législatives 1997 - 2ème tour;Législatives;1997;2;8;8ème circonscription;22;CHAVILLE;92022;12268;3547;8721;398;8323;LEVAIN JEAN;M;LEVAIN;JEAN;PRS;3836
Législatives 2012 - 2ème tour;Législatives;2012;2;2;2ème circonscription;4;ASNIERES SUR SEINE;92004;45108;19141;25967;1046;24921;PIETRASANTA Sébastien;M;PIETRASANTA;Sébastien;SOC;13528
Législatives 2012 - 2ème tour;Législatives;2012;2;12;12ème circonscription;23;CLAMART;92023;34173;13007;21166;422;20744;PEMEZEC Philippe;M;PEMEZEC;Philippe;UMP;9908
Législatives 2012 - 2ème tour;Législatives;2012;2;1;1ère circonscription;25;COLOMBES;92025;26337;16850;9487;2240;7247;BACHELAY Alexis;M;BACHELAY;Alexis;SOC;7247
Législatives 2012 - 2ème tour;Législatives;2012;2;10;10ème circonscription;40;ISSY LES MOULINEAUX;92040;42014;17430;24584;568;24016;SCHMID Lucile;F;SCHMID;Lucile;VEC;10080
Législatives 2012 - 2ème tour;Législatives;2012;2;12;12ème circonscription;60;LE PLESSIS ROBINSON;92060;18785;6011;12774;174;12600;GERMAIN Jean-Marc;M;GERMAIN;Jean-Marc;SOC;4878
Législatives 2002 - 1er tour;Législatives;2002;1;3;3ème circonscription;9;BOIS COLOMBES;92009;16245;6561;9684;288;9396;LASSERRE Jean-André;M;LASSERRE;Jean-André;SOC;1968
Législatives 2002 - 1er tour;Législatives;2002;1;3;3ème circonscription;9;BOIS COLOMBES;92009;16245;6561;9684;288;9396;CHAGNON Louis;M;CHAGNON;Louis;MPF;117
Législatives 2002 - 1er tour;Législatives;2002;1;9;9ème circonscription;12;BOULOGNE BILLANCOURT;92012;60773;22422;38351;535;37816;DUBOUCHER Peggy;F;DUBOUCHER;Peggy;VEC;947
Législatives 2002 - 1er tour;Législatives;2002;1;9;9ème circonscription;12;BOULOGNE BILLANCOURT;92012;60773;22422;38351;535;37816;MISSOFFE Ségolène;F;MISSOFFE;Ségolène;MAJ;505
Législatives 2002 - 1er tour;Législatives;2002;1;9;9ème circonscription;12;BOULOGNE BILLANCOURT;92012;60773;22422;38351;535;37816;PINEAU Dorothée;F;PINEAU;Dorothée;DVD;4129
Législatives 2002 - 1er tour;Législatives;2002;1;10;10ème circonscription;12;BOULOGNE BILLANCOURT;92012;5551;2367;3184;78;3106;SANTINI André;M;SANTINI;André;MAJ;1313
Législatives 2002 - 1er tour;Législatives;2002;1;5;5ème circonscription;24;CLICHY;92024;28799;12380;16419;297;16122;REBATO Stéphanie;F;REBATO;Stéphanie;DIV;76
Législatives 2002 - 1er tour;Législatives;2002;1;5;5ème circonscription;24;CLICHY;92024;28799;12380;16419;297;16122;BOUAKKA Lakdar;M;BOUAKKA;Lakdar;DIV;169
Législatives 2002 - 1er tour;Législatives;2002;1;5;5ème circonscription;24;CLICHY;92024;28799;12380;16419;297;16122;FURON Férial;F;FURON;Férial;DVD;55
Législatives 2002 - 1er tour;Législatives;2002;1;1;1ère circonscription;25;COLOMBES;92025;26192;12273;13919;366;13553;BEN M'BAREK Hassan;M;BEN M'BAREK;Hassan;DIV;65
Législatives 2002 - 1er tour;Législatives;2002;1;12;12ème circonscription;32;FONTENAY AUX ROSES;92032;15468;5605;9863;84;9779;LARCHER Robert;M;LARCHER;Robert;EXG;46
Législatives 2002 - 1er tour;Législatives;2002;1;12;12ème circonscription;32;FONTENAY AUX ROSES;92032;15468;5605;9863;84;9779;CHABRAN Isabelle;F;CHABRAN;Isabelle;VEC;374
Législatives 2002 - 1er tour;Législatives;2002;1;10;10ème circonscription;40;ISSY LES MOULINEAUX;92040;38520;14017;24503;359;24144;GINISTY Christophe;M;GINISTY;Christophe;UDFD;3256
Législatives 2002 - 1er tour;Législatives;2002;1;5;5ème circonscription;44;LEVALLOIS PERRET;92044;39466;14724;24742;404;24338;BALKANY Patrick;M;BALKANY;Patrick;UMP;13328
Législatives 2002 - 1er tour;Législatives;2002;1;11;11ème circonscription;46;MALAKOFF;92046;18478;7045;11433;204;11229;MORILLERE Denis;M;MORILLERE;Denis;DIV;0
Législatives 2002 - 1er tour;Législatives;2002;1;11;11ème circonscription;46;MALAKOFF;92046;18478;7045;11433;204;11229;METTON Jean-Loup;M;METTON;Jean-Loup;MAJ;2855
Législatives 2002 - 1er tour;Législatives;2002;1;8;8ème circonscription;47;MARNES LA COQUETTE;92047;1074;316;758;5;753;RAFFALI Danielle;F;RAFFALI;Danielle;ECO;6
Législatives 2002 - 1er tour;Législatives;2002;1;8;8ème circonscription;48;MEUDON;92048;25427;9683;15744;202;15542;SUCHARD Sophie;F;SUCHARD;Sophie;EXG;42
Législatives 2002 - 1er tour;Législatives;2002;1;11;11ème circonscription;49;MONTROUGE;92049;26595;9698;16897;213;16684;AMIABLE Marie-Hélène;F;AMIABLE;Marie-Hélène;COM;1668
Législatives 2002 - 1er tour;Législatives;2002;1;11;11ème circonscription;49;MONTROUGE;92049;26595;9698;16897;213;16684;DE PABLO Carmelina;F;DE PABLO;Carmelina;VEC;705
Législatives 2002 - 1er tour;Législatives;2002;1;11;11ème circonscription;49;MONTROUGE;92049;26595;9698;16897;213;16684;DADARE Sébastien;M;DADARE;Sébastien;DIV;236
Législatives 2002 - 1er tour;Législatives;2002;1;4;4ème circonscription;50;NANTERRE;92050;42631;18721;23910;314;23596;MEYER Marie-Laure;F;MEYER;Marie-Laure;SOC;3383
Législatives 2002 - 1er tour;Législatives;2002;1;6;6ème circonscription;51;NEUILLY SUR SEINE;92051;39134;14738;24396;185;24211;JEANNE Nadine;F;JEANNE;Nadine;SOC;1421
Législatives 2002 - 1er tour;Législatives;2002;1;6;6ème circonscription;51;NEUILLY SUR SEINE;92051;39134;14738;24396;185;24211;OLIVIER Pascal;M;OLIVIER;Pascal;DVG;18
Législatives 2002 - 1er tour;Législatives;2002;1;12;12ème circonscription;60;LE PLESSIS ROBINSON;92060;16776;5588;11188;123;11065;DELOM Christian;M;DELOM;Christian;UDFD;892
Législatives 2002 - 1er tour;Législatives;2002;1;6;6ème circonscription;62;PUTEAUX;92062;26791;8829;17962;396;17566;GALIENNE Jean;M;GALIENNE;Jean;DIV;89
Législatives 2002 - 1er tour;Législatives;2002;1;7;7ème circonscription;63;RUEIL MALMAISON;92063;51481;18902;32579;337;32242;OLLIER Patrick;M;OLLIER;Patrick;UMP;18658
Législatives 2002 - 1er tour;Législatives;2002;1;8;8ème circonscription;72;SEVRES;92072;14460;5279;9181;151;9030;ROY Caroline;F;ROY;Caroline;RDG;2144
Législatives 2002 - 1er tour;Législatives;2002;1;10;10ème circonscription;75;VANVES;92075;17351;5929;11422;137;11285;BOTTET Philippe;M;BOTTET;Philippe;EXG;52
Législatives 2002 - 1er tour;Législatives;2002;1;10;10ème circonscription;75;VANVES;92075;17351;5929;11422;137;11285;WOUTERS Nina;F;WOUTERS;Nina;EXG;234
Législatives 2002 - 1er tour;Législatives;2002;1;8;8ème circonscription;77;VILLE D'AVRAY;92077;7475;2429;5046;60;4986;BEZAULT Christine;F;BEZAULT;Christine;DIV;39
Législatives 2002 - 1er tour;Législatives;2002;1;1;1ère circonscription;78;VILLENEUVE LA GARENNE;92078;13038;7211;5827;131;5696;GUICHARD Isabelle;F;GUICHARD;Isabelle;EXG;111
Législatives 2002 - 2ème tour;Législatives;2002;2;12;12ème circonscription;23;CLAMART;92023;31363;11807;19556;666;18890;PEMEZEC PHILIPPE;M;PEMEZEC;PHILIPPE;RPF;10040
Législatives 2002 - 2ème tour;Législatives;2002;2;5;5ème circonscription;44;LEVALLOIS PERRET;92044;34014;10618;23396;339;23057;CATOIRE GILLES;M;CATOIRE;GILLES;SOC;5502
Législatives 2002 - 2ème tour;Législatives;2002;2;7;7ème circonscription;64;SAINT CLOUD;92064;18263;7618;10645;307;10338;OLLIER PATRICK;M;OLLIER;PATRICK;UMP;7823
Législatives 1997 - 1er tour;Législatives;1997;1;3;3ème circonscription;26;COURBEVOIE;92026;35738;12354;23384;653;22731;DENJEAN NAVAILLE J.MARC;M;DENJEAN NAVAILLE;J.MARC;EXG;208
Législatives 1997 - 1er tour;Législatives;1997;1;10;10ème circonscription;40;ISSY LES MOULINEAUX;92040;30164;10899;19265;543;18722;JANVIER FREDERIC;M;JANVIER;FREDERIC;EXD;390
Législatives 1997 - 1er tour;Législatives;1997;1;12;12ème circonscription;32;FONTENAY AUX ROSES;92032;14748;4655;10093;259;9834;FOUCHER J.PIERRE;M;FOUCHER;J.PIERRE;UDF;2245
Législatives 1997 - 1er tour;Législatives;1997;1;8;8ème circonscription;47;MARNES LA COQUETTE;92047;985;289;696;19;677;BRISSAUD SOPHIE;F;BRISSAUD;SOPHIE;FRN;75
Législatives 1997 - 2ème tour;Législatives;1997;2;8;8ème circonscription;47;MARNES LA COQUETTE;92047;985;279;706;33;673;GUILLET J.JACQUES;M;GUILLET;J.JACQUES;RPR;541
Législatives 1997 - 2ème tour;Législatives;1997;2;10;10ème circonscription;40;ISSY LES MOULINEAUX;92040;34277;11408;22869;932;21937;JANVIER GUY;M;JANVIER;GUY;SOC;9157
Législatives 1997 - 2ème tour;Législatives;1997;2;10;10ème circonscription;48;MEUDON;92048;4118;1246;2872;108;2764;SANTINI ANDRE;M;SANTINI;ANDRE;UDF;1498
Législatives 1997 - 2ème tour;Législatives;1997;2;10;10ème circonscription;48;MEUDON;92048;4118;1246;2872;108;2764;JANVIER GUY;M;JANVIER;GUY;SOC;1266
Législatives 1997 - 1er tour;Législatives;1997;1;13;13ème circonscription;14;BOURG LA REINE;92014;12587;4431;8156;266;7890;LETTRON J.PIERRE;M;LETTRON;J.PIERRE;DVG;225
Législatives 1997 - 1er tour;Législatives;1997;1;13;13ème circonscription;19;CHATENAY MALABRY;92019;17859;6462;11397;367;11030;GESLAIN A.MARIE;F;GESLAIN;A.MARIE;COM;942
Législatives 1997 - 1er tour;Législatives;1997;1;13;13ème circonscription;19;CHATENAY MALABRY;92019;17859;6462;11397;367;11030;PEURIERE GERARD;M;PEURIERE;GERARD;ECO;507
Législatives 1997 - 1er tour;Législatives;1997;1;12;12ème circonscription;32;FONTENAY AUX ROSES;92032;14748;4655;10093;259;9834;GARREC CLAUDE;M;GARREC;CLAUDE;DVD;2
Législatives 1997 - 1er tour;Législatives;1997;1;7;7ème circonscription;33;GARCHES;92033;11323;3745;7578;290;7288;MORTIMORE STEPHANIE;F;MORTIMORE;STEPHANIE;DVD;142
Législatives 1997 - 1er tour;Législatives;1997;1;5;5ème circonscription;44;LEVALLOIS PERRET;92044;28281;9315;18966;650;18316;LAMY LAURENCE;F;LAMY;LAURENCE;DVD;190
Législatives 1997 - 1er tour;Législatives;1997;1;11;11ème circonscription;46;MALAKOFF;92046;19124;7233;11891;338;11553;DEISS A.MARIE;F;DEISS;A.MARIE;DIV;47
Législatives 1997 - 1er tour;Législatives;1997;1;11;11ème circonscription;46;MALAKOFF;92046;19124;7233;11891;338;11553;PIROIS LOUIS;M;PIROIS;LOUIS;EXG;250
Législatives 2002 - 1er tour;Législatives;2002;1;13;13ème circonscription;2;ANTONY;92002;39807;13942;25865;456;25409;HOLLEBEKE Dominique;F;HOLLEBEKE;Dominique;MPF;277
Présidentielles 2017 - 1er tour;Présidentielles;2017;1;;;2;ANTONY;92002;41488;6486;35002;776;34226;LASSALLE Jean;M;LASSALLE;Jean;;233
Présidentielles 2017 - 1er tour;Présidentielles;2017;1;;;4;ASNIERES SUR SEINE;92004;48227;8578;39649;807;38842;CHEMINADE Jacques;M;CHEMINADE;Jacques;;65
Présidentielles 2017 - 1er tour;Présidentielles;2017;1;;;7;BAGNEUX;92007;21873;5369;16504;428;16076;HAMON Benoît;M;HAMON;Benoît;;1358
Présidentielles 2017 - 1er tour;Présidentielles;2017;1;;;7;BAGNEUX;92007;21873;5369;16504;428;16076;MACRON Emmanuel;M;MACRON;Emmanuel;;4207
Présidentielles 2017 - 1er tour;Présidentielles;2017;1;;;12;BOULOGNE BILLANCOURT;92012;77303;15227;62076;919;61157;MÉLENCHON Jean-Luc;M;MÉLENCHON;Jean-Luc;;6785
Présidentielles 2017 - 1er tour;Présidentielles;2017;1;;;14;BOURG LA REINE;92014;13769;2202;11567;212;11355;ASSELINEAU François;M;ASSELINEAU;François;;102
Présidentielles 2017 - 1er tour;Présidentielles;2017;1;;;24;CLICHY;92024;28553;5564;22989;498;22491;HAMON Benoît;M;HAMON;Benoît;;2289
Présidentielles 2017 - 1er tour;Présidentielles;2017;1;;;35;LA GARENNE COLOMBES;92035;18828;3121;15707;289;15418;DUPONT-AIGNAN Nicolas;M;DUPONT-AIGNAN;Nicolas;;566
Présidentielles 2017 - 1er tour;Présidentielles;2017;1;;;40;ISSY LES MOULINEAUX;92040;46800;9050;37750;728;37022;HAMON Benoît;M;HAMON;Benoît;;3127
Présidentielles 2017 - 1er tour;Présidentielles;2017;1;;;46;MALAKOFF;92046;18434;3186;15248;268;14979;DUPONT-AIGNAN Nicolas;M;DUPONT-AIGNAN;Nicolas;;393
Présidentielles 2017 - 1er tour;Présidentielles;2017;1;;;50;NANTERRE;92050;47568;10655;36913;884;36029;ARTHAUD Nathalie;F;ARTHAUD;Nathalie;;166
Présidentielles 2017 - 1er tour;Présidentielles;2017;1;;;62;PUTEAUX;92062;28950;4530;24420;549;23871;LE PEN Marine;F;LE PEN;Marine;;2358
Présidentielles 2017 - 1er tour;Présidentielles;2017;1;;;72;SEVRES;92072;15142;2166;12976;213;12763;CHEMINADE Jacques;M;CHEMINADE;Jacques;;21
Présidentielles 2017 - 1er tour;Présidentielles;2017;1;;;77;VILLE D'AVRAY;92077;7433;837;6596;89;6507;CHEMINADE Jacques;M;CHEMINADE;Jacques;;6
Présidentielles 2017 - 1er tour;Présidentielles;2017;1;;;78;VILLENEUVE LA GARENNE;92078;12429;3872;8557;315;8242;DUPONT-AIGNAN Nicolas;M;DUPONT-AIGNAN;Nicolas;;222
Présidentielles 2017 - 2ème tour;Présidentielles;2017;2;;;24;CLICHY;92024;28589;7000;21589;1881;19708;LE PEN Marine;F;LE PEN;Marine;;2656
Présidentielles 2017 - 2ème tour;Présidentielles;2017;2;;;40;ISSY LES MOULINEAUX;92040;46803;11572;35231;3270;31961;MACRON Emmanuel;M;MACRON;Emmanuel;;27928
Présidentielles 2017 - 2ème tour;Présidentielles;2017;2;;;64;SAINT CLOUD;92064;19377;3971;15406;1271;14135;MACRON Emmanuel;M;MACRON;Emmanuel;;12069
Législatives 2007 - 1er tour;Législatives;2007;1;2;2ème circonscription;4;ASNIERES SUR SEINE;92004;44110;17783;26327;312;26015;JOUBERT Valérie;F;JOUBERT;Valérie;EXG;597
Législatives 2007 - 1er tour;Législatives;2007;1;13;13ème circonscription;2;ANTONY;92002;39807;13942;25865;456;25409;SARFATI André;M;SARFATI;André;DIV;147
Législatives 2007 - 1er tour;Législatives;2007;1;11;11ème circonscription;46;MALAKOFF;92046;18478;7045;11433;204;11229;BARBEROUSSE Olivier;M;BARBEROUSSE;Olivier;EXG;208
Législatives 2007 - 1er tour;Législatives;2007;1;8;8ème circonscription;47;MARNES LA COQUETTE;92047;1074;316;758;5;753;CYROULNIK Marie-France;F;CYROULNIK;Marie-France;EXG;2
Législatives 2007 - 1er tour;Législatives;2007;1;8;8ème circonscription;48;MEUDON;92048;25427;9683;15744;202;15542;DEQUEANT Annie;F;DEQUEANT;Annie;FN;409
Législatives 2007 - 1er tour;Législatives;2007;1;6;6ème circonscription;62;PUTEAUX;92062;26791;8829;17962;396;17566;GONZALEZ David;M;GONZALEZ;David;DIV;7
Législatives 2007 - 1er tour;Législatives;2007;1;7;7ème circonscription;63;RUEIL MALMAISON;92063;51481;18902;32579;337;32242;BITTERLIN Anne;F;BITTERLIN;Anne;ECO;237
Législatives 2007 - 1er tour;Législatives;2007;1;13;13ème circonscription;71;SCEAUX;92071;14129;4679;9450;74;9376;DEVEDJIAN Patrick;M;DEVEDJIAN;Patrick;UMP;4344
Législatives 2007 - 1er tour;Législatives;2007;1;10;10ème circonscription;75;VANVES;92075;17351;5929;11422;137;11285;SCHMID Lucille;F;SCHMID;Lucille;SOC;3333
Législatives 2007 - 1er tour;Législatives;2007;1;10;10ème circonscription;75;VANVES;92075;17351;5929;11422;137;11285;HOCINI Malek;M;HOCINI;Malek;DIV;45
Législatives 2007 - 1er tour;Législatives;2007;1;8;8ème circonscription;76;VAUCRESSON;92076;6076;2206;3870;46;3824;RAFFALI Danielle;F;RAFFALI;Danielle;ECO;40
Législatives 2007 - 1er tour;Législatives;2007;1;1;1ère circonscription;78;VILLENEUVE LA GARENNE;92078;13038;7211;5827;131;5696;GUICHARD Isabelle;F;GUICHARD;Isabelle;EXG;111
Législatives 2007 - 2ème tour;Législatives;2007;2;11;11ème circonscription;46;MALAKOFF;92046;18478;7595;10883;247;10636;METTON Jean-Loup;M;METTON;Jean-Loup;MAJ;3205
Législatives 2007 - 1er tour;Législatives;2007;1;3;3ème circonscription;35;LA GARENNE COLOMBES;92035;16552;5947;10605;101;10504;BERKOUKI Sarah;F;BERKOUKI;Sarah;DIV;25
Législatives 2007 - 1er tour;Législatives;2007;1;11;11ème circonscription;7;BAGNEUX;92007;20520;8538;11982;178;11804;DE PABLO Carmelina;F;DE PABLO;Carmelina;VEC;364
Législatives 2007 - 1er tour;Législatives;2007;1;11;11ème circonscription;7;BAGNEUX;92007;20520;8538;11982;178;11804;TEIXEIRA Dominique;M;TEIXEIRA;Dominique;EXG;52
Législatives 2007 - 1er tour;Législatives;2007;1;3;3ème circonscription;26;COURBEVOIE;92026;49151;19345;29806;541;29265;MARCEL Françoise;F;MARCEL;Françoise;EXG;119
Législatives 2007 - 1er tour;Législatives;2007;1;12;12ème circonscription;32;FONTENAY AUX ROSES;92032;15468;5605;9863;84;9779;BENARD Paul;M;BENARD;Paul;EXG;44
Législatives 2007 - 1er tour;Législatives;2007;1;10;10ème circonscription;40;ISSY LES MOULINEAUX;92040;38520;14017;24503;359;24144;HOCINI Malek;M;HOCINI;Malek;DIV;88
Législatives 2007 - 1er tour;Législatives;2007;1;5;5ème circonscription;44;LEVALLOIS PERRET;92044;39466;14724;24742;404;24338;GOUDAL Emilie;F;GOUDAL;Emilie;EXG;394
Législatives 2007 - 1er tour;Législatives;2007;1;8;8ème circonscription;22;CHAVILLE;92022;12928;4682;8246;120;8126;BOUCHARD Renaud;M;BOUCHARD;Renaud;DIV;4
Législatives 2007 - 1er tour;Législatives;2007;1;8;8ème circonscription;22;CHAVILLE;92022;12928;4682;8246;120;8126;ROY Caroline;F;ROY;Caroline;RDG;2073
Présidentielles 2002 - 1er tour;Présidentielles;2002;1;;;4;ASNIERES SUR SEINE;92004;35702;11271;24431;515;23916;GLUCKSTEIN DANIEL;M;GLUCKSTEIN;DANIEL;;75
Présidentielles 2002 - 1er tour;Présidentielles;2002;1;;;7;BAGNEUX;92007;18489;5873;12616;519;12097;BOUTIN CHRISTINE;F;BOUTIN;CHRISTINE;;90
Présidentielles 2002 - 1er tour;Présidentielles;2002;1;;;9;BOIS COLOMBES;92009;13996;4554;9442;200;9242;BAYROU FRANCOIS;M;BAYROU;FRANCOIS;;798
Présidentielles 2002 - 1er tour;Présidentielles;2002;1;;;9;BOIS COLOMBES;92009;13996;4554;9442;200;9242;SAINT-JOSSE JEAN;M;SAINT-JOSSE;JEAN;;73
Présidentielles 2002 - 1er tour;Présidentielles;2002;1;;;14;BOURG LA REINE;92014;12075;3519;8556;149;8407;MEGRET BRUNO;M;MEGRET;BRUNO;;123
Présidentielles 2002 - 1er tour;Présidentielles;2002;1;;;19;CHATENAY MALABRY;92019;15965;4483;11482;241;11241;BAYROU FRANCOIS;M;BAYROU;FRANCOIS;;850
Présidentielles 2002 - 1er tour;Présidentielles;2002;1;;;19;CHATENAY MALABRY;92019;15965;4483;11482;241;11241;CHEVENEMENT JEAN-PIERRE;M;CHEVENEMENT;JEAN-PIERRE;;722
Présidentielles 2002 - 1er tour;Présidentielles;2002;1;;;22;CHAVILLE;92022;12122;3826;8296;162;8134;LEPAGE CORINNE;F;LEPAGE;CORINNE;;229
Présidentielles 2002 - 1er tour;Présidentielles;2002;1;;;22;CHAVILLE;92022;12122;3826;8296;162;8134;TAUBIRA CHRISTIANE;F;TAUBIRA;CHRISTIANE;;275
Présidentielles 2002 - 1er tour;Présidentielles;2002;1;;;23;CLAMART;92023;31130;10977;20153;427;19726;BAYROU FRANCOIS;M;BAYROU;FRANCOIS;;1804
Présidentielles 2002 - 1er tour;Présidentielles;2002;1;;;24;CLICHY;92024;24491;8395;16096;399;15697;MADELIN ALAIN;M;MADELIN;ALAIN;;590
Présidentielles 2002 - 1er tour;Présidentielles;2002;1;;;32;FONTENAY AUX ROSES;92032;14148;4309;9839;204;9635;BAYROU FRANCOIS;M;BAYROU;FRANCOIS;;826
Présidentielles 2002 - 1er tour;Présidentielles;2002;1;;;32;FONTENAY AUX ROSES;92032;14148;4309;9839;204;9635;LAGUILLER ARLETTE;F;LAGUILLER;ARLETTE;;359
Présidentielles 2002 - 1er tour;Présidentielles;2002;1;;;33;GARCHES;92033;11708;3920;7788;137;7651;TAUBIRA CHRISTIANE;F;TAUBIRA;CHRISTIANE;;179
Présidentielles 2002 - 1er tour;Présidentielles;2002;1;;;36;GENNEVILLIERS;92036;18213;6933;11280;303;10977;MEGRET BRUNO;M;MEGRET;BRUNO;;239
Présidentielles 2002 - 1er tour;Présidentielles;2002;1;;;46;MALAKOFF;92046;17268;6020;11248;271;10977;BOUTIN CHRISTINE;F;BOUTIN;CHRISTINE;;76
Présidentielles 2002 - 1er tour;Présidentielles;2002;1;;;47;MARNES LA COQUETTE;92047;997;272;725;7;718;GLUCKSTEIN DANIEL;M;GLUCKSTEIN;DANIEL;;2
Présidentielles 2002 - 1er tour;Présidentielles;2002;1;;;50;NANTERRE;92050;37590;13303;24287;669;23618;SAINT-JOSSE JEAN;M;SAINT-JOSSE;JEAN;;191
Présidentielles 2002 - 1er tour;Présidentielles;2002;1;;;51;NEUILLY SUR SEINE;92051;34066;10108;23958;309;23649;MADELIN ALAIN;M;MADELIN;ALAIN;;2881
Présidentielles 2002 - 1er tour;Présidentielles;2002;1;;;62;PUTEAUX;92062;23861;6804;17057;487;16570;SAINT-JOSSE JEAN;M;SAINT-JOSSE;JEAN;;157
Présidentielles 2002 - 1er tour;Présidentielles;2002;1;;;63;RUEIL MALMAISON;92063;48302;17158;31144;693;30451;BESANCENOT OLIVIER;M;BESANCENOT;OLIVIER;;833
Présidentielles 2002 - 1er tour;Présidentielles;2002;1;;;64;SAINT CLOUD;92064;17818;6028;11790;141;11649;SAINT-JOSSE JEAN;M;SAINT-JOSSE;JEAN;;80
Présidentielles 2002 - 1er tour;Présidentielles;2002;1;;;72;SEVRES;92072;13367;4140;9227;153;9074;MAMERE NOEL;M;MAMERE;NOEL;;642
Présidentielles 2002 - 1er tour;Présidentielles;2002;1;;;73;SURESNES;92073;22099;7156;14943;329;14614;CHIRAC JACQUES;M;CHIRAC;JACQUES;;3514
Présidentielles 2002 - 1er tour;Présidentielles;2002;1;;;73;SURESNES;92073;22099;7156;14943;329;14614;TAUBIRA CHRISTIANE;F;TAUBIRA;CHRISTIANE;;414
Présidentielles 2002 - 1er tour;Présidentielles;2002;1;;;73;SURESNES;92073;22099;7156;14943;329;14614;HUE ROBERT;M;HUE;ROBERT;;378
Présidentielles 2002 - 1er tour;Présidentielles;2002;1;;;77;VILLE D'AVRAY;92077;7251;2486;4765;70;4695;JOSPIN LIONEL;M;JOSPIN;LIONEL;;581
Présidentielles 2007 - 1er tour;Présidentielles;2007;1;;;4;ASNIERES SUR SEINE;92004;43605;5665;37940;436;37504;SCHIVARDI Gérard;M;SCHIVARDI;Gérard;;55
Présidentielles 2007 - 1er tour;Présidentielles;2007;1;;;4;ASNIERES SUR SEINE;92004;43605;5665;37940;436;37504;ROYAL Ségolène;F;ROYAL;Ségolène;;10532
Présidentielles 2007 - 1er tour;Présidentielles;2007;1;;;9;BOIS COLOMBES;92009;16113;2534;13579;152;13427;BOVÉ José;M;BOVÉ;José;;103
Présidentielles 2007 - 1er tour;Présidentielles;2007;1;;;9;BOIS COLOMBES;92009;16113;2534;13579;152;13427;LAGUILLER Arlette;F;LAGUILLER;Arlette;;76
Présidentielles 2007 - 1er tour;Présidentielles;2007;1;;;23;CLAMART;92023;32539;3879;28660;293;28367;LAGUILLER Arlette;F;LAGUILLER;Arlette;;234
Présidentielles 2007 - 1er tour;Présidentielles;2007;1;;;26;COURBEVOIE;92026;48308;7118;41190;456;40734;VOYNET Dominique;F;VOYNET;Dominique;;558
Présidentielles 2007 - 1er tour;Présidentielles;2007;1;;;47;MARNES LA COQUETTE;92047;1054;91;963;9;954;BESANCENOT Olivier;M;BESANCENOT;Olivier;;5
Présidentielles 2007 - 1er tour;Présidentielles;2007;1;;;50;NANTERRE;92050;42083;6117;35966;477;35489;LE PEN Jean-Marie;M;LE PEN;Jean-Marie;;2486
Présidentielles 2007 - 1er tour;Présidentielles;2007;1;;;51;NEUILLY SUR SEINE;92051;37647;4032;33615;154;33461;ROYAL Ségolène;F;ROYAL;Ségolène;;2527
Présidentielles 2007 - 1er tour;Présidentielles;2007;1;;;60;LE PLESSIS ROBINSON;92060;16571;1989;14582;159;14423;ROYAL Ségolène;F;ROYAL;Ségolène;;3541
Présidentielles 2007 - 1er tour;Présidentielles;2007;1;;;63;RUEIL MALMAISON;92063;50540;5920;44620;393;44227;BAYROU François;M;BAYROU;François;;10439
Présidentielles 2007 - 1er tour;Présidentielles;2007;1;;;63;RUEIL MALMAISON;92063;50540;5920;44620;393;44227;BOVÉ José;M;BOVÉ;José;;307
Présidentielles 2007 - 1er tour;Présidentielles;2007;1;;;64;SAINT CLOUD;92064;18455;1926;16529;91;16438;BUFFET Marie-George;F;BUFFET;Marie-George;;76
Présidentielles 2007 - 1er tour;Présidentielles;2007;1;;;71;SCEAUX;92071;13824;1539;12285;86;12199;BAYROU François;M;BAYROU;François;;3060
Présidentielles 2007 - 1er tour;Présidentielles;2007;1;;;71;SCEAUX;92071;13824;1539;12285;86;12199;SARKOZY Nicolas;M;SARKOZY;Nicolas;;4838
Présidentielles 2007 - 1er tour;Présidentielles;2007;1;;;72;SEVRES;92072;14178;1738;12440;129;12311;SCHIVARDI Gérard;M;SCHIVARDI;Gérard;;11
Présidentielles 2007 - 1er tour;Présidentielles;2007;1;;;73;SURESNES;92073;24255;2600;21655;272;21383;de VILLIERS Philippe;M;de VILLIERS;Philippe;;254
Présidentielles 2007 - 1er tour;Présidentielles;2007;1;;;75;VANVES;92075;17139;2129;15010;126;14884;BESANCENOT Olivier;M;BESANCENOT;Olivier;;397
Présidentielles 2007 - 1er tour;Présidentielles;2007;1;;;77;VILLE D'AVRAY;92077;7253;672;6581;57;6524;SARKOZY Nicolas;M;SARKOZY;Nicolas;;3259
Présidentielles 2007 - 1er tour;Présidentielles;2007;1;;;78;VILLENEUVE LA GARENNE;92078;12897;2898;9999;145;9854;de VILLIERS Philippe;M;de VILLIERS;Philippe;;95
Présidentielles 2012 - 1er tour;Présidentielles;2012;1;;;2;ANTONY;92002;40169;7755;32414;674;31740;JOLY Eva;F;JOLY;Eva;;981
Présidentielles 2012 - 1er tour;Présidentielles;2012;1;;;4;ASNIERES SUR SEINE;92004;45042;9279;35763;516;35247;HOLLANDE François;M;HOLLANDE;François;;11817
Présidentielles 2012 - 1er tour;Présidentielles;2012;1;;;7;BAGNEUX;92007;20608;4687;15921;281;15640;CHEMINADE Jacques;M;CHEMINADE;Jacques;;56
Présidentielles 2012 - 1er tour;Présidentielles;2012;1;;;19;CHATENAY MALABRY;92019;17914;3466;14448;325;14123;MÉLENCHON Jean-Luc;M;MÉLENCHON;Jean-Luc;;1723
Présidentielles 2012 - 1er tour;Présidentielles;2012;1;;;32;FONTENAY AUX ROSES;92032;15217;3289;11928;161;11767;JOLY Eva;F;JOLY;Eva;;379
Présidentielles 2012 - 1er tour;Présidentielles;2012;1;;;40;ISSY LES MOULINEAUX;92040;41994;9488;32506;521;31985;SARKOZY Nicolas;M;SARKOZY;Nicolas;;10391
Présidentielles 2012 - 1er tour;Présidentielles;2012;1;;;60;LE PLESSIS ROBINSON;92060;18767;3621;15146;260;14886;MÉLENCHON Jean-Luc;M;MÉLENCHON;Jean-Luc;;1624
Présidentielles 2012 - 1er tour;Présidentielles;2012;1;;;62;PUTEAUX;92062;28189;5597;22592;470;22122;CHEMINADE Jacques;M;CHEMINADE;Jacques;;58
Présidentielles 2012 - 1er tour;Présidentielles;2012;1;;;63;RUEIL MALMAISON;92063;52385;10540;41845;580;41265;JOLY Eva;F;JOLY;Eva;;1038
Présidentielles 2012 - 1er tour;Présidentielles;2012;1;;;64;SAINT CLOUD;92064;18973;3529;15444;153;15291;DUPONT-AIGNAN Nicolas;M;DUPONT-AIGNAN;Nicolas;;208
Présidentielles 2012 - 1er tour;Présidentielles;2012;1;;;71;SCEAUX;92071;14355;2941;11414;118;11296;POUTOU Philippe;M;POUTOU;Philippe;;66
Présidentielles 2012 - 1er tour;Présidentielles;2012;1;;;71;SCEAUX;92071;14355;2941;11414;118;11296;ARTHAUD Nathalie;F;ARTHAUD;Nathalie;;11
Présidentielles 2012 - 1er tour;Présidentielles;2012;1;;;72;SEVRES;92072;14837;2876;11961;219;11742;BAYROU François;M;BAYROU;François;;1369
Présidentielles 2012 - 1er tour;Présidentielles;2012;1;;;75;VANVES;92075;17512;3079;14433;161;14272;LE PEN Marine;F;LE PEN;Marine;;1088
Présidentielles 2012 - 1er tour;Présidentielles;2012;1;;;75;VANVES;92075;17512;3079;14433;161;14272;MÉLENCHON Jean-Luc;M;MÉLENCHON;Jean-Luc;;1588
Présidentielles 1995 - 1er tour;Présidentielles;1995;1;;;26;COURBEVOIE;92026;35812;8064;27748;468;27280;VILLIERS DE PHILIPPE;M;VILLIERS DE;PHILIPPE;;946
Présidentielles 1995 - 1er tour;Présidentielles;1995;1;;;25;COLOMBES;92025;44864;11966;32898;703;32195;LAGUILLER ARLETTE;F;LAGUILLER;ARLETTE;;1860
Présidentielles 1995 - 1er tour;Présidentielles;1995;1;;;23;CLAMART;92023;31229;8419;22810;457;22353;CHIRAC JACQUES;M;CHIRAC;JACQUES;;5263
Présidentielles 1995 - 1er tour;Présidentielles;1995;1;;;14;BOURG LA REINE;92014;12770;3430;9340;135;9205;CHIRAC JACQUES;M;CHIRAC;JACQUES;;2553
Présidentielles 1995 - 1er tour;Présidentielles;1995;1;;;9;BOIS COLOMBES;92009;14922;3871;11051;199;10852;LE PEN J.MARIE;M;LE PEN;J.MARIE;;1466
Présidentielles 1995 - 1er tour;Présidentielles;1995;1;;;63;RUEIL MALMAISON;92063;44438;10571;33867;718;33149;BALLADUR EDOUARD;M;BALLADUR;EDOUARD;;6933
Présidentielles 1995 - 1er tour;Présidentielles;1995;1;;;62;PUTEAUX;92062;24192;6165;18027;379;17648;VILLIERS DE PHILIPPE;M;VILLIERS DE;PHILIPPE;;510
Présidentielles 1995 - 1er tour;Présidentielles;1995;1;;;50;NANTERRE;92050;46920;11548;35372;736;34636;LAGUILLER ARLETTE;F;LAGUILLER;ARLETTE;;1854
Présidentielles 1995 - 1er tour;Présidentielles;1995;1;;;48;MEUDON;92048;29714;7851;21863;352;21511;LAGUILLER ARLETTE;F;LAGUILLER;ARLETTE;;1031
Présidentielles 1995 - 1er tour;Présidentielles;1995;1;;;62;PUTEAUX;92062;24192;6165;18027;379;17648;BALLADUR EDOUARD;M;BALLADUR;EDOUARD;;3174
Présidentielles 2012 - 2ème tour;Présidentielles;2012;2;;;25;COLOMBES;92025;44746;8475;36271;1433;34838;SARKOZY Nicolas;M;SARKOZY;Nicolas;;14456
Présidentielles 2012 - 2ème tour;Présidentielles;2012;2;;;71;SCEAUX;92071;14378;2262;12116;403;11713;SARKOZY Nicolas;M;SARKOZY;Nicolas;;6141
Présidentielles 2012 - 2ème tour;Présidentielles;2012;2;;;75;VANVES;92075;17516;2584;14932;567;14365;SARKOZY Nicolas;M;SARKOZY;Nicolas;;6258
Présidentielles 2007 - 2ème tour;Présidentielles;2007;2;;;4;ASNIERES SUR SEINE;92004;43559;6164;37395;1262;36133;SARKOZY Nicolas;M;SARKOZY;Nicolas;;19371
Présidentielles 2007 - 2ème tour;Présidentielles;2007;2;;;22;CHAVILLE;92022;12729;1887;10842;486;10356;SARKOZY Nicolas;M;SARKOZY;Nicolas;;5774
Présidentielles 2007 - 2ème tour;Présidentielles;2007;2;;;32;FONTENAY AUX ROSES;92032;15238;2269;12969;498;12471;SARKOZY Nicolas;M;SARKOZY;Nicolas;;5865
Présidentielles 2007 - 2ème tour;Présidentielles;2007;2;;;47;MARNES LA COQUETTE;92047;1054;95;959;21;938;ROYAL Ségolène;F;ROYAL;Ségolène;;196
Présidentielles 2007 - 2ème tour;Présidentielles;2007;2;;;49;MONTROUGE;92049;26307;3565;22742;830;21912;ROYAL Ségolène;F;ROYAL;Ségolène;;11494
Législatives 2012 - 1er tour;Législatives;2012;1;8;8ème circonscription;22;CHAVILLE;92022;12808;4688;8120;75;8045;BENIERE Louise;F;BENIERE;Louise;DVD;31
Législatives 2012 - 1er tour;Législatives;2012;1;1;1ère circonscription;25;COLOMBES;92025;26337;13144;13193;209;12984;YAHIAOUI Karim;M;YAHIAOUI;Karim;CEN;218
Législatives 2012 - 1er tour;Législatives;2012;1;6;6ème circonscription;26;COURBEVOIE;92026;8123;3742;4381;140;4241;BRANNENS Marie;F;BRANNENS;Marie;SOC;1772
Législatives 2012 - 1er tour;Législatives;2012;1;12;12ème circonscription;32;FONTENAY AUX ROSES;92032;15230;5971;9259;85;9174;PEMEZEC Philippe;M;PEMEZEC;Philippe;UMP;2885
Législatives 2012 - 1er tour;Législatives;2012;1;3;3ème circonscription;35;LA GARENNE COLOMBES;92035;17314;7036;10278;79;10199;MARTINEZ Chaïb;M;MARTINEZ;Chaïb;AUT;85
Législatives 2012 - 1er tour;Législatives;2012;1;5;5ème circonscription;44;LEVALLOIS PERRET;92044;39546;14667;24879;238;24641;DUPONCHEL Pierre;M;DUPONCHEL;Pierre;DVD;227
Législatives 2012 - 1er tour;Législatives;2012;1;8;8ème circonscription;47;MARNES LA COQUETTE;92047;1085;330;755;2;753;LE BAUT Anne;F;LE BAUT;Anne;FN;39
Législatives 2012 - 1er tour;Législatives;2012;1;8;8ème circonscription;48;MEUDON;92048;25002;9709;15293;150;15143;CHETAILLE Romain;M;CHETAILLE;Romain;DVD;998
Législatives 2012 - 1er tour;Législatives;2012;1;11;11ème circonscription;49;MONTROUGE;92049;27889;10680;17209;123;17086;LE DEVEHAT Jean-Luc;M;LE DEVEHAT;Jean-Luc;EXG;42
Législatives 2012 - 1er tour;Législatives;2012;1;4;4ème circonscription;50;NANTERRE;92050;44344;21046;23298;337;22961;VINAYAGAMOORTHY Meenuka;F;VINAYAGAMOORTHY;Meenuka;RDG;154
Législatives 2012 - 1er tour;Législatives;2012;1;4;4ème circonscription;50;NANTERRE;92050;44344;21046;23298;337;22961;MARTIN Brieuc;M;MARTIN;Brieuc;AUT;88
Législatives 2012 - 1er tour;Législatives;2012;1;6;6ème circonscription;51;NEUILLY SUR SEINE;92051;37031;14672;22359;177;22182;GRANGER Marie;F;GRANGER;Marie;AUT;3
Législatives 2012 - 1er tour;Législatives;2012;1;7;7ème circonscription;63;RUEIL MALMAISON;92063;52518;20526;31992;298;31694;BLANCHARD Laurent;M;BLANCHARD;Laurent;AUT;377
Législatives 2012 - 1er tour;Législatives;2012;1;13;13ème circonscription;71;SCEAUX;92071;14395;5253;9142;70;9072;THIRIEZ Duncan;M;THIRIEZ;Duncan;AUT;77
Législatives 2012 - 1er tour;Législatives;2012;1;8;8ème circonscription;72;SEVRES;92072;14861;5785;9076;101;8975;GUILLET Jean-Jacques;M;GUILLET;Jean-Jacques;UMP;3079
Législatives 2012 - 1er tour;Législatives;2012;1;4;4ème circonscription;73;SURESNES;92073;26492;10723;15769;302;15467;DE BEAUFORT Viviane;F;DE BEAUFORT;Viviane;PRV;55
Législatives 2012 - 1er tour;Législatives;2012;1;10;10ème circonscription;75;VANVES;92075;17559;6347;11212;104;11108;SANTINI André;M;SANTINI;André;NCE;4056
Législatives 2012 - 1er tour;Législatives;2012;1;10;10ème circonscription;75;VANVES;92075;17559;6347;11212;104;11108;BUNOT Sandrine;F;BUNOT;Sandrine;FN;715
Législatives 2012 - 2ème tour;Législatives;2012;2;5;5ème circonscription;44;LEVALLOIS PERRET;92044;39546;14970;24576;954;23622;BALKANY Patrick;M;BALKANY;Patrick;UMP;15121
Législatives 2012 - 2ème tour;Législatives;2012;2;10;10ème circonscription;75;VANVES;92075;17559;6475;11084;203;10881;SANTINI André;M;SANTINI;André;NCE;5026
Législatives 2012 - 2ème tour;Législatives;2012;2;1;1ère circonscription;78;VILLENEUVE LA GARENNE;92078;12349;8556;3793;803;2990;BACHELAY Alexis;M;BACHELAY;Alexis;SOC;2990
Législatives 2012 - 1er tour;Législatives;2012;1;11;11ème circonscription;7;BAGNEUX;92007;20609;9648;10961;145;10816;MARCEL Baptiste;M;MARCEL;Baptiste;AUT;133
Législatives 2012 - 1er tour;Législatives;2012;1;9;9ème circonscription;12;BOULOGNE BILLANCOURT;92012;61020;24579;36441;340;36101;MARCEL Julien;M;MARCEL;Julien;DVD;1076
Législatives 2012 - 1er tour;Législatives;2012;1;8;8ème circonscription;22;CHAVILLE;92022;12808;4688;8120;75;8045;RABANY Dominique;F;RABANY;Dominique;FG;330
Législatives 1993 - 1er tour;Législatives;1993;1;4;4ème circonscription;50;NANTERRE;92050;38007;11484;26523;795;25728;DEMERCASTEL CHRISTIAN;M;DEMERCASTEL;CHRISTIAN;VEC;2023
Législatives 1993 - 1er tour;Législatives;1993;1;11;11ème circonscription;49;MONTROUGE;92049;22632;7554;15078;554;14524;POUSSIER MARTIAL;M;POUSSIER;MARTIAL;MAJ;70
Législatives 1993 - 1er tour;Législatives;1993;1;11;11ème circonscription;49;MONTROUGE;92049;22632;7554;15078;554;14524;NGUYEN M.FRANCE;F;NGUYEN;M.FRANCE;DIV;254
Législatives 1993 - 1er tour;Législatives;1993;1;3;3ème circonscription;35;LA GARENNE COLOMBES;92035;13664;4290;9374;347;9027;MORIN GABRIEL;M;MORIN;GABRIEL;DIV;206
Législatives 1993 - 1er tour;Législatives;1993;1;5;5ème circonscription;44;LEVALLOIS PERRET;92044;27392;7486;19906;624;19282;BALKANY PATRICK;M;BALKANY;PATRICK;RPR;9118
Législatives 1993 - 1er tour;Législatives;1993;1;11;11ème circonscription;46;MALAKOFF;92046;19559;6951;12608;416;12192;BERTINELLI M.JOSE;F;BERTINELLI;M.JOSE;DIV;138
Législatives 1993 - 1er tour;Législatives;1993;1;5;5ème circonscription;44;LEVALLOIS PERRET;92044;27392;7486;19906;624;19282;YADAN DOV;M;YADAN;DOV;DVD;208
Législatives 1993 - 1er tour;Législatives;1993;1;11;11ème circonscription;49;MONTROUGE;92049;22632;7554;15078;554;14524;PIROIS LOUIS;M;PIROIS;LOUIS;EXG;228
Législatives 1993 - 1er tour;Législatives;1993;1;11;11ème circonscription;46;MALAKOFF;92046;19559;6951;12608;416;12192;PIROIS LOUIS;M;PIROIS;LOUIS;EXG;150
Législatives 1993 - 1er tour;Législatives;1993;1;10;10ème circonscription;48;MEUDON;92048;4225;1396;2829;92;2737;HERVO DIDIER;M;HERVO;DIDIER;VEC;254
Législatives 1993 - 1er tour;Législatives;1993;1;7;7ème circonscription;64;SAINT CLOUD;92064;19166;6250;12916;429;12487;BAUMEL JACQUES;M;BAUMEL;JACQUES;RPR;7346
Législatives 1993 - 2ème tour;Législatives;1993;2;13;13ème circonscription;2;ANTONY;92002;36749;10926;25823;1776;24047;DEVEDJIAN PATRICK;M;DEVEDJIAN;PATRICK;RPR;14256
Législatives 2002 - 1er tour;Législatives;2002;1;13;13ème circonscription;2;ANTONY;92002;39807;13942;25865;456;25409;DELRIEU Denis;M;DELRIEU;Denis;VEC;1179
Législatives 2002 - 1er tour;Législatives;2002;1;13;13ème circonscription;2;ANTONY;92002;39807;13942;25865;456;25409;RIEUX Françoise;F;RIEUX;Françoise;EXD;104
Législatives 2002 - 1er tour;Législatives;2002;1;2;2ème circonscription;4;ASNIERES SUR SEINE;92004;44110;17783;26327;312;26015;JOURDAN Pascal;M;JOURDAN;Pascal;ECO;358
Législatives 2002 - 1er tour;Législatives;2002;1;13;13ème circonscription;14;BOURG LA REINE;92014;13381;4391;8990;78;8912;CANET Michèle;F;CANET;Michèle;SOC;2087
Législatives 2002 - 1er tour;Législatives;2002;1;12;12ème circonscription;20;CHATILLON;92020;20661;7083;13578;137;13441;KALTENBACH Philippe;M;KALTENBACH;Philippe;SOC;4107
Législatives 2002 - 1er tour;Législatives;2002;1;2;2ème circonscription;25;COLOMBES;92025;18336;7144;11192;207;10985;ETCHEBERRY Michèle;F;ETCHEBERRY;Michèle;SOC;2693
Législatives 2002 - 1er tour;Législatives;2002;1;1;1ère circonscription;36;GENNEVILLIERS;92036;20048;9522;10526;189;10337;MUZEAU Roland;M;MUZEAU;Roland;COM;5096
Législatives 2002 - 1er tour;Législatives;2002;1;4;4ème circonscription;50;NANTERRE;92050;42631;18721;23910;314;23596;BONNECHERE Nathalie;F;BONNECHERE;Nathalie;FN;902
Législatives 2002 - 1er tour;Législatives;2002;1;6;6ème circonscription;51;NEUILLY SUR SEINE;92051;39134;14738;24396;185;24211;GONZALEZ David;M;GONZALEZ;David;DIV;0
Législatives 2002 - 1er tour;Législatives;2002;1;12;12ème circonscription;60;LE PLESSIS ROBINSON;92060;16776;5588;11188;123;11065;CHABRAN Isabelle;F;CHABRAN;Isabelle;VEC;313
Législatives 2002 - 1er tour;Législatives;2002;1;7;7ème circonscription;64;SAINT CLOUD;92064;19115;6812;12303;93;12210;CROS André;M;CROS;André;UDFD;1304
Législatives 2002 - 1er tour;Législatives;2002;1;4;4ème circonscription;73;SURESNES;92073;24666;8949;15717;206;15511;ZEBDI-GHORAB Faouzia;F;ZEBDI-GHORAB;Faouzia;DIV;87
Législatives 2002 - 1er tour;Législatives;2002;1;10;10ème circonscription;75;VANVES;92075;17351;5929;11422;137;11285;VENTURINI Jean-Michel;M;VENTURINI;Jean-Michel;DIV;1
Législatives 2002 - 1er tour;Législatives;2002;1;8;8ème circonscription;76;VAUCRESSON;92076;6076;2206;3870;46;3824;RUSSO Annick;F;RUSSO;Annick;DIV;2
Législatives 2002 - 2ème tour;Législatives;2002;2;5;5ème circonscription;24;CLICHY;92024;24685;10326;14359;540;13819;CATOIRE GILLES;M;CATOIRE;GILLES;SOC;6594
Législatives 2002 - 2ème tour;Législatives;2002;2;7;7ème circonscription;64;SAINT CLOUD;92064;18263;7618;10645;307;10338;NADOR SOUHILA;F;NADOR;SOUHILA;SOC;2515
Législatives 2002 - 2ème tour;Législatives;2002;2;4;4ème circonscription;73;SURESNES;92073;22358;8411;13947;387;13560;DUPUY CHRISTIAN;M;DUPUY;CHRISTIAN;UMP;8427
Législatives 1997 - 2ème tour;Législatives;1997;2;3;3ème circonscription;35;LA GARENNE COLOMBES;92035;13992;4607;9385;405;8980;LAHEURTE RENAUD;M;LAHEURTE;RENAUD;SOC;3561
Législatives 1997 - 2ème tour;Législatives;1997;2;3;3ème circonscription;9;BOIS COLOMBES;92009;14757;4716;10041;430;9611;LAHEURTE RENAUD;M;LAHEURTE;RENAUD;SOC;3584
Législatives 1997 - 1er tour;Législatives;1997;1;8;8ème circonscription;77;VILLE D'AVRAY;92077;7112;2283;4829;139;4690;AMSALLEM EDDY;M;AMSALLEM;EDDY;EXG;45
Législatives 1993 - 2ème tour;Législatives;1993;2;12;12ème circonscription;23;CLAMART;92023;30899;10423;20476;1217;19259;FOUCHER J.PIERRE;M;FOUCHER;J.PIERRE;UDF;11634
Législatives 1993 - 2ème tour;Législatives;1993;2;11;11ème circonscription;7;BAGNEUX;92007;21150;7376;13774;852;12922;JAMBU JANINE;F;JAMBU;JANINE;COM;7342
Législatives 1993 - 2ème tour;Législatives;1993;2;4;4ème circonscription;73;SURESNES;92073;21290;6617;14673;815;13858;DUPUY CHRISTIAN;M;DUPUY;CHRISTIAN;RPR;8596
Législatives 1997 - 1er tour;Législatives;1997;1;13;13ème circonscription;2;ANTONY;92002;37772;12082;25690;861;24829;ORHAN LOUIS;M;ORHAN;LOUIS;EXG;663
Législatives 1997 - 1er tour;Législatives;1997;1;7;7ème circonscription;64;SAINT CLOUD;92064;18908;7095;11813;417;11396;LAGACHE YVES;M;LAGACHE;YVES;ECO;250
Législatives 1997 - 1er tour;Législatives;1997;1;10;10ème circonscription;75;VANVES;92075;15446;4682;10764;329;10435;JANVIER GUY;M;JANVIER;GUY;SOC;3020
Législatives 1993 - 1er tour;Législatives;1993;1;13;13ème circonscription;14;BOURG LA REINE;92014;12754;4085;8669;303;8366;LEFRERE CHRISTIANE;F;LEFRERE;CHRISTIANE;DIV;153
Législatives 1993 - 1er tour;Législatives;1993;1;10;10ème circonscription;12;BOULOGNE BILLANCOURT;92012;4523;1581;2942;133;2809;SANTINI ANDRE;M;SANTINI;ANDRE;UDF;1153
Législatives 1993 - 1er tour;Législatives;1993;1;12;12ème circonscription;20;CHATILLON;92020;15705;4455;11250;435;10815;COUTAT RICHARD;M;COUTAT;RICHARD;EXG;80
Législatives 1993 - 1er tour;Législatives;1993;1;8;8ème circonscription;22;CHAVILLE;92022;12345;3904;8441;296;8145;SUCHIER ANDRE;M;SUCHIER;ANDRE;DIV;106
Législatives 1993 - 1er tour;Législatives;1993;1;3;3ème circonscription;9;BOIS COLOMBES;92009;14392;4251;10141;422;9719;COUSIN GUY;M;COUSIN;GUY;DIV;141
Législatives 1993 - 1er tour;Législatives;1993;1;11;11ème circonscription;7;BAGNEUX;92007;21150;7754;13396;474;12922;AFONSO HENRI;M;AFONSO;HENRI;DIV;110
Législatives 1993 - 1er tour;Législatives;1993;1;2;2ème circonscription;25;COLOMBES;92025;18324;5870;12454;434;12020;LANERET MICHEL;M;LANERET;MICHEL;SOC;1411
Législatives 1993 - 1er tour;Législatives;1993;1;12;12ème circonscription;32;FONTENAY AUX ROSES;92032;15091;4963;10128;341;9787;BUCHET PASCAL;M;BUCHET;PASCAL;SOC;1986
Législatives 1993 - 1er tour;Législatives;1993;1;3;3ème circonscription;26;COURBEVOIE;92026;34737;9916;24821;828;23993;MASSOU GABRIEL;M;MASSOU;GABRIEL;COM;1144
Législatives 1993 - 1er tour;Législatives;1993;1;2;2ème circonscription;25;COLOMBES;92025;18324;5870;12454;434;12020;PIROD GUY;M;PIROD;GUY;EXD;43
Législatives 1997 - 1er tour;Législatives;1997;1;13;13ème circonscription;14;BOURG LA REINE;92014;12587;4431;8156;266;7890;MARTIN ANNICK;F;MARTIN;ANNICK;FRN;828
Législatives 1997 - 1er tour;Législatives;1997;1;8;8ème circonscription;22;CHAVILLE;92022;12268;3930;8338;262;8076;BRISSAUD SOPHIE;F;BRISSAUD;SOPHIE;FRN;1087
Législatives 1997 - 1er tour;Législatives;1997;1;12;12ème circonscription;23;CLAMART;92023;30471;10310;20161;590;19571;ILTIS DANIELLE;F;ILTIS;DANIELLE;EXG;125
Législatives 1997 - 1er tour;Législatives;1997;1;11;11ème circonscription;49;MONTROUGE;92049;21975;7943;14032;388;13644;BOURDIN YVES;M;BOURDIN;YVES;EXG;77
Législatives 1997 - 1er tour;Législatives;1997;1;5;5ème circonscription;24;CLICHY;92024;23725;8942;14783;486;14297;LALUMIERE CATHERINE;F;LALUMIERE;CATHERINE;PRS;3499
Législatives 1997 - 1er tour;Législatives;1997;1;12;12ème circonscription;23;CLAMART;92023;30471;10310;20161;590;19571;BREITBURD NICOLAS;M;BREITBURD;NICOLAS;DVD;231
Législatives 1997 - 1er tour;Législatives;1997;1;2;2ème circonscription;25;COLOMBES;92025;17603;6110;11493;415;11078;PIGAULT J.MARC;M;PIGAULT;J.MARC;EXG;160
Législatives 1997 - 1er tour;Législatives;1997;1;5;5ème circonscription;24;CLICHY;92024;23725;8942;14783;486;14297;OSTER R.OLIVIER;M;OSTER;R.OLIVIER;DIV;0
Législatives 1997 - 1er tour;Législatives;1997;1;5;5ème circonscription;24;CLICHY;92024;23725;8942;14783;486;14297;FOURNIER ALAIN;M;FOURNIER;ALAIN;ECO;484
Législatives 1997 - 1er tour;Législatives;1997;1;5;5ème circonscription;44;LEVALLOIS PERRET;92044;28281;9315;18966;650;18316;FLAHAULT BRIGITTE;F;FLAHAULT;BRIGITTE;DVD;947
Législatives 1997 - 1er tour;Législatives;1997;1;5;5ème circonscription;44;LEVALLOIS PERRET;92044;28281;9315;18966;650;18316;OSTER R.OLIVIER;M;OSTER;R.OLIVIER;DIV;0
Législatives 1997 - 1er tour;Législatives;1997;1;11;11ème circonscription;46;MALAKOFF;92046;19124;7233;11891;338;11553;BOURDIN YVES;M;BOURDIN;YVES;EXG;47
Législatives 1997 - 1er tour;Législatives;1997;1;12;12ème circonscription;32;FONTENAY AUX ROSES;92032;14748;4655;10093;259;9834;GRIELEN ALAIN;M;GRIELEN;ALAIN;DVG;65
Législatives 1997 - 1er tour;Législatives;1997;1;9;9ème circonscription;12;BOULOGNE BILLANCOURT;92012;53287;18902;34385;948;33437;CASTAGNETTI JOSEPH;M;CASTAGNETTI;JOSEPH;DIV;147
Législatives 1997 - 1er tour;Législatives;1997;1;10;10ème circonscription;12;BOULOGNE BILLANCOURT;92012;4529;1717;2812;99;2713;BRUNET FRANCOISE;F;BRUNET;FRANCOISE;EXG;88
Législatives 1997 - 1er tour;Législatives;1997;1;9;9ème circonscription;12;BOULOGNE BILLANCOURT;92012;53287;18902;34385;948;33437;ASKINAZI GERARD;M;ASKINAZI;GERARD;DVD;1842
Législatives 1997 - 1er tour;Législatives;1997;1;13;13ème circonscription;14;BOURG LA REINE;92014;12587;4431;8156;266;7890;DEVEDJIAN PATRICK;M;DEVEDJIAN;PATRICK;RPR;3238
Législatives 1997 - 1er tour;Législatives;1997;1;6;6ème circonscription;62;PUTEAUX;92062;24329;8862;15467;635;14832;CASSETTE DANIELE;F;CASSETTE;DANIELE;EXG;427
Législatives 1997 - 1er tour;Législatives;1997;1;6;6ème circonscription;62;PUTEAUX;92062;24329;8862;15467;635;14832;SARKOZY NICOLAS;M;SARKOZY;NICOLAS;RPR;6116
Législatives 2017 - 1er tour;Législatives;2017;1;1;1ère circonscription;78;VILLENEUVE LA GARENNE;92078;12445;8430;4015;143;3872;PIJOAN David;M;PIJOAN;David;EXG;8
Législatives 2017 - 1er tour;Législatives;2017;1;11;11ème circonscription;46;MALAKOFF;92046;18448;8148;10300;133;10167;TAUTHUI Stéphane;M;TAUTHUI;Stéphane;DVD;56
Législatives 2017 - 1er tour;Législatives;2017;1;12;12ème circonscription;20;CHATILLON;92020;22311;9527;12784;186;12598;BAHLOUL Madeleine;F;BAHLOUL;Madeleine;FI;1248
Législatives 2017 - 1er tour;Législatives;2017;1;12;12ème circonscription;20;CHATILLON;92020;22311;9527;12784;186;12598;BOURLANGES Jean-Louis;M;BOURLANGES;Jean-Louis;MDM;5503
Législatives 2017 - 1er tour;Législatives;2017;1;12;12ème circonscription;23;CLAMART;92023;35342;15954;19388;238;19150;GARCIA-BADIN Théo;M;GARCIA-BADIN;Théo;ECO;710
Législatives 2017 - 1er tour;Législatives;2017;1;12;12ème circonscription;23;CLAMART;92023;35342;15954;19388;238;19150;PEMEZEC Philippe;M;PEMEZEC;Philippe;LR;4355
Législatives 2017 - 1er tour;Législatives;2017;1;12;12ème circonscription;32;FONTENAY AUX ROSES;92032;16049;7756;8293;93;8200;PERDRIAULT Mathieu;M;PERDRIAULT;Mathieu;DIV;17
Législatives 2017 - 1er tour;Législatives;2017;1;4;4ème circonscription;73;SURESNES;92073;28524;12725;15799;423;15376;MAHMOOD Shahnissar;F;MAHMOOD;Shahnissar;DLF;139
Législatives 2017 - 1er tour;Législatives;2017;1;4;4ème circonscription;73;SURESNES;92073;28524;12725;15799;423;15376;BOUKHEDIMI Patrick;M;BOUKHEDIMI;Patrick;EXG;17
Législatives 2017 - 1er tour;Législatives;2017;1;4;4ème circonscription;50;NANTERRE;92050;47651;26455;21196;432;20764;SALLES Laurent;M;SALLES;Laurent;FN;1409
Législatives 2017 - 1er tour;Législatives;2017;1;10;10ème circonscription;40;ISSY LES MOULINEAUX;92040;45375;19009;26366;517;25849;DRELON Marie-Thérèse;F;DRELON;Marie-Thérèse;DIV;282
Législatives 2017 - 1er tour;Législatives;2017;1;10;10ème circonscription;48;MEUDON;92048;6009;2545;3464;38;3426;MALEYRE Anne-Laure;F;MALEYRE;Anne-Laure;FN;137
Législatives 2017 - 1er tour;Législatives;2017;1;10;10ème circonscription;12;BOULOGNE BILLANCOURT;92012;9082;4562;4520;114;4406;VIGUIÉ Laurence;F;VIGUIÉ;Laurence;EXG;33
Législatives 2017 - 1er tour;Législatives;2017;1;10;10ème circonscription;12;BOULOGNE BILLANCOURT;92012;9082;4562;4520;114;4406;ZAZOUN Messaoud;M;ZAZOUN;Messaoud;DIV;37
Législatives 2017 - 1er tour;Législatives;2017;1;3;3ème circonscription;35;LA GARENNE COLOMBES;92035;18829;8238;10591;114;10477;BANCHET Julien;M;BANCHET;Julien;DIV;35
Législatives 2017 - 1er tour;Législatives;2017;1;5;5ème circonscription;44;LEVALLOIS PERRET;92044;41751;17632;24119;255;23864;RONDEPIERRE Geoffroy;M;RONDEPIERRE;Geoffroy;FN;865
Législatives 2017 - 1er tour;Législatives;2017;1;5;5ème circonscription;44;LEVALLOIS PERRET;92044;41751;17632;24119;255;23864;HERVO Xavier;M;HERVO;Xavier;DIV;81
Législatives 2017 - 1er tour;Législatives;2017;1;5;5ème circonscription;44;LEVALLOIS PERRET;92044;41751;17632;24119;255;23864;ZIANI Mimoun;M;ZIANI;Mimoun;DIV;117
Législatives 2017 - 1er tour;Législatives;2017;1;6;6ème circonscription;26;COURBEVOIE;92026;8107;4228;3879;107;3772;PAUCHET Jonathan;M;PAUCHET;Jonathan;DIV;33
Législatives 2017 - 1er tour;Législatives;2017;1;8;8ème circonscription;47;MARNES LA COQUETTE;92047;1215;451;764;4;760;DUBOIS Renaud;M;DUBOIS;Renaud;ECO;19
Législatives 2017 - 1er tour;Législatives;2017;1;8;8ème circonscription;72;SEVRES;92072;15144;6343;8801;149;8652;DUBOIS Renaud;M;DUBOIS;Renaud;ECO;499
Législatives 2017 - 1er tour;Législatives;2017;1;8;8ème circonscription;72;SEVRES;92072;15144;6343;8801;149;8652;THOMAS Marc;M;THOMAS;Marc;FN;369
Législatives 2017 - 1er tour;Législatives;2017;1;7;7ème circonscription;33;GARCHES;92033;12777;5514;7263;115;7148;SOUCHÈRE Sophie;F;SOUCHÈRE;Sophie;DLF;88
Législatives 2017 - 1er tour;Législatives;2017;1;7;7ème circonscription;64;SAINT CLOUD;92064;19410;7490;11920;102;11818;ABAD Cécile;F;ABAD;Cécile;EXG;13
Législatives 2017 - 1er tour;Législatives;2017;1;6;6ème circonscription;51;NEUILLY SUR SEINE;92051;37215;15249;21966;119;21847;CUIGNET Emmanuelle;F;CUIGNET;Emmanuelle;FN;522
Législatives 2017 - 1er tour;Législatives;2017;1;6;6ème circonscription;51;NEUILLY SUR SEINE;92051;37215;15249;21966;119;21847;DE CHOISY Hugo;M;DE CHOISY;Hugo;DIV;74
Législatives 2017 - 1er tour;Législatives;2017;1;6;6ème circonscription;62;PUTEAUX;92062;28983;11794;17189;436;16753;MARCEL Françoise;F;MARCEL;Françoise;EXG;97
Législatives 2017 - 1er tour;Législatives;2017;1;10;10ème circonscription;48;MEUDON;92048;6009;2545;3464;38;3426;FOSSAERT Michel;M;FOSSAERT;Michel;ECO;6
Présidentielles 1995 - 1er tour;Présidentielles;1995;1;;;2;ANTONY;92002;37894;9274;28620;590;28030;CHEMINADE JACQUES;M;CHEMINADE;JACQUES;;79
Présidentielles 1995 - 2ème tour;Présidentielles;1995;2;;;4;ASNIERES SUR SEINE;92004;39050;9195;29855;1421;28434;CHIRAC JACQUES;M;CHIRAC;JACQUES;;11122
Présidentielles 1995 - 2ème tour;Présidentielles;1995;2;;;20;CHATILLON;92020;16579;3299;13280;631;12649;CHIRAC JACQUES;M;CHIRAC;JACQUES;;6892
Présidentielles 1995 - 2ème tour;Présidentielles;1995;2;;;40;ISSY LES MOULINEAUX;92040;30037;6886;23151;1077;22074;CHIRAC JACQUES;M;CHIRAC;JACQUES;;12482
Présidentielles 1995 - 2ème tour;Présidentielles;1995;2;;;60;LE PLESSIS ROBINSON;92060;13056;2868;10188;561;9627;CHIRAC JACQUES;M;CHIRAC;JACQUES;;5111
Présidentielles 1995 - 1er tour;Présidentielles;1995;1;;;50;NANTERRE;92050;46920;11548;35372;736;34636;VILLIERS DE PHILIPPE;M;VILLIERS DE;PHILIPPE;;984
Présidentielles 1995 - 1er tour;Présidentielles;1995;1;;;50;NANTERRE;92050;46920;11548;35372;736;34636;CHEMINADE JACQUES;M;CHEMINADE;JACQUES;;121
Présidentielles 1995 - 1er tour;Présidentielles;1995;1;;;50;NANTERRE;92050;46920;11548;35372;736;34636;BALLADUR EDOUARD;M;BALLADUR;EDOUARD;;4303
Présidentielles 1995 - 1er tour;Présidentielles;1995;1;;;49;MONTROUGE;92049;22293;5924;16369;314;16055;LE PEN J.MARIE;M;LE PEN;J.MARIE;;1707
Présidentielles 1995 - 1er tour;Présidentielles;1995;1;;;35;LA GARENNE COLOMBES;92035;14104;3637;10467;225;10242;JOSPIN LIONEL;M;JOSPIN;LIONEL;;2242
Présidentielles 1995 - 1er tour;Présidentielles;1995;1;;;26;COURBEVOIE;92026;35812;8064;27748;468;27280;VOYNET DOMINIQUE;F;VOYNET;DOMINIQUE;;804
Présidentielles 1995 - 1er tour;Présidentielles;1995;1;;;26;COURBEVOIE;92026;35812;8064;27748;468;27280;HUE ROBERT;M;HUE;ROBERT;;1198
Présidentielles 1995 - 1er tour;Présidentielles;1995;1;;;64;SAINT CLOUD;92064;18989;5119;13870;179;13691;VILLIERS DE PHILIPPE;M;VILLIERS DE;PHILIPPE;;526
Présidentielles 1995 - 1er tour;Présidentielles;1995;1;;;19;CHATENAY MALABRY;92019;18227;5121;13106;238;12868;LAGUILLER ARLETTE;F;LAGUILLER;ARLETTE;;671
Présidentielles 1995 - 1er tour;Présidentielles;1995;1;;;19;CHATENAY MALABRY;92019;18227;5121;13106;238;12868;BALLADUR EDOUARD;M;BALLADUR;EDOUARD;;2157
Présidentielles 1995 - 1er tour;Présidentielles;1995;1;;;7;BAGNEUX;92007;20166;5090;15076;308;14768;LAGUILLER ARLETTE;F;LAGUILLER;ARLETTE;;885
Présidentielles 1995 - 1er tour;Présidentielles;1995;1;;;73;SURESNES;92073;21968;5851;16117;341;15776;VOYNET DOMINIQUE;F;VOYNET;DOMINIQUE;;505
Présidentielles 1995 - 1er tour;Présidentielles;1995;1;;;72;SEVRES;92072;13745;2869;10876;183;10693;VOYNET DOMINIQUE;F;VOYNET;DOMINIQUE;;401
Présidentielles 1995 - 1er tour;Présidentielles;1995;1;;;71;SCEAUX;92071;13371;3073;10298;170;10128;BALLADUR EDOUARD;M;BALLADUR;EDOUARD;;2353
Présidentielles 2007 - 1er tour;Présidentielles;2007;1;;;14;BOURG LA REINE;92014;13108;1436;11672;90;11582;LE PEN Jean-Marie;M;LE PEN;Jean-Marie;;538
Présidentielles 2007 - 1er tour;Présidentielles;2007;1;;;24;CLICHY;92024;28539;4472;24067;245;23822;BOVÉ José;M;BOVÉ;José;;303
Présidentielles 2007 - 1er tour;Présidentielles;2007;1;;;25;COLOMBES;92025;44025;7536;36489;501;35988;ROYAL Ségolène;F;ROYAL;Ségolène;;11880
Présidentielles 2007 - 1er tour;Présidentielles;2007;1;;;26;COURBEVOIE;92026;48308;7118;41190;456;40734;SARKOZY Nicolas;M;SARKOZY;Nicolas;;17378
Présidentielles 2007 - 1er tour;Présidentielles;2007;1;;;32;FONTENAY AUX ROSES;92032;15234;2027;13207;123;13084;LAGUILLER Arlette;F;LAGUILLER;Arlette;;110
Présidentielles 2007 - 1er tour;Présidentielles;2007;1;;;33;GARCHES;92033;11957;1346;10611;106;10505;BESANCENOT Olivier;M;BESANCENOT;Olivier;;181
Présidentielles 2007 - 1er tour;Présidentielles;2007;1;;;33;GARCHES;92033;11957;1346;10611;106;10505;BAYROU François;M;BAYROU;François;;2231
Présidentielles 2007 - 1er tour;Présidentielles;2007;1;;;33;GARCHES;92033;11957;1346;10611;106;10505;NIHOUS Frédéric;M;NIHOUS;Frédéric;;31
Présidentielles 2007 - 1er tour;Présidentielles;2007;1;;;46;MALAKOFF;92046;18259;2640;15619;178;15441;BOVÉ José;M;BOVÉ;José;;217
Présidentielles 2007 - 1er tour;Présidentielles;2007;1;;;49;MONTROUGE;92049;26299;3093;23206;219;22987;BOVÉ José;M;BOVÉ;José;;248
Présidentielles 2007 - 1er tour;Présidentielles;2007;1;;;50;NANTERRE;92050;42083;6117;35966;477;35489;BOVÉ José;M;BOVÉ;José;;578
Présidentielles 2007 - 1er tour;Présidentielles;2007;1;;;60;LE PLESSIS ROBINSON;92060;16571;1989;14582;159;14423;BOVÉ José;M;BOVÉ;José;;102
Présidentielles 2007 - 1er tour;Présidentielles;2007;1;;;64;SAINT CLOUD;92064;18455;1926;16529;91;16438;VOYNET Dominique;F;VOYNET;Dominique;;217
Présidentielles 2007 - 1er tour;Présidentielles;2007;1;;;64;SAINT CLOUD;92064;18455;1926;16529;91;16438;NIHOUS Frédéric;M;NIHOUS;Frédéric;;32
Présidentielles 2007 - 1er tour;Présidentielles;2007;1;;;73;SURESNES;92073;24255;2600;21655;272;21383;BESANCENOT Olivier;M;BESANCENOT;Olivier;;506
Présidentielles 2007 - 1er tour;Présidentielles;2007;1;;;73;SURESNES;92073;24255;2600;21655;272;21383;BAYROU François;M;BAYROU;François;;4727
Présidentielles 2007 - 1er tour;Présidentielles;2007;1;;;73;SURESNES;92073;24255;2600;21655;272;21383;NIHOUS Frédéric;M;NIHOUS;Frédéric;;52
Présidentielles 2007 - 1er tour;Présidentielles;2007;1;;;76;VAUCRESSON;92076;5902;781;5121;42;5079;BAYROU François;M;BAYROU;François;;1045
Présidentielles 2007 - 1er tour;Présidentielles;2007;1;;;76;VAUCRESSON;92076;5902;781;5121;42;5079;de VILLIERS Philippe;M;de VILLIERS;Philippe;;59
Présidentielles 2017 - 1er tour;Présidentielles;2017;1;;;2;ANTONY;92002;41488;6486;35002;776;34226;HAMON Benoît;M;HAMON;Benoît;;2684
Présidentielles 2017 - 1er tour;Présidentielles;2017;1;;;2;ANTONY;92002;41488;6486;35002;776;34226;POUTOU Philippe;M;POUTOU;Philippe;;188
Présidentielles 2017 - 1er tour;Présidentielles;2017;1;;;20;CHATILLON;92020;22292;3682;18610;351;18259;LASSALLE Jean;M;LASSALLE;Jean;;135
Présidentielles 2017 - 1er tour;Présidentielles;2017;1;;;22;CHAVILLE;92022;13493;2042;11451;183;11267;LASSALLE Jean;M;LASSALLE;Jean;;74
Présidentielles 2017 - 1er tour;Présidentielles;2017;1;;;22;CHAVILLE;92022;13493;2042;11451;183;11267;POUTOU Philippe;M;POUTOU;Philippe;;70
Présidentielles 2017 - 1er tour;Présidentielles;2017;1;;;32;FONTENAY AUX ROSES;92032;16036;3739;12297;218;12078;ARTHAUD Nathalie;F;ARTHAUD;Nathalie;;65
Présidentielles 2017 - 1er tour;Présidentielles;2017;1;;;47;MARNES LA COQUETTE;92047;1215;171;1044;5;1039;FILLON François;M;FILLON;François;;554
Présidentielles 2017 - 1er tour;Présidentielles;2017;1;;;49;MONTROUGE;92049;28899;4312;24587;429;24158;FILLON François;M;FILLON;François;;5216
Présidentielles 2017 - 1er tour;Présidentielles;2017;1;;;50;NANTERRE;92050;47568;10655;36913;884;36029;LE PEN Marine;F;LE PEN;Marine;;3759
Présidentielles 2017 - 1er tour;Présidentielles;2017;1;;;50;NANTERRE;92050;47568;10655;36913;884;36029;MACRON Emmanuel;M;MACRON;Emmanuel;;9990
Présidentielles 2017 - 1er tour;Présidentielles;2017;1;;;73;SURESNES;92073;28497;4342;24155;520;23635;ASSELINEAU François;M;ASSELINEAU;François;;224
Présidentielles 2012 - 1er tour;Présidentielles;2012;1;;;9;BOIS COLOMBES;92009;16746;3612;13134;231;12903;LE PEN Marine;F;LE PEN;Marine;;1056
Présidentielles 2012 - 1er tour;Présidentielles;2012;1;;;14;BOURG LA REINE;92014;13300;2381;10919;132;10787;JOLY Eva;F;JOLY;Eva;;367
Présidentielles 2012 - 1er tour;Présidentielles;2012;1;;;25;COLOMBES;92025;44741;10181;34560;526;34034;SARKOZY Nicolas;M;SARKOZY;Nicolas;;8890
Présidentielles 2012 - 1er tour;Présidentielles;2012;1;;;26;COURBEVOIE;92026;50576;11277;39299;681;38618;HOLLANDE François;M;HOLLANDE;François;;10912
Présidentielles 2012 - 1er tour;Présidentielles;2012;1;;;32;FONTENAY AUX ROSES;92032;15217;3289;11928;161;11767;MÉLENCHON Jean-Luc;M;MÉLENCHON;Jean-Luc;;1420
Présidentielles 2012 - 1er tour;Présidentielles;2012;1;;;51;NEUILLY SUR SEINE;92051;37003;5964;31039;257;30782;LE PEN Marine;F;LE PEN;Marine;;1539
Présidentielles 2012 - 1er tour;Présidentielles;2012;1;;;64;SAINT CLOUD;92064;18973;3529;15444;153;15291;BAYROU François;M;BAYROU;François;;1843
Présidentielles 2012 - 1er tour;Présidentielles;2012;1;;;73;SURESNES;92073;26458;5110;21348;425;20923;POUTOU Philippe;M;POUTOU;Philippe;;137
Présidentielles 2002 - 1er tour;Présidentielles;2002;1;;;46;MALAKOFF;92046;17268;6020;11248;271;10977;LEPAGE CORINNE;F;LEPAGE;CORINNE;;209
Présidentielles 2002 - 1er tour;Présidentielles;2002;1;;;47;MARNES LA COQUETTE;92047;997;272;725;7;718;MAMERE NOEL;M;MAMERE;NOEL;;19
Présidentielles 2002 - 1er tour;Présidentielles;2002;1;;;51;NEUILLY SUR SEINE;92051;34066;10108;23958;309;23649;LE PEN JEAN-MARIE;M;LE PEN;JEAN-MARIE;;2269
Présidentielles 2002 - 1er tour;Présidentielles;2002;1;;;62;PUTEAUX;92062;23861;6804;17057;487;16570;LAGUILLER ARLETTE;F;LAGUILLER;ARLETTE;;719
Présidentielles 2002 - 1er tour;Présidentielles;2002;1;;;71;SCEAUX;92071;12917;3930;8987;154;8833;BAYROU FRANCOIS;M;BAYROU;FRANCOIS;;1096
Présidentielles 2002 - 1er tour;Présidentielles;2002;1;;;72;SEVRES;92072;13367;4140;9227;153;9074;MEGRET BRUNO;M;MEGRET;BRUNO;;106
Présidentielles 2002 - 1er tour;Présidentielles;2002;1;;;72;SEVRES;92072;13367;4140;9227;153;9074;TAUBIRA CHRISTIANE;F;TAUBIRA;CHRISTIANE;;293
Présidentielles 2002 - 1er tour;Présidentielles;2002;1;;;73;SURESNES;92073;22099;7156;14943;329;14614;JOSPIN LIONEL;M;JOSPIN;LIONEL;;2527
Présidentielles 2002 - 1er tour;Présidentielles;2002;1;;;76;VAUCRESSON;92076;5861;2048;3813;62;3751;BAYROU FRANCOIS;M;BAYROU;FRANCOIS;;418
Présidentielles 2002 - 1er tour;Présidentielles;2002;1;;;77;VILLE D'AVRAY;92077;7251;2486;4765;70;4695;HUE ROBERT;M;HUE;ROBERT;;35
Présidentielles 2002 - 1er tour;Présidentielles;2002;1;;;78;VILLENEUVE LA GARENNE;92078;11406;4746;6660;180;6480;CHIRAC JACQUES;M;CHIRAC;JACQUES;;1173
Présidentielles 2002 - 1er tour;Présidentielles;2002;1;;;78;VILLENEUVE LA GARENNE;92078;11406;4746;6660;180;6480;BESANCENOT OLIVIER;M;BESANCENOT;OLIVIER;;182
Présidentielles 2002 - 1er tour;Présidentielles;2002;1;;;2;ANTONY;92002;36989;11047;25942;517;25425;HUE ROBERT;M;HUE;ROBERT;;794
Présidentielles 2002 - 1er tour;Présidentielles;2002;1;;;12;BOULOGNE BILLANCOURT;92012;57382;17570;39812;645;39167;LE PEN JEAN-MARIE;M;LE PEN;JEAN-MARIE;;4149
Présidentielles 2002 - 1er tour;Présidentielles;2002;1;;;14;BOURG LA REINE;92014;12075;3519;8556;149;8407;LE PEN JEAN-MARIE;M;LE PEN;JEAN-MARIE;;818
Présidentielles 2002 - 1er tour;Présidentielles;2002;1;;;14;BOURG LA REINE;92014;12075;3519;8556;149;8407;MAMERE NOEL;M;MAMERE;NOEL;;441
Législatives 2017 - 1er tour;Législatives;2017;1;1;1ère circonscription;36;GENNEVILLIERS;92036;22174;13223;8951;243;8708;BORDREUIL Myriam;F;BORDREUIL;Myriam;DVD;10
Législatives 2017 - 1er tour;Législatives;2017;1;1;1ère circonscription;36;GENNEVILLIERS;92036;22174;13223;8951;243;8708;KHALFI Isia;F;KHALFI;Isia;REM;1762
Législatives 2017 - 1er tour;Législatives;2017;1;5;5ème circonscription;24;CLICHY;92024;28620;14628;13992;265;13727;RONDEPIERRE Geoffroy;M;RONDEPIERRE;Geoffroy;FN;741
Législatives 2017 - 1er tour;Législatives;2017;1;6;6ème circonscription;26;COURBEVOIE;92026;8107;4228;3879;107;3772;PINCEMIN Martine;F;PINCEMIN;Martine;EXD;14
Législatives 2017 - 1er tour;Législatives;2017;1;6;6ème circonscription;51;NEUILLY SUR SEINE;92051;37215;15249;21966;119;21847;PAUCHET Jonathan;M;PAUCHET;Jonathan;DIV;65
Législatives 2017 - 1er tour;Législatives;2017;1;6;6ème circonscription;62;PUTEAUX;92062;28983;11794;17189;436;16753;ZAMECZKOWSKI Laurent;M;ZAMECZKOWSKI;Laurent;REM;7307
Législatives 2017 - 1er tour;Législatives;2017;1;7;7ème circonscription;33;GARCHES;92033;12777;5514;7263;115;7148;LAPORTE Lucia;F;LAPORTE;Lucia;FN;321
Législatives 2017 - 1er tour;Législatives;2017;1;8;8ème circonscription;47;MARNES LA COQUETTE;92047;1215;451;764;4;760;SCHNEIDER Frédéric;M;SCHNEIDER;Frédéric;DIV;2
Législatives 2017 - 1er tour;Législatives;2017;1;8;8ème circonscription;48;MEUDON;92048;25240;11059;14181;174;14007;EPPLING Robin;M;EPPLING;Robin;DIV;331
Législatives 2017 - 1er tour;Législatives;2017;1;10;10ème circonscription;40;ISSY LES MOULINEAUX;92040;45375;19009;26366;517;25849;COUR Philippine;F;COUR;Philippine;DLF;163
Législatives 2017 - 1er tour;Législatives;2017;1;10;10ème circonscription;75;VANVES;92075;18507;7626;10881;125;10756;MOREAU Nicolas;M;MOREAU;Nicolas;DVG;94
Législatives 2017 - 1er tour;Législatives;2017;1;11;11ème circonscription;7;BAGNEUX;92007;21911;12424;9487;167;9320;CUDENNEC Lionel;M;CUDENNEC;Lionel;DIV;56
Législatives 2017 - 1er tour;Législatives;2017;1;12;12ème circonscription;32;FONTENAY AUX ROSES;92032;16049;7756;8293;93;8200;REJA-BRET Alexandre;M;REJA-BRET;Alexandre;DIV;3
Législatives 2017 - 1er tour;Législatives;2017;1;13;13ème circonscription;2;ANTONY;92002;41542;17216;24326;446;23880;LAFFITE Agnès;F;LAFFITE;Agnès;FN;1096
Législatives 2017 - 1er tour;Législatives;2017;1;13;13ème circonscription;14;BOURG LA REINE;92014;13736;5356;8380;81;8299;CUKIERMAN Maurice;M;CUKIERMAN;Maurice;EXG;12
Législatives 2017 - 1er tour;Législatives;2017;1;13;13ème circonscription;14;BOURG LA REINE;92014;13736;5356;8380;81;8299;LASGI Nicolas;M;LASGI;Nicolas;FI;669
Législatives 2017 - 1er tour;Législatives;2017;1;13;13ème circonscription;19;CHATENAY MALABRY;92019;18752;8166;10586;245;10341;DELRIEU Denis;M;DELRIEU;Denis;ECO;382
Législatives 2017 - 2ème tour;Législatives;2017;2;5;5ème circonscription;24;CLICHY;92024;28619;17354;11265;1596;9669;CALVEZ Céline;F;CALVEZ;Céline;REM;6542
Législatives 2017 - 2ème tour;Législatives;2017;2;5;5ème circonscription;24;CLICHY;92024;28619;17354;11265;1596;9669;DE COURSON Arnaud;M;DE COURSON;Arnaud;LR;3127
Législatives 2017 - 2ème tour;Législatives;2017;2;12;12ème circonscription;23;CLAMART;92023;35342;18577;16765;1453;15312;BOURLANGES Jean-Louis;M;BOURLANGES;Jean-Louis;MDM;9470
Législatives 2017 - 1er tour;Législatives;2017;1;4;4ème circonscription;73;SURESNES;92073;28524;12725;15799;423;15376;STRUMANNE Laurent;M;STRUMANNE;Laurent;EXG;52
Législatives 2017 - 1er tour;Législatives;2017;1;4;4ème circonscription;73;SURESNES;92073;28524;12725;15799;423;15376;MARTIN Alexis;M;MARTIN;Alexis;ECO;530
Présidentielles 2017 - 1er tour;Présidentielles;2017;1;;;14;BOURG LA REINE;92014;13769;2202;11567;212;11355;CHEMINADE Jacques;M;CHEMINADE;Jacques;;15
Présidentielles 2017 - 1er tour;Présidentielles;2017;1;;;22;CHAVILLE;92022;13493;2042;11451;183;11267;DUPONT-AIGNAN Nicolas;M;DUPONT-AIGNAN;Nicolas;;356
Présidentielles 2017 - 1er tour;Présidentielles;2017;1;;;22;CHAVILLE;92022;13493;2042;11451;183;11267;MÉLENCHON Jean-Luc;M;MÉLENCHON;Jean-Luc;;1814
Présidentielles 2017 - 1er tour;Présidentielles;2017;1;;;23;CLAMART;92023;35291;6330;28961;560;28401;MÉLENCHON Jean-Luc;M;MÉLENCHON;Jean-Luc;;5339
Présidentielles 2017 - 1er tour;Présidentielles;2017;1;;;24;CLICHY;92024;28553;5564;22989;498;22491;LASSALLE Jean;M;LASSALLE;Jean;;117
Présidentielles 2017 - 1er tour;Présidentielles;2017;1;;;25;COLOMBES;92025;47454;9714;37740;907;36833;POUTOU Philippe;M;POUTOU;Philippe;;287
Présidentielles 2017 - 1er tour;Présidentielles;2017;1;;;32;FONTENAY AUX ROSES;92032;16036;3739;12297;218;12078;LASSALLE Jean;M;LASSALLE;Jean;;90
Présidentielles 2017 - 1er tour;Présidentielles;2017;1;;;33;GARCHES;92033;12767;1975;10792;194;10598;FILLON François;M;FILLON;François;;4496
Présidentielles 2017 - 1er tour;Présidentielles;2017;1;;;48;MEUDON;92048;31280;5715;25565;405;25160;LE PEN Marine;F;LE PEN;Marine;;2003
Présidentielles 2017 - 1er tour;Présidentielles;2017;1;;;50;NANTERRE;92050;47568;10655;36913;884;36029;POUTOU Philippe;M;POUTOU;Philippe;;366
Présidentielles 2017 - 1er tour;Présidentielles;2017;1;;;60;LE PLESSIS ROBINSON;92060;19141;2947;16194;344;15850;LASSALLE Jean;M;LASSALLE;Jean;;102
Présidentielles 2017 - 1er tour;Présidentielles;2017;1;;;62;PUTEAUX;92062;28950;4530;24420;549;23871;CHEMINADE Jacques;M;CHEMINADE;Jacques;;43
Présidentielles 2017 - 1er tour;Présidentielles;2017;1;;;63;RUEIL MALMAISON;92063;54426;9298;45128;713;44414;LE PEN Marine;F;LE PEN;Marine;;3406
Présidentielles 2017 - 1er tour;Présidentielles;2017;1;;;63;RUEIL MALMAISON;92063;54426;9298;45128;713;44414;MACRON Emmanuel;M;MACRON;Emmanuel;;15180
Présidentielles 2017 - 1er tour;Présidentielles;2017;1;;;76;VAUCRESSON;92076;6176;835;5341;72;5269;CHEMINADE Jacques;M;CHEMINADE;Jacques;;9
Présidentielles 2017 - 1er tour;Présidentielles;2017;1;;;78;VILLENEUVE LA GARENNE;92078;12429;3872;8557;315;8242;ARTHAUD Nathalie;F;ARTHAUD;Nathalie;;50
Présidentielles 2012 - 1er tour;Présidentielles;2012;1;;;9;BOIS COLOMBES;92009;16746;3612;13134;231;12903;ARTHAUD Nathalie;F;ARTHAUD;Nathalie;;34
Présidentielles 2012 - 1er tour;Présidentielles;2012;1;;;19;CHATENAY MALABRY;92019;17914;3466;14448;325;14123;POUTOU Philippe;M;POUTOU;Philippe;;101
Présidentielles 2012 - 1er tour;Présidentielles;2012;1;;;20;CHATILLON;92020;21656;4298;17358;265;17093;BAYROU François;M;BAYROU;François;;1997
Présidentielles 2012 - 1er tour;Présidentielles;2012;1;;;25;COLOMBES;92025;44741;10181;34560;526;34034;BAYROU François;M;BAYROU;François;;3224
Présidentielles 2012 - 1er tour;Présidentielles;2012;1;;;50;NANTERRE;92050;44307;10435;33872;654;33218;DUPONT-AIGNAN Nicolas;M;DUPONT-AIGNAN;Nicolas;;427
Présidentielles 2012 - 1er tour;Présidentielles;2012;1;;;63;RUEIL MALMAISON;92063;52385;10540;41845;580;41265;POUTOU Philippe;M;POUTOU;Philippe;;280
Présidentielles 2012 - 1er tour;Présidentielles;2012;1;;;72;SEVRES;92072;14837;2876;11961;219;11742;MÉLENCHON Jean-Luc;M;MÉLENCHON;Jean-Luc;;1033
Présidentielles 2012 - 2ème tour;Présidentielles;2012;2;;;9;BOIS COLOMBES;92009;16756;3008;13748;607;13141;HOLLANDE François;M;HOLLANDE;François;;6265
Présidentielles 2012 - 2ème tour;Présidentielles;2012;2;;;73;SURESNES;92073;26469;4257;22212;935;21277;HOLLANDE François;M;HOLLANDE;François;;10048
Présidentielles 2012 - 2ème tour;Présidentielles;2012;2;;;77;VILLE D'AVRAY;92077;7161;809;6352;228;6124;SARKOZY Nicolas;M;SARKOZY;Nicolas;;4008
Présidentielles 2017 - 2ème tour;Présidentielles;2017;2;;;48;MEUDON;92048;31253;7214;24039;2126;21913;MACRON Emmanuel;M;MACRON;Emmanuel;;18529
Présidentielles 2017 - 2ème tour;Présidentielles;2017;2;;;78;VILLENEUVE LA GARENNE;92078;12429;4419;8010;786;7224;LE PEN Marine;F;LE PEN;Marine;;1426
Législatives 2007 - 1er tour;Législatives;2007;1;13;13ème circonscription;2;ANTONY;92002;39807;13942;25865;456;25409;BASTIDE Anne;F;BASTIDE;Anne;ECO;45
Législatives 2007 - 1er tour;Législatives;2007;1;10;10ème circonscription;40;ISSY LES MOULINEAUX;92040;38520;14017;24503;359;24144;SANTINI André;M;SANTINI;André;MAJ;12379
Législatives 2007 - 1er tour;Législatives;2007;1;5;5ème circonscription;44;LEVALLOIS PERRET;92044;39466;14724;24742;404;24338;FURON Férial;F;FURON;Férial;DVD;220
Législatives 2007 - 1er tour;Législatives;2007;1;12;12ème circonscription;32;FONTENAY AUX ROSES;92032;15468;5605;9863;84;9779;CHABRAN Isabelle;F;CHABRAN;Isabelle;VEC;374
Législatives 2007 - 1er tour;Législatives;2007;1;12;12ème circonscription;32;FONTENAY AUX ROSES;92032;15468;5605;9863;84;9779;DELVITTO Denis;M;DELVITTO;Denis;DIV;0
Législatives 2007 - 1er tour;Législatives;2007;1;5;5ème circonscription;24;CLICHY;92024;28799;12380;16419;297;16122;CATOIRE Gilles;M;CATOIRE;Gilles;SOC;5671
Législatives 2007 - 1er tour;Législatives;2007;1;11;11ème circonscription;46;MALAKOFF;92046;18478;7045;11433;204;11229;GALATEAU Marie-Thérèse;F;GALATEAU;Marie-Thérèse;EXD;82
Législatives 2007 - 1er tour;Législatives;2007;1;8;8ème circonscription;47;MARNES LA COQUETTE;92047;1074;316;758;5;753;BEZAULT Christine;F;BEZAULT;Christine;DIV;3
Législatives 2007 - 1er tour;Législatives;2007;1;8;8ème circonscription;22;CHAVILLE;92022;12928;4682;8246;120;8126;LUCET Francis;M;LUCET;Francis;EXG;47
Législatives 2007 - 1er tour;Législatives;2007;1;10;10ème circonscription;48;MEUDON;92048;5066;1864;3202;29;3173;ARIPA Alain;M;ARIPA;Alain;MPF;55
Législatives 2007 - 1er tour;Législatives;2007;1;8;8ème circonscription;72;SEVRES;92072;14460;5279;9181;151;9030;RUSSO Annick;F;RUSSO;Annick;DIV;9
Législatives 2007 - 1er tour;Législatives;2007;1;9;9ème circonscription;12;BOULOGNE BILLANCOURT;92012;60773;22422;38351;535;37816;DUBOUCHER Peggy;F;DUBOUCHER;Peggy;VEC;947
Législatives 2007 - 1er tour;Législatives;2007;1;3;3ème circonscription;9;BOIS COLOMBES;92009;16245;6561;9684;288;9396;PELISSIER Hélène;F;PELISSIER;Hélène;DIV;49
Législatives 2007 - 1er tour;Législatives;2007;1;13;13ème circonscription;71;SCEAUX;92071;14129;4679;9450;74;9376;BENLOLO Martine;F;BENLOLO;Martine;EXG;26
Législatives 2007 - 1er tour;Législatives;2007;1;10;10ème circonscription;12;BOULOGNE BILLANCOURT;92012;5551;2367;3184;78;3106;DROUET Valérie;F;DROUET;Valérie;EXD;12
Législatives 2007 - 1er tour;Législatives;2007;1;13;13ème circonscription;19;CHATENAY MALABRY;92019;17835;6584;11251;211;11040;SARFATI André;M;SARFATI;André;DIV;75
Législatives 2007 - 1er tour;Législatives;2007;1;4;4ème circonscription;73;SURESNES;92073;24666;8949;15717;206;15511;MARDOCH Brigitte;F;MARDOCH;Brigitte;ECO;97
Législatives 2007 - 1er tour;Législatives;2007;1;4;4ème circonscription;73;SURESNES;92073;24666;8949;15717;206;15511;LE ROUX Cécile;M;LE ROUX;Cécile;DIV;7
Législatives 2007 - 1er tour;Législatives;2007;1;4;4ème circonscription;73;SURESNES;92073;24666;8949;15717;206;15511;CREUZET Pierre;M;CREUZET;Pierre;UDFD;1755
Législatives 2007 - 1er tour;Législatives;2007;1;1;1ère circonscription;78;VILLENEUVE LA GARENNE;92078;13038;7211;5827;131;5696;SARRE Philippe;M;SARRE;Philippe;SOC;1390
Législatives 2007 - 1er tour;Législatives;2007;1;8;8ème circonscription;77;VILLE D'AVRAY;92077;7475;2429;5046;60;4986;LEHIDEUX Bernard;M;LEHIDEUX;Bernard;UDFD;861
Législatives 2007 - 1er tour;Législatives;2007;1;1;1ère circonscription;78;VILLENEUVE LA GARENNE;92078;13038;7211;5827;131;5696;RABIER Marie-Cécile;F;RABIER;Marie-Cécile;FN;264
Législatives 2007 - 2ème tour;Législatives;2007;2;1;1ère circonscription;36;GENNEVILLIERS;92036;20048;9832;10216;209;10007;MUZEAU Roland;M;MUZEAU;Roland;COM;7467
Présidentielles 2002 - 1er tour;Présidentielles;2002;1;;;7;BAGNEUX;92007;18489;5873;12616;519;12097;HUE ROBERT;M;HUE;ROBERT;;1195
Présidentielles 2002 - 1er tour;Présidentielles;2002;1;;;19;CHATENAY MALABRY;92019;15965;4483;11482;241;11241;LEPAGE CORINNE;F;LEPAGE;CORINNE;;285
Présidentielles 2002 - 1er tour;Présidentielles;2002;1;;;19;CHATENAY MALABRY;92019;15965;4483;11482;241;11241;BOUTIN CHRISTINE;F;BOUTIN;CHRISTINE;;125
Présidentielles 2002 - 1er tour;Présidentielles;2002;1;;;23;CLAMART;92023;31130;10977;20153;427;19726;TAUBIRA CHRISTIANE;F;TAUBIRA;CHRISTIANE;;581
Présidentielles 2002 - 1er tour;Présidentielles;2002;1;;;23;CLAMART;92023;31130;10977;20153;427;19726;LAGUILLER ARLETTE;F;LAGUILLER;ARLETTE;;857
Présidentielles 2002 - 1er tour;Présidentielles;2002;1;;;26;COURBEVOIE;92026;39941;11959;27982;520;27462;LEPAGE CORINNE;F;LEPAGE;CORINNE;;710
Présidentielles 2002 - 1er tour;Présidentielles;2002;1;;;26;COURBEVOIE;92026;39941;11959;27982;520;27462;BOUTIN CHRISTINE;F;BOUTIN;CHRISTINE;;376
Présidentielles 2002 - 1er tour;Présidentielles;2002;1;;;32;FONTENAY AUX ROSES;92032;14148;4309;9839;204;9635;SAINT-JOSSE JEAN;M;SAINT-JOSSE;JEAN;;60
Présidentielles 2002 - 1er tour;Présidentielles;2002;1;;;33;GARCHES;92033;11708;3920;7788;137;7651;GLUCKSTEIN DANIEL;M;GLUCKSTEIN;DANIEL;;19
Présidentielles 2002 - 1er tour;Présidentielles;2002;1;;;35;LA GARENNE COLOMBES;92035;15006;5167;9839;227;9612;LEPAGE CORINNE;F;LEPAGE;CORINNE;;312
Présidentielles 2002 - 1er tour;Présidentielles;2002;1;;;35;LA GARENNE COLOMBES;92035;15006;5167;9839;227;9612;BAYROU FRANCOIS;M;BAYROU;FRANCOIS;;865
Présidentielles 2002 - 1er tour;Présidentielles;2002;1;;;40;ISSY LES MOULINEAUX;92040;32059;9424;22635;510;22125;TAUBIRA CHRISTIANE;F;TAUBIRA;CHRISTIANE;;749
Présidentielles 2002 - 1er tour;Présidentielles;2002;1;;;46;MALAKOFF;92046;17268;6020;11248;271;10977;MADELIN ALAIN;M;MADELIN;ALAIN;;304
Présidentielles 2002 - 1er tour;Présidentielles;2002;1;;;49;MONTROUGE;92049;23382;8142;15240;301;14939;LAGUILLER ARLETTE;F;LAGUILLER;ARLETTE;;650
Présidentielles 2002 - 1er tour;Présidentielles;2002;1;;;50;NANTERRE;92050;37590;13303;24287;669;23618;LAGUILLER ARLETTE;F;LAGUILLER;ARLETTE;;1275
Présidentielles 2002 - 1er tour;Présidentielles;2002;1;;;51;NEUILLY SUR SEINE;92051;34066;10108;23958;309;23649;CHIRAC JACQUES;M;CHIRAC;JACQUES;;10616
Présidentielles 2002 - 1er tour;Présidentielles;2002;1;;;62;PUTEAUX;92062;23861;6804;17057;487;16570;LEPAGE CORINNE;F;LEPAGE;CORINNE;;477
Présidentielles 2002 - 1er tour;Présidentielles;2002;1;;;75;VANVES;92075;15493;4648;10845;221;10624;MAMERE NOEL;M;MAMERE;NOEL;;685
Présidentielles 2002 - 1er tour;Présidentielles;2002;1;;;77;VILLE D'AVRAY;92077;7251;2486;4765;70;4695;LEPAGE CORINNE;F;LEPAGE;CORINNE;;171
Présidentielles 2007 - 1er tour;Présidentielles;2007;1;;;9;BOIS COLOMBES;92009;16113;2534;13579;152;13427;NIHOUS Frédéric;M;NIHOUS;Frédéric;;28
Présidentielles 2007 - 1er tour;Présidentielles;2007;1;;;12;BOULOGNE BILLANCOURT;92012;64709;7685;57024;546;56478;de VILLIERS Philippe;M;de VILLIERS;Philippe;;689
Présidentielles 2007 - 1er tour;Présidentielles;2007;1;;;22;CHAVILLE;92022;12743;1700;11043;119;10924;LE PEN Jean-Marie;M;LE PEN;Jean-Marie;;609
Présidentielles 2007 - 1er tour;Présidentielles;2007;1;;;36;GENNEVILLIERS;92036;19890;3536;16354;259;16095;VOYNET Dominique;F;VOYNET;Dominique;;177
Présidentielles 2007 - 1er tour;Présidentielles;2007;1;;;40;ISSY LES MOULINEAUX;92040;37966;4920;33046;365;32681;de VILLIERS Philippe;M;de VILLIERS;Philippe;;398
Présidentielles 2007 - 1er tour;Présidentielles;2007;1;;;40;ISSY LES MOULINEAUX;92040;37966;4920;33046;365;32681;NIHOUS Frédéric;M;NIHOUS;Frédéric;;81
Présidentielles 2007 - 1er tour;Présidentielles;2007;1;;;44;LEVALLOIS PERRET;92044;38708;4734;33974;296;33678;LE PEN Jean-Marie;M;LE PEN;Jean-Marie;;1785
Présidentielles 2007 - 1er tour;Présidentielles;2007;1;;;48;MEUDON;92048;29936;4129;25807;223;25584;SCHIVARDI Gérard;M;SCHIVARDI;Gérard;;38
Présidentielles 2007 - 1er tour;Présidentielles;2007;1;;;49;MONTROUGE;92049;26299;3093;23206;219;22987;BESANCENOT Olivier;M;BESANCENOT;Olivier;;648
Présidentielles 2007 - 1er tour;Présidentielles;2007;1;;;49;MONTROUGE;92049;26299;3093;23206;219;22987;BUFFET Marie-George;F;BUFFET;Marie-George;;396
Présidentielles 2007 - 1er tour;Présidentielles;2007;1;;;60;LE PLESSIS ROBINSON;92060;16571;1989;14582;159;14423;SCHIVARDI Gérard;M;SCHIVARDI;Gérard;;35
Présidentielles 2007 - 1er tour;Présidentielles;2007;1;;;64;SAINT CLOUD;92064;18455;1926;16529;91;16438;de VILLIERS Philippe;M;de VILLIERS;Philippe;;263
Présidentielles 2007 - 1er tour;Présidentielles;2007;1;;;75;VANVES;92075;17139;2129;15010;126;14884;LE PEN Jean-Marie;M;LE PEN;Jean-Marie;;692
Présidentielles 1995 - 1er tour;Présidentielles;1995;1;;;49;MONTROUGE;92049;22293;5924;16369;314;16055;CHEMINADE JACQUES;M;CHEMINADE;JACQUES;;43
Présidentielles 1995 - 1er tour;Présidentielles;1995;1;;;49;MONTROUGE;92049;22293;5924;16369;314;16055;VOYNET DOMINIQUE;F;VOYNET;DOMINIQUE;;633
Présidentielles 1995 - 1er tour;Présidentielles;1995;1;;;60;LE PLESSIS ROBINSON;92060;13056;3285;9771;199;9572;JOSPIN LIONEL;M;JOSPIN;LIONEL;;2325
Présidentielles 1995 - 1er tour;Présidentielles;1995;1;;;71;SCEAUX;92071;13371;3073;10298;170;10128;LAGUILLER ARLETTE;F;LAGUILLER;ARLETTE;;370
Présidentielles 1995 - 1er tour;Présidentielles;1995;1;;;75;VANVES;92075;15499;3343;12156;236;11920;VILLIERS DE PHILIPPE;M;VILLIERS DE;PHILIPPE;;359
Présidentielles 1995 - 1er tour;Présidentielles;1995;1;;;7;BAGNEUX;92007;20166;5090;15076;308;14768;HUE ROBERT;M;HUE;ROBERT;;2899
Présidentielles 1995 - 1er tour;Présidentielles;1995;1;;;47;MARNES LA COQUETTE;92047;1003;227;776;11;765;BALLADUR EDOUARD;M;BALLADUR;EDOUARD;;230
Présidentielles 1995 - 1er tour;Présidentielles;1995;1;;;47;MARNES LA COQUETTE;92047;1003;227;776;11;765;VOYNET DOMINIQUE;F;VOYNET;DOMINIQUE;;14
Présidentielles 2007 - 2ème tour;Présidentielles;2007;2;;;7;BAGNEUX;92007;20463;3047;17416;560;16856;SARKOZY Nicolas;M;SARKOZY;Nicolas;;6059
Présidentielles 2007 - 2ème tour;Présidentielles;2007;2;;;20;CHATILLON;92020;20472;2480;17992;669;17323;ROYAL Ségolène;F;ROYAL;Ségolène;;8561
Présidentielles 2007 - 2ème tour;Présidentielles;2007;2;;;49;MONTROUGE;92049;26307;3565;22742;830;21912;SARKOZY Nicolas;M;SARKOZY;Nicolas;;10418
Présidentielles 2007 - 2ème tour;Présidentielles;2007;2;;;73;SURESNES;92073;24258;3080;21178;918;20260;ROYAL Ségolène;F;ROYAL;Ségolène;;8483
Présidentielles 2007 - 2ème tour;Présidentielles;2007;2;;;78;VILLENEUVE LA GARENNE;92078;12908;2961;9947;309;9638;ROYAL Ségolène;F;ROYAL;Ségolène;;5489
Présidentielles 1995 - 1er tour;Présidentielles;1995;1;;;14;BOURG LA REINE;92014;12770;3430;9340;135;9205;BALLADUR EDOUARD;M;BALLADUR;EDOUARD;;2140
Présidentielles 1995 - 1er tour;Présidentielles;1995;1;;;22;CHAVILLE;92022;12177;2870;9307;170;9137;HUE ROBERT;M;HUE;ROBERT;;568
Présidentielles 1995 - 1er tour;Présidentielles;1995;1;;;33;GARCHES;92033;11689;2941;8748;172;8576;VOYNET DOMINIQUE;F;VOYNET;DOMINIQUE;;264
Présidentielles 2002 - 2ème tour;Présidentielles;2002;2;;;4;ASNIERES SUR SEINE;92004;35708;6723;28985;905;28080;CHIRAC JACQUES;M;CHIRAC;JACQUES;;24286
Présidentielles 2002 - 2ème tour;Présidentielles;2002;2;;;23;CLAMART;92023;31134;6910;24224;815;23409;LE PEN JEAN-MARIE;M;LE PEN;JEAN-MARIE;;2791
Présidentielles 1995 - 1er tour;Présidentielles;1995;1;;;26;COURBEVOIE;92026;35812;8064;27748;468;27280;LE PEN J.MARIE;M;LE PEN;J.MARIE;;3107
Présidentielles 1995 - 1er tour;Présidentielles;1995;1;;;24;CLICHY;92024;24688;6820;17868;364;17504;VOYNET DOMINIQUE;F;VOYNET;DOMINIQUE;;604
Présidentielles 1995 - 1er tour;Présidentielles;1995;1;;;23;CLAMART;92023;31229;8419;22810;457;22353;LE PEN J.MARIE;M;LE PEN;J.MARIE;;2769
Présidentielles 1995 - 1er tour;Présidentielles;1995;1;;;23;CLAMART;92023;31229;8419;22810;457;22353;HUE ROBERT;M;HUE;ROBERT;;1815
Législatives 1993 - 1er tour;Législatives;1993;1;10;10ème circonscription;12;BOULOGNE BILLANCOURT;92012;4523;1581;2942;133;2809;PEYNAUD JEAN;M;PEYNAUD;JEAN;MAJ;12
Législatives 1993 - 1er tour;Législatives;1993;1;3;3ème circonscription;9;BOIS COLOMBES;92009;14392;4251;10141;422;9719;ROUSSEL PIERRE;M;ROUSSEL;PIERRE;SOC;1519
Législatives 1993 - 2ème tour;Législatives;1993;2;3;3ème circonscription;35;LA GARENNE COLOMBES;92035;13664;4706;8958;549;8409;ROUSSEL PIERRE;M;ROUSSEL;PIERRE;SOC;3270
Législatives 1993 - 2ème tour;Législatives;1993;2;13;13ème circonscription;14;BOURG LA REINE;92014;12748;4405;8343;506;7837;MERLE J.FRANCOIS;M;MERLE;J.FRANCOIS;SOC;2861
Législatives 1993 - 2ème tour;Législatives;1993;2;8;8ème circonscription;48;MEUDON;92048;25126;12469;12657;4677;7980;GUILLET J.JACQUES;M;GUILLET;J.JACQUES;RPR;7980
Législatives 1997 - 1er tour;Législatives;1997;1;2;2ème circonscription;4;ASNIERES SUR SEINE;92004;37154;13729;23425;737;22688;CHAZOULE OLIVIER;M;CHAZOULE;OLIVIER;DVD;688
Législatives 1997 - 1er tour;Législatives;1997;1;3;3ème circonscription;9;BOIS COLOMBES;92009;14757;5447;9310;293;9017;SCHWARTZ A.MARIE;F;SCHWARTZ;A.MARIE;EXG;263
Législatives 1997 - 1er tour;Législatives;1997;1;3;3ème circonscription;9;BOIS COLOMBES;92009;14757;5447;9310;293;9017;LAIDI AMIROUCHE;M;LAIDI;AMIROUCHE;ECO;194
Législatives 1997 - 1er tour;Législatives;1997;1;13;13ème circonscription;2;ANTONY;92002;37772;12082;25690;861;24829;ROMAN INGRID;F;ROMAN;INGRID;DIV;36
Législatives 1997 - 1er tour;Législatives;1997;1;3;3ème circonscription;9;BOIS COLOMBES;92009;14757;5447;9310;293;9017;LE RET CHRISTOPHE;M;LE RET;CHRISTOPHE;DVD;129
Législatives 1997 - 1er tour;Législatives;1997;1;12;12ème circonscription;20;CHATILLON;92020;16406;5234;11172;367;10805;BREITBURD NICOLAS;M;BREITBURD;NICOLAS;DVD;119
Législatives 1997 - 1er tour;Législatives;1997;1;5;5ème circonscription;24;CLICHY;92024;23725;8942;14783;486;14297;BENOIT LUC;M;BENOIT;LUC;EXG;104
Législatives 1997 - 1er tour;Législatives;1997;1;13;13ème circonscription;14;BOURG LA REINE;92014;12587;4431;8156;266;7890;RIVIERE ALAIN;M;RIVIERE;ALAIN;DVD;278
Législatives 1997 - 1er tour;Législatives;1997;1;13;13ème circonscription;14;BOURG LA REINE;92014;12587;4431;8156;266;7890;SEXER YVES;M;SEXER;YVES;DVD;144
Législatives 1997 - 1er tour;Législatives;1997;1;12;12ème circonscription;32;FONTENAY AUX ROSES;92032;14748;4655;10093;259;9834;PEYRONNEAU GASTON;M;PEYRONNEAU;GASTON;COM;527
Législatives 1997 - 1er tour;Législatives;1997;1;3;3ème circonscription;26;COURBEVOIE;92026;35738;12354;23384;653;22731;KOSSOWSKI JACQUES;M;KOSSOWSKI;JACQUES;DVD;5814
Législatives 1997 - 1er tour;Législatives;1997;1;3;3ème circonscription;26;COURBEVOIE;92026;35738;12354;23384;653;22731;HABANS ROGER;M;HABANS;ROGER;EXD;56
Législatives 1997 - 1er tour;Législatives;1997;1;12;12ème circonscription;32;FONTENAY AUX ROSES;92032;14748;4655;10093;259;9834;GERMA PHILIPPE;M;GERMA;PHILIPPE;DVD;244
Législatives 1997 - 1er tour;Législatives;1997;1;8;8ème circonscription;48;MEUDON;92048;24248;8136;16112;629;15483;BRISSAUD SOPHIE;F;BRISSAUD;SOPHIE;FRN;1987
Législatives 1993 - 1er tour;Législatives;1993;1;13;13ème circonscription;71;SCEAUX;92071;13127;3574;9553;306;9247;MERLE J.FRANCOIS;M;MERLE;J.FRANCOIS;SOC;1778
Législatives 1993 - 1er tour;Législatives;1993;1;4;4ème circonscription;73;SURESNES;92073;21292;6457;14835;522;14313;SAPIN MICHEL;M;SAPIN;MICHEL;SOC;2855
Législatives 1993 - 1er tour;Législatives;1993;1;8;8ème circonscription;72;SEVRES;92072;13536;3690;9846;336;9510;SUCHIER ANDRE;M;SUCHIER;ANDRE;DIV;74
Législatives 1993 - 1er tour;Législatives;1993;1;1;1ère circonscription;78;VILLENEUVE LA GARENNE;92078;11604;4168;7436;212;7224;FAUCONNIER DENIS;M;FAUCONNIER;DENIS;DIV;184
Législatives 1993 - 1er tour;Législatives;1993;1;1;1ère circonscription;78;VILLENEUVE LA GARENNE;92078;11604;4168;7436;212;7224;BRETON MICHEL;M;BRETON;MICHEL;EXG;70
Législatives 1993 - 1er tour;Législatives;1993;1;4;4ème circonscription;73;SURESNES;92073;21292;6457;14835;522;14313;DEBAILLE NATHALIE;F;DEBAILLE;NATHALIE;FRN;1501
Législatives 1993 - 1er tour;Législatives;1993;1;12;12ème circonscription;32;FONTENAY AUX ROSES;92032;15091;4963;10128;341;9787;BURGAUD CHRISTINE;F;BURGAUD;CHRISTINE;DIV;77
Législatives 1993 - 1er tour;Législatives;1993;1;12;12ème circonscription;32;FONTENAY AUX ROSES;92032;15091;4963;10128;341;9787;FOUCHER J.PIERRE;M;FOUCHER;J.PIERRE;UDF;3993
Législatives 1993 - 1er tour;Législatives;1993;1;1;1ère circonscription;36;GENNEVILLIERS;92036;19185;6818;12367;395;11972;RANAIVOSON BRIGITTE;F;RANAIVOSON;BRIGITTE;DIV;176
Législatives 1993 - 1er tour;Législatives;1993;1;12;12ème circonscription;32;FONTENAY AUX ROSES;92032;15091;4963;10128;341;9787;DUNG JURGEN;M;DUNG;JURGEN;MAJ;100
Législatives 1993 - 1er tour;Législatives;1993;1;11;11ème circonscription;46;MALAKOFF;92046;19559;6951;12608;416;12192;AFONSO HENRI;M;AFONSO;HENRI;DIV;84
Législatives 1993 - 1er tour;Législatives;1993;1;8;8ème circonscription;48;MEUDON;92048;25126;7628;17498;529;16969;ROY CAROLINE;F;ROY;CAROLINE;RDG;2659
Législatives 1993 - 1er tour;Législatives;1993;1;8;8ème circonscription;22;CHAVILLE;92022;12345;3904;8441;296;8145;MARGUERITES HARRY;M;MARGUERITES;HARRY;MAJ;85
Législatives 1993 - 1er tour;Législatives;1993;1;8;8ème circonscription;48;MEUDON;92048;25126;7628;17498;529;16969;GREGOIRE MAURICE;M;GREGOIRE;MAURICE;DIV;224
Législatives 1993 - 1er tour;Législatives;1993;1;8;8ème circonscription;48;MEUDON;92048;25126;7628;17498;529;16969;NICOLAS PATRICK;M;NICOLAS;PATRICK;DVD;89
Législatives 1993 - 1er tour;Législatives;1993;1;4;4ème circonscription;50;NANTERRE;92050;38007;11484;26523;795;25728;SAPIN MICHEL;M;SAPIN;MICHEL;SOC;3825
Législatives 1993 - 1er tour;Législatives;1993;1;10;10ème circonscription;48;MEUDON;92048;4225;1396;2829;92;2737;RIEUPET ANNIE;F;RIEUPET;ANNIE;EXG;48
Législatives 1993 - 1er tour;Législatives;1993;1;12;12ème circonscription;23;CLAMART;92023;30899;9896;21003;704;20299;BUCHET PASCAL;M;BUCHET;PASCAL;SOC;3429
Législatives 1993 - 2ème tour;Législatives;1993;2;11;11ème circonscription;7;BAGNEUX;92007;21150;7376;13774;852;12922;ROBERT ALAIN;M;ROBERT;ALAIN;RPR;5580
Législatives 1997 - 1er tour;Législatives;1997;1;13;13ème circonscription;71;SCEAUX;92071;13168;3887;9281;266;9015;DEVEDJIAN PATRICK;M;DEVEDJIAN;PATRICK;RPR;3838
Législatives 1997 - 1er tour;Législatives;1997;1;4;4ème circonscription;73;SURESNES;92073;20985;7217;13768;441;13327;MONNOT MICHEL;M;MONNOT;MICHEL;EXG;108
Législatives 1997 - 1er tour;Législatives;1997;1;13;13ème circonscription;71;SCEAUX;92071;13168;3887;9281;266;9015;LE NET HERVE;M;LE NET;HERVE;DVD;75
Législatives 1997 - 1er tour;Législatives;1997;1;4;4ème circonscription;50;NANTERRE;92050;38533;13799;24734;766;23968;DEMERCASTEL CHRISTIAN;M;DEMERCASTEL;CHRISTIAN;ECO;972
Législatives 1997 - 1er tour;Législatives;1997;1;4;4ème circonscription;50;NANTERRE;92050;38533;13799;24734;766;23968;FERHAT TOUATI;M;FERHAT;TOUATI;ECO;310
Législatives 1997 - 1er tour;Législatives;1997;1;4;4ème circonscription;50;NANTERRE;92050;38533;13799;24734;766;23968;FRAYSSE JACQUELINE;F;FRAYSSE;JACQUELINE;COM;7885
Législatives 1997 - 1er tour;Législatives;1997;1;7;7ème circonscription;63;RUEIL MALMAISON;92063;44715;14813;29902;1094;28808;MARECHAL CHRISTIAN;M;MARECHAL;CHRISTIAN;FRN;3302
Législatives 1997 - 2ème tour;Législatives;1997;2;3;3ème circonscription;9;BOIS COLOMBES;92009;14757;4716;10041;430;9611;KOSSOWSKI JACQUES;M;KOSSOWSKI;JACQUES;DVD;4297
Législatives 1997 - 1er tour;Législatives;1997;1;8;8ème circonscription;76;VAUCRESSON;92076;5546;1861;3685;139;3546;JASSERAND BERNARD;M;JASSERAND;BERNARD;COM;103
Législatives 2002 - 1er tour;Législatives;2002;1;2;2ème circonscription;25;COLOMBES;92025;18336;7144;11192;207;10985;POURBAGHER Francis;M;POURBAGHER;Francis;DVD;59
Législatives 2002 - 1er tour;Législatives;2002;1;7;7ème circonscription;33;GARCHES;92033;12286;4601;7685;112;7573;BITTERLIN Anne;F;BITTERLIN;Anne;ECO;60
Législatives 2002 - 1er tour;Législatives;2002;1;1;1ère circonscription;36;GENNEVILLIERS;92036;20048;9522;10526;189;10337;GRIMAL Jean;M;GRIMAL;Jean;EXG;99
Législatives 2002 - 1er tour;Législatives;2002;1;10;10ème circonscription;40;ISSY LES MOULINEAUX;92040;38520;14017;24503;359;24144;BINDER Sabrina;F;BINDER;Sabrina;DIV;121
Législatives 2002 - 1er tour;Législatives;2002;1;11;11ème circonscription;46;MALAKOFF;92046;18478;7045;11433;204;11229;AMIABLE Marie-Hélène;F;AMIABLE;Marie-Hélène;COM;4461
Législatives 2002 - 1er tour;Législatives;2002;1;11;11ème circonscription;46;MALAKOFF;92046;18478;7045;11433;204;11229;GALATEAU Marie-Thérèse;F;GALATEAU;Marie-Thérèse;EXD;82
Législatives 2002 - 1er tour;Législatives;2002;1;11;11ème circonscription;49;MONTROUGE;92049;26595;9698;16897;213;16684;KADRI Malika;F;KADRI;Malika;DIV;72
Législatives 2002 - 1er tour;Législatives;2002;1;4;4ème circonscription;50;NANTERRE;92050;42631;18721;23910;314;23596;PELLET Tony;M;PELLET;Tony;EXG;360
Législatives 2017 - 1er tour;Législatives;2017;1;1;1ère circonscription;25;COLOMBES;92025;27867;16420;11447;405;11042;AODELLA Abdelmajid;M;AODELLA;Abdelmajid;DIV;125
Législatives 2017 - 1er tour;Législatives;2017;1;1;1ère circonscription;25;COLOMBES;92025;27867;16420;11447;405;11042;BORDREUIL Myriam;F;BORDREUIL;Myriam;DVD;34
Législatives 2017 - 1er tour;Législatives;2017;1;1;1ère circonscription;25;COLOMBES;92025;27867;16420;11447;405;11042;KHALFI Isia;F;KHALFI;Isia;REM;3916
Législatives 2017 - 1er tour;Législatives;2017;1;5;5ème circonscription;44;LEVALLOIS PERRET;92044;41751;17632;24119;255;23864;DUTHEIL Daniel;M;DUTHEIL;Daniel;EXG;12
Législatives 2017 - 1er tour;Législatives;2017;1;4;4ème circonscription;50;NANTERRE;92050;47651;26455;21196;432;20764;GAUHY Aristide;M;GAUHY;Aristide;DIV;0
Législatives 2017 - 1er tour;Législatives;2017;1;4;4ème circonscription;73;SURESNES;92073;28524;12725;15799;423;15376;BIGDADE Habiba;F;BIGDADE;Habiba;SOC;543
Législatives 2017 - 1er tour;Législatives;2017;1;4;4ème circonscription;73;SURESNES;92073;28524;12725;15799;423;15376;GIGOT Magalie;F;GIGOT;Magalie;DIV;135
Législatives 2017 - 1er tour;Législatives;2017;1;5;5ème circonscription;44;LEVALLOIS PERRET;92044;41751;17632;24119;255;23864;DUTILLOY Marie-Catherine;F;DUTILLOY;Marie-Catherine;ECO;255
Législatives 2017 - 1er tour;Législatives;2017;1;6;6ème circonscription;26;COURBEVOIE;92026;8107;4228;3879;107;3772;CUIGNET Emmanuelle;F;CUIGNET;Emmanuelle;FN;226
Législatives 2017 - 1er tour;Législatives;2017;1;3;3ème circonscription;35;LA GARENNE COLOMBES;92035;18829;8238;10591;114;10477;KENLER Virginie;F;KENLER;Virginie;FI;713
Législatives 2017 - 1er tour;Législatives;2017;1;3;3ème circonscription;35;LA GARENNE COLOMBES;92035;18829;8238;10591;114;10477;DAHAN Isabelle;F;DAHAN;Isabelle;SOC;423
Législatives 2017 - 1er tour;Législatives;2017;1;3;3ème circonscription;26;COURBEVOIE;92026;44322;19890;24432;415;24017;KENLER Virginie;F;KENLER;Virginie;FI;1630
Législatives 2017 - 1er tour;Législatives;2017;1;3;3ème circonscription;26;COURBEVOIE;92026;44322;19890;24432;415;24017;DENOO Emilia;F;DENOO;Emilia;DIV;310
Législatives 2017 - 1er tour;Législatives;2017;1;11;11ème circonscription;7;BAGNEUX;92007;21911;12424;9487;167;9320;TEIXEIRA Dominique;M;TEIXEIRA;Dominique;EXG;58
Législatives 2017 - 1er tour;Législatives;2017;1;10;10ème circonscription;75;VANVES;92075;18507;7626;10881;125;10756;DAHAN Gérald;M;DAHAN;Gérald;FI;1082
Législatives 2017 - 1er tour;Législatives;2017;1;11;11ème circonscription;46;MALAKOFF;92046;18448;8148;10300;133;10167;OUJIBOU Saïd;M;OUJIBOU;Saïd;DVD;53
Législatives 2017 - 1er tour;Législatives;2017;1;11;11ème circonscription;49;MONTROUGE;92049;28914;12071;16843;175;16668;CARRASCO Julia;F;CARRASCO;Julia;FN;742
Législatives 2017 - 1er tour;Législatives;2017;1;12;12ème circonscription;20;CHATILLON;92020;22311;9527;12784;186;12598;ASCOUET Florence;F;ASCOUET;Florence;DIV;108
Législatives 2017 - 1er tour;Législatives;2017;1;13;13ème circonscription;19;CHATENAY MALABRY;92019;18752;8166;10586;245;10341;LAFFITE Agnès;F;LAFFITE;Agnès;FN;443
Législatives 2017 - 1er tour;Législatives;2017;1;7;7ème circonscription;64;SAINT CLOUD;92064;19410;7490;11920;102;11818;SOUCHÈRE Sophie;F;SOUCHÈRE;Sophie;DLF;119
Législatives 2017 - 1er tour;Législatives;2017;1;7;7ème circonscription;63;RUEIL MALMAISON;92063;54498;24335;30163;377;29786;BERDOATI Eric;M;BERDOATI;Eric;LR;7356
Législatives 2017 - 1er tour;Législatives;2017;1;7;7ème circonscription;64;SAINT CLOUD;92064;19410;7490;11920;102;11818;LAPORTE Lucia;F;LAPORTE;Lucia;FN;458
Législatives 2017 - 1er tour;Législatives;2017;1;1;1ère circonscription;36;GENNEVILLIERS;92036;22174;13223;8951;243;8708;FRONTIGNY Nadia;F;FRONTIGNY;Nadia;LR;299
Législatives 2017 - 1er tour;Législatives;2017;1;8;8ème circonscription;77;VILLE D'AVRAY;92077;7440;2857;4583;44;4539;DE SAINT ALBIN Stéphane;M;DE SAINT ALBIN;Stéphane;DVD;101
Législatives 2017 - 1er tour;Législatives;2017;1;9;9ème circonscription;12;BOULOGNE BILLANCOURT;92012;64984;30321;34663;987;33676;FOUQUERAY Olivier;M;FOUQUERAY;Olivier;DIV;231
Législatives 2017 - 1er tour;Législatives;2017;1;8;8ème circonscription;77;VILLE D'AVRAY;92077;7440;2857;4583;44;4539;BOYER Gilles;M;BOYER;Gilles;LR;1121
Législatives 2017 - 1er tour;Législatives;2017;1;8;8ème circonscription;72;SEVRES;92072;15144;6343;8801;149;8652;ROURE Françoise;F;ROURE;Françoise;RDG;302
Législatives 2017 - 1er tour;Législatives;2017;1;8;8ème circonscription;76;VAUCRESSON;92076;6187;2474;3713;42;3671;DUBOIS Renaud;M;DUBOIS;Renaud;ECO;98
Législatives 2017 - 1er tour;Législatives;2017;1;7;7ème circonscription;33;GARCHES;92033;12777;5514;7263;115;7148;POIZAT Vincent;M;POIZAT;Vincent;ECO;300
Législatives 2017 - 1er tour;Législatives;2017;1;10;10ème circonscription;12;BOULOGNE BILLANCOURT;92012;9082;4562;4520;114;4406;SOUBELET Bertrand;M;SOUBELET;Bertrand;DIV;157
Législatives 2017 - 1er tour;Législatives;2017;1;10;10ème circonscription;40;ISSY LES MOULINEAUX;92040;45375;19009;26366;517;25849;SOUBELET Bertrand;M;SOUBELET;Bertrand;DIV;2024
Législatives 2017 - 1er tour;Législatives;2017;1;10;10ème circonscription;40;ISSY LES MOULINEAUX;92040;45375;19009;26366;517;25849;PUIJALON Thomas;M;PUIJALON;Thomas;SOC;1408
Législatives 2017 - 1er tour;Législatives;2017;1;10;10ème circonscription;48;MEUDON;92048;6009;2545;3464;38;3426;AMOROZ Boris;M;AMOROZ;Boris;COM;35
Présidentielles 2002 - 1er tour;Présidentielles;2002;1;;;2;ANTONY;92002;36989;11047;25942;517;25425;MAMERE NOEL;M;MAMERE;NOEL;;1569
Présidentielles 2002 - 1er tour;Présidentielles;2002;1;;;4;ASNIERES SUR SEINE;92004;35702;11271;24431;515;23916;MEGRET BRUNO;M;MEGRET;BRUNO;;450
Présidentielles 2002 - 1er tour;Présidentielles;2002;1;;;4;ASNIERES SUR SEINE;92004;35702;11271;24431;515;23916;CHIRAC JACQUES;M;CHIRAC;JACQUES;;5721
Présidentielles 2002 - 1er tour;Présidentielles;2002;1;;;7;BAGNEUX;92007;18489;5873;12616;519;12097;CHEVENEMENT JEAN-PIERRE;M;CHEVENEMENT;JEAN-PIERRE;;766
Présidentielles 2002 - 1er tour;Présidentielles;2002;1;;;9;BOIS COLOMBES;92009;13996;4554;9442;200;9242;TAUBIRA CHRISTIANE;F;TAUBIRA;CHRISTIANE;;270
Présidentielles 2002 - 1er tour;Présidentielles;2002;1;;;9;BOIS COLOMBES;92009;13996;4554;9442;200;9242;HUE ROBERT;M;HUE;ROBERT;;191
Présidentielles 2002 - 1er tour;Présidentielles;2002;1;;;9;BOIS COLOMBES;92009;13996;4554;9442;200;9242;BESANCENOT OLIVIER;M;BESANCENOT;OLIVIER;;268
Présidentielles 2002 - 1er tour;Présidentielles;2002;1;;;12;BOULOGNE BILLANCOURT;92012;57382;17570;39812;645;39167;TAUBIRA CHRISTIANE;F;TAUBIRA;CHRISTIANE;;853
Présidentielles 2002 - 1er tour;Présidentielles;2002;1;;;14;BOURG LA REINE;92014;12075;3519;8556;149;8407;BAYROU FRANCOIS;M;BAYROU;FRANCOIS;;874
Présidentielles 2002 - 1er tour;Présidentielles;2002;1;;;22;CHAVILLE;92022;12122;3826;8296;162;8134;CHIRAC JACQUES;M;CHIRAC;JACQUES;;1727
Présidentielles 2002 - 1er tour;Présidentielles;2002;1;;;25;COLOMBES;92025;39608;13654;25954;571;25383;LE PEN JEAN-MARIE;M;LE PEN;JEAN-MARIE;;3495
Présidentielles 2002 - 1er tour;Présidentielles;2002;1;;;26;COURBEVOIE;92026;39941;11959;27982;520;27462;MEGRET BRUNO;M;MEGRET;BRUNO;;481
Présidentielles 2002 - 1er tour;Présidentielles;2002;1;;;26;COURBEVOIE;92026;39941;11959;27982;520;27462;CHIRAC JACQUES;M;CHIRAC;JACQUES;;7330
Présidentielles 2002 - 1er tour;Présidentielles;2002;1;;;35;LA GARENNE COLOMBES;92035;15006;5167;9839;227;9612;TAUBIRA CHRISTIANE;F;TAUBIRA;CHRISTIANE;;259
Présidentielles 2002 - 1er tour;Présidentielles;2002;1;;;40;ISSY LES MOULINEAUX;92040;32059;9424;22635;510;22125;CHIRAC JACQUES;M;CHIRAC;JACQUES;;4707
Présidentielles 2002 - 1er tour;Présidentielles;2002;1;;;44;LEVALLOIS PERRET;92044;33618;9640;23978;575;23403;MEGRET BRUNO;M;MEGRET;BRUNO;;311
Présidentielles 2002 - 1er tour;Présidentielles;2002;1;;;46;MALAKOFF;92046;17268;6020;11248;271;10977;MEGRET BRUNO;M;MEGRET;BRUNO;;180
Présidentielles 2002 - 1er tour;Présidentielles;2002;1;;;46;MALAKOFF;92046;17268;6020;11248;271;10977;JOSPIN LIONEL;M;JOSPIN;LIONEL;;1883
Présidentielles 2002 - 1er tour;Présidentielles;2002;1;;;47;MARNES LA COQUETTE;92047;997;272;725;7;718;LE PEN JEAN-MARIE;M;LE PEN;JEAN-MARIE;;80
Présidentielles 2002 - 1er tour;Présidentielles;2002;1;;;47;MARNES LA COQUETTE;92047;997;272;725;7;718;BESANCENOT OLIVIER;M;BESANCENOT;OLIVIER;;9
Présidentielles 2002 - 1er tour;Présidentielles;2002;1;;;48;MEUDON;92048;28283;9341;18942;321;18621;HUE ROBERT;M;HUE;ROBERT;;486
Présidentielles 2002 - 1er tour;Présidentielles;2002;1;;;50;NANTERRE;92050;37590;13303;24287;669;23618;LEPAGE CORINNE;F;LEPAGE;CORINNE;;410
Présidentielles 2002 - 1er tour;Présidentielles;2002;1;;;60;LE PLESSIS ROBINSON;92060;14503;4736;9767;230;9537;MEGRET BRUNO;M;MEGRET;BRUNO;;157
Présidentielles 2002 - 1er tour;Présidentielles;2002;1;;;60;LE PLESSIS ROBINSON;92060;14503;4736;9767;230;9537;LAGUILLER ARLETTE;F;LAGUILLER;ARLETTE;;463
Présidentielles 2002 - 1er tour;Présidentielles;2002;1;;;62;PUTEAUX;92062;23861;6804;17057;487;16570;MADELIN ALAIN;M;MADELIN;ALAIN;;1095
Présidentielles 2002 - 1er tour;Présidentielles;2002;1;;;63;RUEIL MALMAISON;92063;48302;17158;31144;693;30451;LEPAGE CORINNE;F;LEPAGE;CORINNE;;937
Présidentielles 2002 - 1er tour;Présidentielles;2002;1;;;64;SAINT CLOUD;92064;17818;6028;11790;141;11649;JOSPIN LIONEL;M;JOSPIN;LIONEL;;1356
Présidentielles 2002 - 1er tour;Présidentielles;2002;1;;;71;SCEAUX;92071;12917;3930;8987;154;8833;MADELIN ALAIN;M;MADELIN;ALAIN;;589
Présidentielles 2002 - 1er tour;Présidentielles;2002;1;;;73;SURESNES;92073;22099;7156;14943;329;14614;BESANCENOT OLIVIER;M;BESANCENOT;OLIVIER;;464
Présidentielles 2007 - 1er tour;Présidentielles;2007;1;;;2;ANTONY;92002;39316;4695;34621;413;34208;BAYROU François;M;BAYROU;François;;7861
Présidentielles 2007 - 1er tour;Présidentielles;2007;1;;;7;BAGNEUX;92007;20438;2809;17629;261;17368;BAYROU François;M;BAYROU;François;;3072
Présidentielles 2007 - 1er tour;Présidentielles;2007;1;;;9;BOIS COLOMBES;92009;16113;2534;13579;152;13427;BUFFET Marie-George;F;BUFFET;Marie-George;;153
Présidentielles 2007 - 1er tour;Présidentielles;2007;1;;;25;COLOMBES;92025;44025;7536;36489;501;35988;BUFFET Marie-George;F;BUFFET;Marie-George;;889
Présidentielles 2007 - 1er tour;Présidentielles;2007;1;;;25;COLOMBES;92025;44025;7536;36489;501;35988;de VILLIERS Philippe;M;de VILLIERS;Philippe;;421
Présidentielles 2007 - 1er tour;Présidentielles;2007;1;;;32;FONTENAY AUX ROSES;92032;15234;2027;13207;123;13084;VOYNET Dominique;F;VOYNET;Dominique;;230
Présidentielles 2007 - 1er tour;Présidentielles;2007;1;;;44;LEVALLOIS PERRET;92044;38708;4734;33974;296;33678;BESANCENOT Olivier;M;BESANCENOT;Olivier;;620
Présidentielles 2007 - 1er tour;Présidentielles;2007;1;;;44;LEVALLOIS PERRET;92044;38708;4734;33974;296;33678;SARKOZY Nicolas;M;SARKOZY;Nicolas;;16458
Présidentielles 2007 - 1er tour;Présidentielles;2007;1;;;50;NANTERRE;92050;42083;6117;35966;477;35489;SCHIVARDI Gérard;M;SCHIVARDI;Gérard;;100
Présidentielles 2007 - 1er tour;Présidentielles;2007;1;;;51;NEUILLY SUR SEINE;92051;37647;4032;33615;154;33461;de VILLIERS Philippe;M;de VILLIERS;Philippe;;366
Présidentielles 2007 - 1er tour;Présidentielles;2007;1;;;62;PUTEAUX;92062;26761;3397;23364;263;23101;VOYNET Dominique;F;VOYNET;Dominique;;332
Présidentielles 2007 - 1er tour;Présidentielles;2007;1;;;62;PUTEAUX;92062;26761;3397;23364;263;23101;SARKOZY Nicolas;M;SARKOZY;Nicolas;;9100
Présidentielles 2007 - 1er tour;Présidentielles;2007;1;;;64;SAINT CLOUD;92064;18455;1926;16529;91;16438;SARKOZY Nicolas;M;SARKOZY;Nicolas;;8785
Présidentielles 2007 - 1er tour;Présidentielles;2007;1;;;71;SCEAUX;92071;13824;1539;12285;86;12199;de VILLIERS Philippe;M;de VILLIERS;Philippe;;161
Présidentielles 2007 - 1er tour;Présidentielles;2007;1;;;76;VAUCRESSON;92076;5902;781;5121;42;5079;ROYAL Ségolène;F;ROYAL;Ségolène;;677
Présidentielles 2007 - 1er tour;Présidentielles;2007;1;;;76;VAUCRESSON;92076;5902;781;5121;42;5079;SARKOZY Nicolas;M;SARKOZY;Nicolas;;2879
Présidentielles 2007 - 1er tour;Présidentielles;2007;1;;;77;VILLE D'AVRAY;92077;7253;672;6581;57;6524;BESANCENOT Olivier;M;BESANCENOT;Olivier;;55
Présidentielles 2007 - 1er tour;Présidentielles;2007;1;;;77;VILLE D'AVRAY;92077;7253;672;6581;57;6524;BAYROU François;M;BAYROU;François;;1659
Présidentielles 2007 - 1er tour;Présidentielles;2007;1;;;78;VILLENEUVE LA GARENNE;92078;12897;2898;9999;145;9854;BESANCENOT Olivier;M;BESANCENOT;Olivier;;450
Présidentielles 1995 - 1er tour;Présidentielles;1995;1;;;12;BOULOGNE BILLANCOURT;92012;58255;14334;43921;656;43265;LAGUILLER ARLETTE;F;LAGUILLER;ARLETTE;;1520
Présidentielles 1995 - 1er tour;Présidentielles;1995;1;;;12;BOULOGNE BILLANCOURT;92012;58255;14334;43921;656;43265;CHEMINADE JACQUES;M;CHEMINADE;JACQUES;;66
Présidentielles 1995 - 1er tour;Présidentielles;1995;1;;;14;BOURG LA REINE;92014;12770;3430;9340;135;9205;VILLIERS DE PHILIPPE;M;VILLIERS DE;PHILIPPE;;318
Présidentielles 1995 - 1er tour;Présidentielles;1995;1;;;23;CLAMART;92023;31229;8419;22810;457;22353;CHEMINADE JACQUES;M;CHEMINADE;JACQUES;;47
Présidentielles 1995 - 1er tour;Présidentielles;1995;1;;;24;CLICHY;92024;24688;6820;17868;364;17504;LAGUILLER ARLETTE;F;LAGUILLER;ARLETTE;;1055
Présidentielles 1995 - 1er tour;Présidentielles;1995;1;;;33;GARCHES;92033;11689;2941;8748;172;8576;BALLADUR EDOUARD;M;BALLADUR;EDOUARD;;2070
Présidentielles 1995 - 1er tour;Présidentielles;1995;1;;;40;ISSY LES MOULINEAUX;92040;30054;8139;21915;444;21471;CHIRAC JACQUES;M;CHIRAC;JACQUES;;5592
Présidentielles 1995 - 1er tour;Présidentielles;1995;1;;;47;MARNES LA COQUETTE;92047;1003;227;776;11;765;JOSPIN LIONEL;M;JOSPIN;LIONEL;;98
Présidentielles 1995 - 1er tour;Présidentielles;1995;1;;;50;NANTERRE;92050;46920;11548;35372;736;34636;HUE ROBERT;M;HUE;ROBERT;;6152
Présidentielles 1995 - 1er tour;Présidentielles;1995;1;;;51;NEUILLY SUR SEINE;92051;35904;7798;28106;261;27845;CHIRAC JACQUES;M;CHIRAC;JACQUES;;11477
Présidentielles 1995 - 1er tour;Présidentielles;1995;1;;;60;LE PLESSIS ROBINSON;92060;13056;3285;9771;199;9572;VILLIERS DE PHILIPPE;M;VILLIERS DE;PHILIPPE;;364
Présidentielles 1995 - 1er tour;Présidentielles;1995;1;;;63;RUEIL MALMAISON;92063;44438;10571;33867;718;33149;LAGUILLER ARLETTE;F;LAGUILLER;ARLETTE;;1604
Présidentielles 1995 - 1er tour;Présidentielles;1995;1;;;63;RUEIL MALMAISON;92063;44438;10571;33867;718;33149;VOYNET DOMINIQUE;F;VOYNET;DOMINIQUE;;1110
Présidentielles 1995 - 1er tour;Présidentielles;1995;1;;;64;SAINT CLOUD;92064;18989;5119;13870;179;13691;VOYNET DOMINIQUE;F;VOYNET;DOMINIQUE;;317
Présidentielles 1995 - 1er tour;Présidentielles;1995;1;;;72;SEVRES;92072;13745;2869;10876;183;10693;CHIRAC JACQUES;M;CHIRAC;JACQUES;;2828
Présidentielles 1995 - 1er tour;Présidentielles;1995;1;;;72;SEVRES;92072;13745;2869;10876;183;10693;HUE ROBERT;M;HUE;ROBERT;;626
Présidentielles 1995 - 1er tour;Présidentielles;1995;1;;;77;VILLE D'AVRAY;92077;7139;1490;5649;74;5575;CHEMINADE JACQUES;M;CHEMINADE;JACQUES;;11
Présidentielles 1995 - 1er tour;Présidentielles;1995;1;;;78;VILLENEUVE LA GARENNE;92078;11588;3130;8458;196;8262;VOYNET DOMINIQUE;F;VOYNET;DOMINIQUE;;205
Présidentielles 2002 - 2ème tour;Présidentielles;2002;2;;;7;BAGNEUX;92007;18493;3762;14731;600;14131;LE PEN JEAN-MARIE;M;LE PEN;JEAN-MARIE;;1845
Présidentielles 2002 - 2ème tour;Présidentielles;2002;2;;;12;BOULOGNE BILLANCOURT;92012;57397;10488;46909;1202;45707;CHIRAC JACQUES;M;CHIRAC;JACQUES;;40725
Présidentielles 2002 - 2ème tour;Présidentielles;2002;2;;;60;LE PLESSIS ROBINSON;92060;14505;2930;11575;479;11096;CHIRAC JACQUES;M;CHIRAC;JACQUES;;9569
Présidentielles 1995 - 2ème tour;Présidentielles;1995;2;;;76;VAUCRESSON;92076;5527;921;4606;147;4459;CHIRAC JACQUES;M;CHIRAC;JACQUES;;3454
Présidentielles 1995 - 1er tour;Présidentielles;1995;1;;;9;BOIS COLOMBES;92009;14922;3871;11051;199;10852;CHEMINADE JACQUES;M;CHEMINADE;JACQUES;;18
Législatives 2007 - 2ème tour;Législatives;2007;2;5;5ème circonscription;44;LEVALLOIS PERRET;92044;39466;17427;22039;1112;20927;BALKANY Patrick;M;BALKANY;Patrick;UMP;13866
Présidentielles 2017 - 1er tour;Présidentielles;2017;1;;;2;ANTONY;92002;41488;6486;35002;776;34226;FILLON François;M;FILLON;François;;9139
Présidentielles 2017 - 1er tour;Présidentielles;2017;1;;;4;ASNIERES SUR SEINE;92004;48227;8578;39649;807;38842;HAMON Benoît;M;HAMON;Benoît;;3065
Présidentielles 2017 - 1er tour;Présidentielles;2017;1;;;9;BOIS COLOMBES;92009;17896;3242;14654;318;14336;ASSELINEAU François;M;ASSELINEAU;François;;156
Présidentielles 2017 - 1er tour;Présidentielles;2017;1;;;22;CHAVILLE;92022;13493;2042;11451;183;11267;HAMON Benoît;M;HAMON;Benoît;;804
Présidentielles 2017 - 1er tour;Présidentielles;2017;1;;;32;FONTENAY AUX ROSES;92032;16036;3739;12297;218;12078;ASSELINEAU François;M;ASSELINEAU;François;;130
Présidentielles 2017 - 1er tour;Présidentielles;2017;1;;;32;FONTENAY AUX ROSES;92032;16036;3739;12297;218;12078;DUPONT-AIGNAN Nicolas;M;DUPONT-AIGNAN;Nicolas;;431
Présidentielles 2017 - 1er tour;Présidentielles;2017;1;;;40;ISSY LES MOULINEAUX;92040;46800;9050;37750;728;37022;ARTHAUD Nathalie;F;ARTHAUD;Nathalie;;83
Présidentielles 2017 - 1er tour;Présidentielles;2017;1;;;49;MONTROUGE;92049;28899;4312;24587;429;24158;ARTHAUD Nathalie;F;ARTHAUD;Nathalie;;80
Présidentielles 2017 - 1er tour;Présidentielles;2017;1;;;49;MONTROUGE;92049;28899;4312;24587;429;24158;MÉLENCHON Jean-Luc;M;MÉLENCHON;Jean-Luc;;4673
Présidentielles 2017 - 1er tour;Présidentielles;2017;1;;;50;NANTERRE;92050;47568;10655;36913;884;36029;MÉLENCHON Jean-Luc;M;MÉLENCHON;Jean-Luc;;11877
Présidentielles 2017 - 1er tour;Présidentielles;2017;1;;;51;NEUILLY SUR SEINE;92051;37184;4180;33004;212;32792;CHEMINADE Jacques;M;CHEMINADE;Jacques;;27
Présidentielles 2017 - 1er tour;Présidentielles;2017;1;;;51;NEUILLY SUR SEINE;92051;37184;4180;33004;212;32792;HAMON Benoît;M;HAMON;Benoît;;686
Présidentielles 2017 - 1er tour;Présidentielles;2017;1;;;64;SAINT CLOUD;92064;19370;2628;16742;186;16556;MÉLENCHON Jean-Luc;M;MÉLENCHON;Jean-Luc;;1304
Présidentielles 2017 - 1er tour;Présidentielles;2017;1;;;73;SURESNES;92073;28497;4342;24155;520;23635;ARTHAUD Nathalie;F;ARTHAUD;Nathalie;;66
Présidentielles 2017 - 1er tour;Présidentielles;2017;1;;;78;VILLENEUVE LA GARENNE;92078;12429;3872;8557;315;8242;MÉLENCHON Jean-Luc;M;MÉLENCHON;Jean-Luc;;3009
Présidentielles 2012 - 1er tour;Présidentielles;2012;1;;;2;ANTONY;92002;40169;7755;32414;674;31740;POUTOU Philippe;M;POUTOU;Philippe;;221
Présidentielles 2012 - 1er tour;Présidentielles;2012;1;;;4;ASNIERES SUR SEINE;92004;45042;9279;35763;516;35247;CHEMINADE Jacques;M;CHEMINADE;Jacques;;91
Présidentielles 2012 - 1er tour;Présidentielles;2012;1;;;4;ASNIERES SUR SEINE;92004;45042;9279;35763;516;35247;BAYROU François;M;BAYROU;François;;3742
Présidentielles 2012 - 1er tour;Présidentielles;2012;1;;;14;BOURG LA REINE;92014;13300;2381;10919;132;10787;SARKOZY Nicolas;M;SARKOZY;Nicolas;;3452
Présidentielles 2012 - 1er tour;Présidentielles;2012;1;;;14;BOURG LA REINE;92014;13300;2381;10919;132;10787;CHEMINADE Jacques;M;CHEMINADE;Jacques;;43
Présidentielles 2012 - 1er tour;Présidentielles;2012;1;;;19;CHATENAY MALABRY;92019;17914;3466;14448;325;14123;LE PEN Marine;F;LE PEN;Marine;;1304
Présidentielles 2012 - 1er tour;Présidentielles;2012;1;;;19;CHATENAY MALABRY;92019;17914;3466;14448;325;14123;BAYROU François;M;BAYROU;François;;1422
Présidentielles 2012 - 1er tour;Présidentielles;2012;1;;;23;CLAMART;92023;34131;6740;27391;417;26974;SARKOZY Nicolas;M;SARKOZY;Nicolas;;8153
Présidentielles 2012 - 1er tour;Présidentielles;2012;1;;;24;CLICHY;92024;29226;6786;22440;374;22066;BAYROU François;M;BAYROU;François;;1860
Présidentielles 2012 - 1er tour;Présidentielles;2012;1;;;26;COURBEVOIE;92026;50576;11277;39299;681;38618;MÉLENCHON Jean-Luc;M;MÉLENCHON;Jean-Luc;;2895
Présidentielles 2012 - 1er tour;Présidentielles;2012;1;;;35;LA GARENNE COLOMBES;92035;17300;3509;13791;212;13579;BAYROU François;M;BAYROU;François;;1636
Présidentielles 2012 - 1er tour;Présidentielles;2012;1;;;40;ISSY LES MOULINEAUX;92040;41994;9488;32506;521;31985;POUTOU Philippe;M;POUTOU;Philippe;;209
Présidentielles 2012 - 1er tour;Présidentielles;2012;1;;;40;ISSY LES MOULINEAUX;92040;41994;9488;32506;521;31985;HOLLANDE François;M;HOLLANDE;François;;10207
Présidentielles 2012 - 1er tour;Présidentielles;2012;1;;;50;NANTERRE;92050;44307;10435;33872;654;33218;SARKOZY Nicolas;M;SARKOZY;Nicolas;;5772
Présidentielles 2012 - 1er tour;Présidentielles;2012;1;;;72;SEVRES;92072;14837;2876;11961;219;11742;ARTHAUD Nathalie;F;ARTHAUD;Nathalie;;27
Présidentielles 2012 - 1er tour;Présidentielles;2012;1;;;76;VAUCRESSON;92076;6089;1241;4848;74;4774;MÉLENCHON Jean-Luc;M;MÉLENCHON;Jean-Luc;;179
Présidentielles 2012 - 1er tour;Présidentielles;2012;1;;;76;VAUCRESSON;92076;6089;1241;4848;74;4774;CHEMINADE Jacques;M;CHEMINADE;Jacques;;6
Présidentielles 2012 - 1er tour;Présidentielles;2012;1;;;76;VAUCRESSON;92076;6089;1241;4848;74;4774;HOLLANDE François;M;HOLLANDE;François;;753
Présidentielles 2017 - 2ème tour;Présidentielles;2017;2;;;2;ANTONY;92002;41491;8828;32663;3195;29468;LE PEN Marine;F;LE PEN;Marine;;4284
Présidentielles 2017 - 2ème tour;Présidentielles;2017;2;;;7;BAGNEUX;92007;21878;6554;15324;1399;13925;LE PEN Marine;F;LE PEN;Marine;;2419
Présidentielles 2017 - 2ème tour;Présidentielles;2017;2;;;33;GARCHES;92033;12767;2732;10035;916;9119;MACRON Emmanuel;M;MACRON;Emmanuel;;7770
Présidentielles 2017 - 2ème tour;Présidentielles;2017;2;;;46;MALAKOFF;92046;18434;4289;14145;1484;12661;MACRON Emmanuel;M;MACRON;Emmanuel;;10660
Présidentielles 2017 - 2ème tour;Présidentielles;2017;2;;;76;VAUCRESSON;92076;6176;1207;4969;427;4542;MACRON Emmanuel;M;MACRON;Emmanuel;;3985
Présidentielles 2012 - 2ème tour;Présidentielles;2012;2;;;14;BOURG LA REINE;92014;13304;1969;11335;433;10902;HOLLANDE François;M;HOLLANDE;François;;5689
Présidentielles 2012 - 2ème tour;Présidentielles;2012;2;;;22;CHAVILLE;92022;12785;2053;10732;455;10277;HOLLANDE François;M;HOLLANDE;François;;5085
Présidentielles 2012 - 2ème tour;Présidentielles;2012;2;;;26;COURBEVOIE;92026;50575;9527;41048;1678;39370;HOLLANDE François;M;HOLLANDE;François;;17476
Présidentielles 2007 - 2ème tour;Présidentielles;2007;2;;;22;CHAVILLE;92022;12729;1887;10842;486;10356;ROYAL Ségolène;F;ROYAL;Ségolène;;4582
Présidentielles 2007 - 2ème tour;Présidentielles;2007;2;;;47;MARNES LA COQUETTE;92047;1054;95;959;21;938;SARKOZY Nicolas;M;SARKOZY;Nicolas;;742
Présidentielles 2007 - 2ème tour;Présidentielles;2007;2;;;51;NEUILLY SUR SEINE;92051;37661;4241;33420;707;32713;SARKOZY Nicolas;M;SARKOZY;Nicolas;;28398
Présidentielles 2007 - 2ème tour;Présidentielles;2007;2;;;63;RUEIL MALMAISON;92063;50540;6613;43927;1660;42267;SARKOZY Nicolas;M;SARKOZY;Nicolas;;25899
Législatives 2007 - 1er tour;Législatives;2007;1;2;2ème circonscription;4;ASNIERES SUR SEINE;92004;44110;17783;26327;312;26015;FISCHER Josiane;F;FISCHER;Josiane;DVD;953
Législatives 2007 - 1er tour;Législatives;2007;1;10;10ème circonscription;48;MEUDON;92048;5066;1864;3202;29;3173;GINISTY Christophe;M;GINISTY;Christophe;UDFD;449
Législatives 2007 - 1er tour;Législatives;2007;1;10;10ème circonscription;40;ISSY LES MOULINEAUX;92040;38520;14017;24503;359;24144;SCHMID Lucille;F;SCHMID;Lucille;SOC;5654
Législatives 2007 - 1er tour;Législatives;2007;1;3;3ème circonscription;35;LA GARENNE COLOMBES;92035;16552;5947;10605;101;10504;DORE Patricia;F;DORE;Patricia;ECO;169
Législatives 2007 - 1er tour;Législatives;2007;1;3;3ème circonscription;9;BOIS COLOMBES;92009;16245;6561;9684;288;9396;TRIBOULET Catherine;F;TRIBOULET;Catherine;DIV;24
Législatives 2007 - 1er tour;Législatives;2007;1;13;13ème circonscription;19;CHATENAY MALABRY;92019;17835;6584;11251;211;11040;BRAULT Chantal;F;BRAULT;Chantal;UDFD;1394
Législatives 2007 - 1er tour;Législatives;2007;1;1;1ère circonscription;25;COLOMBES;92025;26192;12273;13919;366;13553;LE GAL Anna;F;LE GAL;Anna;ECO;111
Législatives 2007 - 1er tour;Législatives;2007;1;13;13ème circonscription;71;SCEAUX;92071;14129;4679;9450;74;9376;FIE Dominique;M;FIE;Dominique;COM;134
Législatives 2007 - 1er tour;Législatives;2007;1;8;8ème circonscription;72;SEVRES;92072;14460;5279;9181;151;9030;RAFFALI Danielle;F;RAFFALI;Danielle;ECO;81
Législatives 2007 - 1er tour;Législatives;2007;1;8;8ème circonscription;76;VAUCRESSON;92076;6076;2206;3870;46;3824;SUCHARD Sophie;F;SUCHARD;Sophie;EXG;2
Législatives 2007 - 1er tour;Législatives;2007;1;10;10ème circonscription;75;VANVES;92075;17351;5929;11422;137;11285;TERRET Eugène;M;TERRET;Eugène;FN;303
Législatives 1993 - 1er tour;Législatives;1993;1;3;3ème circonscription;35;LA GARENNE COLOMBES;92035;13664;4290;9374;347;9027;POYER DIDIER;M;POYER;DIDIER;DVD;43
Législatives 1993 - 1er tour;Législatives;1993;1;3;3ème circonscription;26;COURBEVOIE;92026;34737;9916;24821;828;23993;EDMONDSON NEIL;M;EDMONDSON;NEIL;EXD;102
Législatives 1993 - 1er tour;Législatives;1993;1;3;3ème circonscription;26;COURBEVOIE;92026;34737;9916;24821;828;23993;COUSIN GUY;M;COUSIN;GUY;DIV;263
Législatives 1993 - 1er tour;Législatives;1993;1;7;7ème circonscription;33;GARCHES;92033;11440;3330;8110;328;7782;BURQ DANIEL;M;BURQ;DANIEL;GEC;903
Législatives 1993 - 1er tour;Législatives;1993;1;7;7ème circonscription;33;GARCHES;92033;11440;3330;8110;328;7782;TRON ROGER;M;TRON;ROGER;DVD;221
Législatives 1993 - 1er tour;Législatives;1993;1;8;8ème circonscription;77;VILLE D'AVRAY;92077;7199;1786;5413;149;5264;GREGOIRE MAURICE;M;GREGOIRE;MAURICE;DIV;40
Législatives 1993 - 1er tour;Législatives;1993;1;1;1ère circonscription;25;COLOMBES;92025;26594;9512;17082;693;16389;LE GALLOU J.YVES;M;LE GALLOU;J.YVES;FRN;3314
Législatives 1993 - 1er tour;Législatives;1993;1;1;1ère circonscription;25;COLOMBES;92025;26594;9512;17082;693;16389;BRUNHES JACQUES;M;BRUNHES;JACQUES;COM;5030
Législatives 1993 - 1er tour;Législatives;1993;1;1;1ère circonscription;78;VILLENEUVE LA GARENNE;92078;11604;4168;7436;212;7224;PREVOT ALAIN;M;PREVOT;ALAIN;DIV;287
Législatives 1993 - 1er tour;Législatives;1993;1;2;2ème circonscription;4;ASNIERES SUR SEINE;92004;37314;11544;25770;852;24918;POMERANZ JACQUES;M;POMERANZ;JACQUES;SOC;318
Législatives 1993 - 1er tour;Législatives;1993;1;11;11ème circonscription;49;MONTROUGE;92049;22632;7554;15078;554;14524;LE CORGUILLE VIVETTE;F;LE CORGUILLE;VIVETTE;EXG;89
Législatives 1993 - 1er tour;Législatives;1993;1;10;10ème circonscription;48;MEUDON;92048;4225;1396;2829;92;2737;SANTINI ANDRE;M;SANTINI;ANDRE;UDF;1212
Législatives 1993 - 1er tour;Législatives;1993;1;13;13ème circonscription;19;CHATENAY MALABRY;92019;17809;6223;11586;435;11151;LEFRERE CHRISTIANE;F;LEFRERE;CHRISTIANE;DIV;275
Législatives 1993 - 1er tour;Législatives;1993;1;7;7ème circonscription;63;RUEIL MALMAISON;92063;42219;12104;30115;1049;29066;MARECHAL CHRISTIAN;M;MARECHAL;CHRISTIAN;FRN;2888
Législatives 1993 - 1er tour;Législatives;1993;1;6;6ème circonscription;62;PUTEAUX;92062;23271;6636;16635;697;15938;GOUREVITCH ELISABETH;F;GOUREVITCH;ELISABETH;SOC;1950
Législatives 1993 - 1er tour;Législatives;1993;1;8;8ème circonscription;72;SEVRES;92072;13536;3690;9846;336;9510;JASSERAND BERNARD;M;JASSERAND;BERNARD;COM;680
Législatives 1993 - 1er tour;Législatives;1993;1;3;3ème circonscription;9;BOIS COLOMBES;92009;14392;4251;10141;422;9719;EDMONDSON NEIL;M;EDMONDSON;NEIL;EXD;50
Législatives 1993 - 1er tour;Législatives;1993;1;8;8ème circonscription;47;MARNES LA COQUETTE;92047;1006;246;760;21;739;JASSERAND BERNARD;M;JASSERAND;BERNARD;COM;21
Législatives 1993 - 1er tour;Législatives;1993;1;4;4ème circonscription;50;NANTERRE;92050;38007;11484;26523;795;25728;AMEIL BERTRAND;M;AMEIL;BERTRAND;DVD;185
Législatives 1993 - 1er tour;Législatives;1993;1;9;9ème circonscription;12;BOULOGNE BILLANCOURT;92012;53509;17387;36122;1224;34898;GABORIT PIERRE;M;GABORIT;PIERRE;SOC;5150
Législatives 1993 - 1er tour;Législatives;1993;1;8;8ème circonscription;47;MARNES LA COQUETTE;92047;1006;246;760;21;739;GODICHEAU PIERRE;M;GODICHEAU;PIERRE;DVD;13
Législatives 1993 - 1er tour;Législatives;1993;1;5;5ème circonscription;44;LEVALLOIS PERRET;92044;27392;7486;19906;624;19282;GALLAIS ALAIN;M;GALLAIS;ALAIN;FRN;2156
Législatives 2012 - 1er tour;Législatives;2012;1;3;3ème circonscription;9;BOIS COLOMBES;92009;16783;6763;10020;331;9689;EL-BOUZAIDI CHEIKHI Azedine;M;EL-BOUZAIDI CHEIKHI;Azedine;ECO;82
Législatives 2012 - 1er tour;Législatives;2012;1;3;3ème circonscription;9;BOIS COLOMBES;92009;16783;6763;10020;331;9689;MARTINEZ Chaïb;M;MARTINEZ;Chaïb;AUT;63
Législatives 2012 - 1er tour;Législatives;2012;1;9;9ème circonscription;12;BOULOGNE BILLANCOURT;92012;61020;24579;36441;340;36101;FEO Hélène;F;FEO;Hélène;ECO;151
Législatives 2012 - 1er tour;Législatives;2012;1;13;13ème circonscription;19;CHATENAY MALABRY;92019;17908;6775;11133;210;10923;THIRIEZ Duncan;M;THIRIEZ;Duncan;AUT;66
Législatives 2012 - 1er tour;Législatives;2012;1;5;5ème circonscription;24;CLICHY;92024;29276;13521;15755;274;15481;LACOUR Dominique;F;LACOUR;Dominique;ECO;79
Législatives 2012 - 1er tour;Législatives;2012;1;1;1ère circonscription;25;COLOMBES;92025;26337;13144;13193;209;12984;DESACHY Anne-Marie;F;DESACHY;Anne-Marie;AUT;31
Législatives 2012 - 1er tour;Législatives;2012;1;1;1ère circonscription;25;COLOMBES;92025;26337;13144;13193;209;12984;DJELLAB Nora;F;DJELLAB;Nora;UMP;2027
Législatives 2012 - 1er tour;Législatives;2012;1;2;2ème circonscription;25;COLOMBES;92025;18458;7115;11343;114;11229;PERTUS Armelle;F;PERTUS;Armelle;EXG;50
Législatives 2012 - 1er tour;Législatives;2012;1;3;3ème circonscription;35;LA GARENNE COLOMBES;92035;17314;7036;10278;79;10199;VILLEDEY Florence;F;VILLEDEY;Florence;ALLI;568
Législatives 2012 - 1er tour;Législatives;2012;1;3;3ème circonscription;35;LA GARENNE COLOMBES;92035;17314;7036;10278;79;10199;KOSSOWSKI Jacques;M;KOSSOWSKI;Jacques;UMP;4672
Législatives 2012 - 1er tour;Législatives;2012;1;8;8ème circonscription;47;MARNES LA COQUETTE;92047;1085;330;755;2;753;RABANY Dominique;F;RABANY;Dominique;FG;5
Législatives 2012 - 1er tour;Législatives;2012;1;8;8ème circonscription;47;MARNES LA COQUETTE;92047;1085;330;755;2;753;BOUCHARD Renaud;M;BOUCHARD;Renaud;DVD;0
Législatives 2012 - 1er tour;Législatives;2012;1;10;10ème circonscription;48;MEUDON;92048;5576;2083;3493;26;3467;RONCHINI Vanessa;F;RONCHINI;Vanessa;EXG;14
Législatives 2012 - 1er tour;Législatives;2012;1;11;11ème circonscription;49;MONTROUGE;92049;27889;10680;17209;123;17086;BOCHER Aurélie;F;BOCHER;Aurélie;DVD;97
Législatives 2012 - 1er tour;Législatives;2012;1;4;4ème circonscription;50;NANTERRE;92050;44344;21046;23298;337;22961;MORGANT David;M;MORGANT;David;CEN;678
Législatives 2012 - 1er tour;Législatives;2012;1;4;4ème circonscription;50;NANTERRE;92050;44344;21046;23298;337;22961;SALLES Laurent;M;SALLES;Laurent;FN;2249
Législatives 2012 - 1er tour;Législatives;2012;1;6;6ème circonscription;51;NEUILLY SUR SEINE;92051;37031;14672;22359;177;22182;FROMANTIN Jean-Christophe;M;FROMANTIN;Jean-Christophe;DVD;13279
Législatives 2012 - 1er tour;Législatives;2012;1;7;7ème circonscription;64;SAINT CLOUD;92064;19029;7431;11598;97;11501;PIERSON Jean-Christophe;M;PIERSON;Jean-Christophe;DVD;535
Législatives 2012 - 1er tour;Législatives;2012;1;13;13ème circonscription;71;SCEAUX;92071;14395;5253;9142;70;9072;CASSIA Paul;M;CASSIA;Paul;CEN;610
Législatives 2012 - 1er tour;Législatives;2012;1;8;8ème circonscription;77;VILLE D'AVRAY;92077;7169;2468;4701;48;4653;BOUCHARD Renaud;M;BOUCHARD;Renaud;DVD;0
Législatives 2012 - 1er tour;Législatives;2012;1;1;1ère circonscription;78;VILLENEUVE LA GARENNE;92078;12349;6903;5446;131;5315;GUICHARD Isabelle;F;GUICHARD;Isabelle;EXG;26
Législatives 2012 - 1er tour;Législatives;2012;1;1;1ère circonscription;78;VILLENEUVE LA GARENNE;92078;12349;6903;5446;131;5315;MUZEAU Roland;M;MUZEAU;Roland;FG;998
Législatives 2002 - 1er tour;Législatives;2002;1;13;13ème circonscription;2;ANTONY;92002;39807;13942;25865;456;25409;LEPEUVE Stéphane;M;LEPEUVE;Stéphane;EXG;496
Législatives 2002 - 1er tour;Législatives;2002;1;13;13ème circonscription;2;ANTONY;92002;39807;13942;25865;456;25409;BRAULT Chantal;F;BRAULT;Chantal;UDFD;3497
Législatives 2002 - 1er tour;Législatives;2002;1;11;11ème circonscription;7;BAGNEUX;92007;20520;8538;11982;178;11804;METTON Jean-Loup;M;METTON;Jean-Loup;MAJ;3539
Législatives 1997 - 1er tour;Législatives;1997;1;8;8ème circonscription;48;MEUDON;92048;24248;8136;16112;629;15483;BALLOT LENA CAROLINE;F;BALLOT LENA;CAROLINE;DVD;529
Législatives 1997 - 1er tour;Législatives;1997;1;11;11ème circonscription;49;MONTROUGE;92049;21975;7943;14032;388;13644;FAGES PATRICK;M;FAGES;PATRICK;DVD;68
Législatives 1997 - 1er tour;Législatives;1997;1;9;9ème circonscription;12;BOULOGNE BILLANCOURT;92012;53287;18902;34385;948;33437;JANSSEN AXELLE;F;JANSSEN;AXELLE;DVD;602
Législatives 1997 - 1er tour;Législatives;1997;1;3;3ème circonscription;9;BOIS COLOMBES;92009;14757;5447;9310;293;9017;LAHEURTE RENAUD;M;LAHEURTE;RENAUD;SOC;1873
Législatives 1993 - 2ème tour;Législatives;1993;2;13;13ème circonscription;71;SCEAUX;92071;13127;4093;9034;536;8498;MERLE J.FRANCOIS;M;MERLE;J.FRANCOIS;SOC;2991
Législatives 1997 - 1er tour;Législatives;1997;1;11;11ème circonscription;7;BAGNEUX;92007;20284;7388;12896;374;12522;DEISS A.MARIE;F;DEISS;A.MARIE;DIV;53
Législatives 1997 - 1er tour;Législatives;1997;1;8;8ème circonscription;72;SEVRES;92072;13776;4413;9363;352;9011;BALLOT LENA CAROLINE;F;BALLOT LENA;CAROLINE;DVD;309
Législatives 1997 - 1er tour;Législatives;1997;1;7;7ème circonscription;64;SAINT CLOUD;92064;18908;7095;11813;417;11396;GIROUD JEAN;M;GIROUD;JEAN;DVG;133
Législatives 1997 - 1er tour;Législatives;1997;1;12;12ème circonscription;60;LE PLESSIS ROBINSON;92060;13002;3860;9142;204;8938;PEMEZEC PHILIPPE;M;PEMEZEC;PHILIPPE;DVD;3766
Législatives 1997 - 1er tour;Législatives;1997;1;12;12ème circonscription;60;LE PLESSIS ROBINSON;92060;13002;3860;9142;204;8938;GARREC CLAUDE;M;GARREC;CLAUDE;DVD;2
Législatives 1997 - 1er tour;Législatives;1997;1;8;8ème circonscription;77;VILLE D'AVRAY;92077;7112;2283;4829;139;4690;MULLERIS KONOPNICKI A.PAULE;F;MULLERIS KONOPNICKI;A.PAULE;ECO;258
Législatives 1997 - 1er tour;Législatives;1997;1;4;4ème circonscription;73;SURESNES;92073;20985;7217;13768;441;13327;KERSUZAN NICOLE;F;KERSUZAN;NICOLE;DIV;118
Législatives 1997 - 1er tour;Législatives;1997;1;9;9ème circonscription;12;BOULOGNE BILLANCOURT;92012;53287;18902;34385;948;33437;BENSADOUN ROGER;M;BENSADOUN;ROGER;DVG;123
Législatives 1997 - 1er tour;Législatives;1997;1;8;8ème circonscription;22;CHAVILLE;92022;12268;3930;8338;262;8076;ETILE L.CHRISTOPHE;M;ETILE;L.CHRISTOPHE;DVD;169
Législatives 1997 - 1er tour;Législatives;1997;1;12;12ème circonscription;20;CHATILLON;92020;16406;5234;11172;367;10805;GARREC CLAUDE;M;GARREC;CLAUDE;DVD;6
Législatives 1997 - 1er tour;Législatives;1997;1;8;8ème circonscription;48;MEUDON;92048;24248;8136;16112;629;15483;LEVAIN JEAN;M;LEVAIN;JEAN;PRS;3838
Législatives 1997 - 1er tour;Législatives;1997;1;4;4ème circonscription;50;NANTERRE;92050;38533;13799;24734;766;23968;GEORGES BRUNO;M;GEORGES;BRUNO;DVD;293
Législatives 1997 - 2ème tour;Législatives;1997;2;8;8ème circonscription;76;VAUCRESSON;92076;5541;1696;3845;155;3690;GUILLET J.JACQUES;M;GUILLET;J.JACQUES;RPR;2813
Législatives 1997 - 2ème tour;Législatives;1997;2;8;8ème circonscription;22;CHAVILLE;92022;12268;3547;8721;398;8323;GUILLET J.JACQUES;M;GUILLET;J.JACQUES;RPR;4487
Législatives 2012 - 1er tour;Législatives;2012;1;13;13ème circonscription;2;ANTONY;92002;40941;15088;25853;361;25492;LANDFRIED Julien;M;LANDFRIED;Julien;DVG;7278
Législatives 2012 - 1er tour;Législatives;2012;1;2;2ème circonscription;4;ASNIERES SUR SEINE;92004;45114;18545;26569;310;26259;GUILLARD Laurent;M;GUILLARD;Laurent;VEC;961
Législatives 2012 - 1er tour;Législatives;2012;1;11;11ème circonscription;7;BAGNEUX;92007;20609;9648;10961;145;10816;AARSSE Rodéric;M;AARSSE;Rodéric;VEC;278
Législatives 2012 - 1er tour;Législatives;2012;1;8;8ème circonscription;22;CHAVILLE;92022;12808;4688;8120;75;8045;CASTERA Stéphane;M;CASTERA;Stéphane;AUT;76
Législatives 2012 - 1er tour;Législatives;2012;1;12;12ème circonscription;23;CLAMART;92023;34173;13440;20733;193;20540;WAHNICH Sophie;F;WAHNICH;Sophie;AUT;89
Législatives 2012 - 1er tour;Législatives;2012;1;5;5ème circonscription;24;CLICHY;92024;29276;13521;15755;274;15481;MORVAN François;M;MORVAN;François;DVD;111
Législatives 2012 - 1er tour;Législatives;2012;1;1;1ère circonscription;25;COLOMBES;92025;26337;13144;13193;209;12984;BRETON Michel;M;BRETON;Michel;EXG;70
Législatives 2012 - 1er tour;Législatives;2012;1;6;6ème circonscription;26;COURBEVOIE;92026;8123;3742;4381;140;4241;CARREAU Georges;M;CARREAU;Georges;AUT;6
Législatives 2012 - 1er tour;Législatives;2012;1;1;1ère circonscription;36;GENNEVILLIERS;92036;20795;10523;10272;192;10080;MELIHI Rachida;F;MELIHI;Rachida;ECO;30
Législatives 2012 - 1er tour;Législatives;2012;1;1;1ère circonscription;36;GENNEVILLIERS;92036;20795;10523;10272;192;10080;YAHIAOUI Karim;M;YAHIAOUI;Karim;CEN;71
Législatives 2012 - 1er tour;Législatives;2012;1;5;5ème circonscription;44;LEVALLOIS PERRET;92044;39546;14667;24879;238;24641;LAMBERT Mireille;F;LAMBERT;Mireille;EXG;25
Législatives 2012 - 1er tour;Législatives;2012;1;8;8ème circonscription;48;MEUDON;92048;25002;9709;15293;150;15143;MORDELET-CARRIERE Nadia;F;MORDELET-CARRIERE;Nadia;CEN;567
Législatives 2012 - 1er tour;Législatives;2012;1;8;8ème circonscription;48;MEUDON;92048;25002;9709;15293;150;15143;BOUCHARD Renaud;M;BOUCHARD;Renaud;DVD;22
Législatives 2012 - 1er tour;Législatives;2012;1;11;11ème circonscription;49;MONTROUGE;92049;27889;10680;17209;123;17086;DE FONTENAILLES Marie;F;DE FONTENAILLES;Marie;FN;910
Législatives 2012 - 1er tour;Législatives;2012;1;4;4ème circonscription;50;NANTERRE;92050;44344;21046;23298;337;22961;BOUQUET André;M;BOUQUET;André;EXG;32
Législatives 2012 - 1er tour;Législatives;2012;1;4;4ème circonscription;50;NANTERRE;92050;44344;21046;23298;337;22961;DUPUY Christian;M;DUPUY;Christian;UMP;3920
Législatives 2012 - 1er tour;Législatives;2012;1;6;6ème circonscription;62;PUTEAUX;92062;28253;11141;17112;441;16671;FROMANTIN Jean-Christophe;M;FROMANTIN;Jean-Christophe;DVD;3022
Législatives 2012 - 1er tour;Législatives;2012;1;7;7ème circonscription;63;RUEIL MALMAISON;92063;52518;20526;31992;298;31694;PIERSON Jean-Christophe;M;PIERSON;Jean-Christophe;DVD;551
Législatives 2012 - 1er tour;Législatives;2012;1;7;7ème circonscription;63;RUEIL MALMAISON;92063;52518;20526;31992;298;31694;JEANMAIRE François;M;JEANMAIRE;François;DVD;1731
Législatives 2012 - 1er tour;Législatives;2012;1;8;8ème circonscription;72;SEVRES;92072;14861;5785;9076;101;8975;BOUCHARD Renaud;M;BOUCHARD;Renaud;DVD;8
Législatives 2012 - 1er tour;Législatives;2012;1;8;8ème circonscription;77;VILLE D'AVRAY;92077;7169;2468;4701;48;4653;RABANY Dominique;F;RABANY;Dominique;FG;75
Législatives 2012 - 1er tour;Législatives;2012;1;8;8ème circonscription;77;VILLE D'AVRAY;92077;7169;2468;4701;48;4653;CASTERA Stéphane;M;CASTERA;Stéphane;AUT;27
Législatives 2012 - 1er tour;Législatives;2012;1;1;1ère circonscription;78;VILLENEUVE LA GARENNE;92078;12349;6903;5446;131;5315;SABAN Muriel;F;SABAN;Muriel;NCE;0
Législatives 2012 - 1er tour;Législatives;2012;1;1;1ère circonscription;78;VILLENEUVE LA GARENNE;92078;12349;6903;5446;131;5315;BOURDU Anne;F;BOURDU;Anne;DVD;28
Législatives 2012 - 1er tour;Législatives;2012;1;1;1ère circonscription;78;VILLENEUVE LA GARENNE;92078;12349;6903;5446;131;5315;CARILLON Rémi;M;CARILLON;Rémi;FN;766
Législatives 2012 - 2ème tour;Législatives;2012;2;3;3ème circonscription;9;BOIS COLOMBES;92009;16783;7127;9656;288;9368;KOSSOWSKI Jacques;M;KOSSOWSKI;Jacques;UMP;4996
Législatives 2012 - 2ème tour;Législatives;2012;2;10;10ème circonscription;12;BOULOGNE BILLANCOURT;92012;6600;3010;3590;117;3473;SCHMID Lucile;F;SCHMID;Lucile;VEC;1886
Législatives 2012 - 2ème tour;Législatives;2012;2;2;2ème circonscription;25;COLOMBES;92025;18459;7690;10769;430;10339;AESCHLIMANN Manuel;M;AESCHLIMANN;Manuel;UMP;4991
Législatives 2012 - 2ème tour;Législatives;2012;2;6;6ème circonscription;26;COURBEVOIE;92026;8123;3901;4222;154;4068;BRANNENS Marie;F;BRANNENS;Marie;SOC;2145
Législatives 2012 - 2ème tour;Législatives;2012;2;4;4ème circonscription;50;NANTERRE;92050;44344;22115;22229;757;21472;DUPUY Christian;M;DUPUY;Christian;UMP;6255
Législatives 2012 - 2ème tour;Législatives;2012;2;6;6ème circonscription;51;NEUILLY SUR SEINE;92051;37031;16138;20893;237;20656;BRANNENS Marie;F;BRANNENS;Marie;SOC;2199
Législatives 2012 - 2ème tour;Législatives;2012;2;7;7ème circonscription;64;SAINT CLOUD;92064;19029;8583;10446;347;10099;ROCHERON Bertrand;M;ROCHERON;Bertrand;SOC;3030
Législatives 2002 - 2ème tour;Législatives;2002;2;13;13ème circonscription;2;ANTONY;92002;37341;12747;24594;681;23913;LE NEOUANNIC PASCALE;F;LE NEOUANNIC;PASCALE;SOC;10139
Présidentielles 1995 - 2ème tour;Présidentielles;1995;2;;;36;GENNEVILLIERS;92036;19543;5757;13786;960;12826;CHIRAC JACQUES;M;CHIRAC;JACQUES;;4537
Présidentielles 2002 - 2ème tour;Présidentielles;2002;2;;;78;VILLENEUVE LA GARENNE;92078;11406;3421;7985;280;7705;CHIRAC JACQUES;M;CHIRAC;JACQUES;;6395
Présidentielles 1995 - 1er tour;Présidentielles;1995;1;;;77;VILLE D'AVRAY;92077;7139;1490;5649;74;5575;CHIRAC JACQUES;M;CHIRAC;JACQUES;;1892
Présidentielles 1995 - 1er tour;Présidentielles;1995;1;;;75;VANVES;92075;15499;3343;12156;236;11920;VOYNET DOMINIQUE;F;VOYNET;DOMINIQUE;;475
Législatives 1993 - 1er tour;Législatives;1993;1;13;13ème circonscription;2;ANTONY;92002;36749;10226;26523;1007;25516;CAILLAULT JACQUES;M;CAILLAULT;JACQUES;MAJ;528
Législatives 1993 - 1er tour;Législatives;1993;1;2;2ème circonscription;4;ASNIERES SUR SEINE;92004;37314;11544;25770;852;24918;PIROD GUY;M;PIROD;GUY;EXD;76
Législatives 1993 - 1er tour;Législatives;1993;1;12;12ème circonscription;32;FONTENAY AUX ROSES;92032;15091;4963;10128;341;9787;LE BERRE ALAIN;M;LE BERRE;ALAIN;FRN;1105
Législatives 1993 - 1er tour;Législatives;1993;1;2;2ème circonscription;25;COLOMBES;92025;18324;5870;12454;434;12020;POMERANZ JACQUES;M;POMERANZ;JACQUES;SOC;144
Législatives 1993 - 1er tour;Législatives;1993;1;8;8ème circonscription;47;MARNES LA COQUETTE;92047;1006;246;760;21;739;NICOLAS PATRICK;M;NICOLAS;PATRICK;DVD;3
Législatives 1993 - 1er tour;Législatives;1993;1;8;8ème circonscription;47;MARNES LA COQUETTE;92047;1006;246;760;21;739;KONOPNICKI GUY;M;KONOPNICKI;GUY;GEC;46
Législatives 1993 - 1er tour;Législatives;1993;1;12;12ème circonscription;60;LE PLESSIS ROBINSON;92060;13118;4266;8852;315;8537;LARCHER ROBERT;M;LARCHER;ROBERT;EXG;142
Législatives 1993 - 1er tour;Législatives;1993;1;6;6ème circonscription;51;NEUILLY SUR SEINE;92051;35806;10146;25660;620;25040;SARKOZY NICOLAS;M;SARKOZY;NICOLAS;RPR;18049
Législatives 1993 - 1er tour;Législatives;1993;1;8;8ème circonscription;48;MEUDON;92048;25126;7628;17498;529;16969;MARGUERITES HARRY;M;MARGUERITES;HARRY;MAJ;228
Législatives 1993 - 1er tour;Législatives;1993;1;10;10ème circonscription;48;MEUDON;92048;4225;1396;2829;92;2737;DORLIN MICHEL;M;DORLIN;MICHEL;FRN;331
Législatives 1993 - 1er tour;Législatives;1993;1;8;8ème circonscription;77;VILLE D'AVRAY;92077;7199;1786;5413;149;5264;GODICHEAU PIERRE;M;GODICHEAU;PIERRE;DVD;43
Législatives 1993 - 2ème tour;Législatives;1993;2;13;13ème circonscription;2;ANTONY;92002;36749;10926;25823;1776;24047;MERLE J.FRANCOIS;M;MERLE;J.FRANCOIS;SOC;9791
Législatives 1993 - 2ème tour;Législatives;1993;2;5;5ème circonscription;24;CLICHY;92024;25172;9456;15716;1166;14550;BALKANY PATRICK;M;BALKANY;PATRICK;RPR;7449
Législatives 1993 - 1er tour;Législatives;1993;1;11;11ème circonscription;7;BAGNEUX;92007;21150;7754;13396;474;12922;BASSINET PHILIPPE;M;BASSINET;PHILIPPE;SOC;1804
Législatives 1993 - 1er tour;Législatives;1993;1;13;13ème circonscription;19;CHATENAY MALABRY;92019;17809;6223;11586;435;11151;ROSNER ADRIAN;M;ROSNER;ADRIAN;GEC;1131
Législatives 1993 - 1er tour;Législatives;1993;1;5;5ème circonscription;24;CLICHY;92024;25172;9290;15882;514;15368;CREMIEUX ROBERT;M;CREMIEUX;ROBERT;EXG;222
Législatives 1993 - 1er tour;Législatives;1993;1;10;10ème circonscription;40;ISSY LES MOULINEAUX;92040;29377;9425;19952;648;19304;SANTINI ANDRE;M;SANTINI;ANDRE;UDF;10269
Législatives 1993 - 2ème tour;Législatives;1993;2;5;5ème circonscription;44;LEVALLOIS PERRET;92044;27392;8022;19370;1292;18078;CATOIRE GILLES;M;CATOIRE;GILLES;SOC;6620
Législatives 1993 - 2ème tour;Législatives;1993;2;3;3ème circonscription;35;LA GARENNE COLOMBES;92035;13664;4706;8958;549;8409;HABY J.YVES;M;HABY;J.YVES;UDF;5139
Législatives 1993 - 2ème tour;Législatives;1993;2;10;10ème circonscription;48;MEUDON;92048;4225;1555;2670;149;2521;SANTINI ANDRE;M;SANTINI;ANDRE;UDF;1492
Législatives 1997 - 1er tour;Législatives;1997;1;2;2ème circonscription;4;ASNIERES SUR SEINE;92004;37154;13729;23425;737;22688;MOAL PHILIPPE;M;MOAL;PHILIPPE;DIV;32
Législatives 2017 - 1er tour;Législatives;2017;1;1;1ère circonscription;25;COLOMBES;92025;27867;16420;11447;405;11042;BARON Jean-Baptiste;M;BARON;Jean-Baptiste;DIV;144
Législatives 2017 - 1er tour;Législatives;2017;1;7;7ème circonscription;64;SAINT CLOUD;92064;19410;7490;11920;102;11818;BERDOATI Eric;M;BERDOATI;Eric;LR;4138
Législatives 2017 - 1er tour;Législatives;2017;1;8;8ème circonscription;22;CHAVILLE;92022;13523;5385;8138;93;8045;HÉNIQUE Philippe;M;HÉNIQUE;Philippe;EXG;47
Législatives 2017 - 1er tour;Législatives;2017;1;8;8ème circonscription;48;MEUDON;92048;25240;11059;14181;174;14007;THOMAS Marc;M;THOMAS;Marc;FN;722
Législatives 2017 - 1er tour;Législatives;2017;1;8;8ème circonscription;72;SEVRES;92072;15144;6343;8801;149;8652;EPPLING Robin;M;EPPLING;Robin;DIV;118
Législatives 2017 - 1er tour;Législatives;2017;1;8;8ème circonscription;72;SEVRES;92072;15144;6343;8801;149;8652;PAILLARD Christophe;M;PAILLARD;Christophe;DVD;20
Législatives 2017 - 1er tour;Législatives;2017;1;8;8ème circonscription;76;VAUCRESSON;92076;6187;2474;3713;42;3671;PAILLARD Christophe;M;PAILLARD;Christophe;DVD;22
Législatives 2017 - 1er tour;Législatives;2017;1;9;9ème circonscription;12;BOULOGNE BILLANCOURT;92012;64984;30321;34663;987;33676;GAMBIEZ Fabienne;F;GAMBIEZ;Fabienne;RDG;2144
Législatives 2017 - 1er tour;Législatives;2017;1;10;10ème circonscription;12;BOULOGNE BILLANCOURT;92012;9082;4562;4520;114;4406;COSTE Jeremy;M;COSTE;Jeremy;UDI;730
Législatives 2017 - 1er tour;Législatives;2017;1;10;10ème circonscription;75;VANVES;92075;18507;7626;10881;125;10756;ATTAL Gabriel;M;ATTAL;Gabriel;REM;4776
Législatives 2017 - 1er tour;Législatives;2017;1;11;11ème circonscription;7;BAGNEUX;92007;21911;12424;9487;167;9320;RAMONET Pascal;M;RAMONET;Pascal;DIV;0
Législatives 2017 - 1er tour;Législatives;2017;1;12;12ème circonscription;20;CHATILLON;92020;22311;9527;12784;186;12598;SÉJOURNÉ Emmanuelle;F;SÉJOURNÉ;Emmanuelle;DLF;171
Législatives 2017 - 1er tour;Législatives;2017;1;12;12ème circonscription;20;CHATILLON;92020;22311;9527;12784;186;12598;YVENAT Damien;M;YVENAT;Damien;FN;635
Législatives 2017 - 1er tour;Législatives;2017;1;13;13ème circonscription;19;CHATENAY MALABRY;92019;18752;8166;10586;245;10341;YANEZ Jérôme;M;YANEZ;Jérôme;DIV;75
Législatives 2017 - 1er tour;Législatives;2017;1;13;13ème circonscription;71;SCEAUX;92071;15078;6395;8683;84;8599;CUKIERMAN Maurice;M;CUKIERMAN;Maurice;EXG;10
Législatives 2017 - 2ème tour;Législatives;2017;2;11;11ème circonscription;49;MONTROUGE;92049;28914;14304;14610;920;13690;ROSSI Laurianne;F;ROSSI;Laurianne;REM;8726
Législatives 2017 - 2ème tour;Législatives;2017;2;12;12ème circonscription;32;FONTENAY AUX ROSES;92032;16049;9154;6895;706;6189;PEMEZEC Philippe;M;PEMEZEC;Philippe;LR;2184
Législatives 2017 - 1er tour;Législatives;2017;1;4;4ème circonscription;50;NANTERRE;92050;47651;26455;21196;432;20764;BEDIN Camille;F;BEDIN;Camille;LR;2278
Législatives 2017 - 1er tour;Législatives;2017;1;7;7ème circonscription;63;RUEIL MALMAISON;92063;54498;24335;30163;377;29786;SOUCHÈRE Sophie;F;SOUCHÈRE;Sophie;DLF;406
Législatives 2017 - 1er tour;Législatives;2017;1;7;7ème circonscription;33;GARCHES;92033;12777;5514;7263;115;7148;HANNOUF Noureddine;M;HANNOUF;Noureddine;DVD;19
Législatives 2017 - 1er tour;Législatives;2017;1;3;3ème circonscription;26;COURBEVOIE;92026;44322;19890;24432;415;24017;FRANCOIS-DAINVILLE Grégoire;M;FRANCOIS-DAINVILLE;Grégoire;DVD;400
Présidentielles 2002 - 1er tour;Présidentielles;2002;1;;;24;CLICHY;92024;24491;8395;16096;399;15697;LEPAGE CORINNE;F;LEPAGE;CORINNE;;285
Présidentielles 2002 - 1er tour;Présidentielles;2002;1;;;24;CLICHY;92024;24491;8395;16096;399;15697;LAGUILLER ARLETTE;F;LAGUILLER;ARLETTE;;876
Présidentielles 2002 - 1er tour;Présidentielles;2002;1;;;25;COLOMBES;92025;39608;13654;25954;571;25383;MADELIN ALAIN;M;MADELIN;ALAIN;;1057
Présidentielles 2002 - 1er tour;Présidentielles;2002;1;;;32;FONTENAY AUX ROSES;92032;14148;4309;9839;204;9635;CHIRAC JACQUES;M;CHIRAC;JACQUES;;1918
Présidentielles 2002 - 1er tour;Présidentielles;2002;1;;;33;GARCHES;92033;11708;3920;7788;137;7651;BESANCENOT OLIVIER;M;BESANCENOT;OLIVIER;;134
Présidentielles 2002 - 1er tour;Présidentielles;2002;1;;;35;LA GARENNE COLOMBES;92035;15006;5167;9839;227;9612;MADELIN ALAIN;M;MADELIN;ALAIN;;570
Présidentielles 2002 - 1er tour;Présidentielles;2002;1;;;36;GENNEVILLIERS;92036;18213;6933;11280;303;10977;BOUTIN CHRISTINE;F;BOUTIN;CHRISTINE;;55
Présidentielles 2002 - 2ème tour;Présidentielles;2002;2;;;25;COLOMBES;92025;39599;8138;31461;1186;30275;LE PEN JEAN-MARIE;M;LE PEN;JEAN-MARIE;;4197
Présidentielles 2002 - 2ème tour;Présidentielles;2002;2;;;48;MEUDON;92048;28289;5448;22841;707;22134;LE PEN JEAN-MARIE;M;LE PEN;JEAN-MARIE;;2439
Présidentielles 2002 - 2ème tour;Présidentielles;2002;2;;;49;MONTROUGE;92049;23382;5345;18037;640;17397;CHIRAC JACQUES;M;CHIRAC;JACQUES;;15418
Présidentielles 2017 - 2ème tour;Présidentielles;2017;2;;;23;CLAMART;92023;35297;8251;27046;2436;24610;MACRON Emmanuel;M;MACRON;Emmanuel;;20527
Présidentielles 2017 - 2ème tour;Présidentielles;2017;2;;;46;MALAKOFF;92046;18434;4289;14145;1484;12661;LE PEN Marine;F;LE PEN;Marine;;2001
Présidentielles 2007 - 2ème tour;Présidentielles;2007;2;;;60;LE PLESSIS ROBINSON;92060;16574;2193;14381;560;13821;ROYAL Ségolène;F;ROYAL;Ségolène;;6282
Présidentielles 2007 - 2ème tour;Présidentielles;2007;2;;;72;SEVRES;92072;14169;1834;12335;525;11810;SARKOZY Nicolas;M;SARKOZY;Nicolas;;6661
Présidentielles 2012 - 2ème tour;Présidentielles;2012;2;;;12;BOULOGNE BILLANCOURT;92012;67629;11051;56578;2025;54553;SARKOZY Nicolas;M;SARKOZY;Nicolas;;34464
Présidentielles 2012 - 2ème tour;Présidentielles;2012;2;;;14;BOURG LA REINE;92014;13304;1969;11335;433;10902;SARKOZY Nicolas;M;SARKOZY;Nicolas;;5213
Présidentielles 2012 - 2ème tour;Présidentielles;2012;2;;;48;MEUDON;92048;30598;5278;25320;925;24395;SARKOZY Nicolas;M;SARKOZY;Nicolas;;12122
Présidentielles 2012 - 2ème tour;Présidentielles;2012;2;;;51;NEUILLY SUR SEINE;92051;37057;4383;32674;657;32017;HOLLANDE François;M;HOLLANDE;François;;5058
Législatives 2007 - 1er tour;Législatives;2007;1;1;1ère circonscription;78;VILLENEUVE LA GARENNE;92078;13038;7211;5827;131;5696;DENJEAN Jean-Marc;M;DENJEAN;Jean-Marc;VEC;151
Législatives 2007 - 2ème tour;Législatives;2007;2;10;10ème circonscription;12;BOULOGNE BILLANCOURT;92012;5551;2854;2697;89;2608;SCHMID Lucille;F;SCHMID;Lucille;SOC;1302
Législatives 2007 - 2ème tour;Législatives;2007;2;12;12ème circonscription;23;CLAMART;92023;32915;12101;20814;545;20269;PEMEZEC Philippe;M;PEMEZEC;Philippe;UMP;10381
Législatives 2007 - 1er tour;Législatives;2007;1;2;2ème circonscription;4;ASNIERES SUR SEINE;92004;44110;17783;26327;312;26015;VALLET Guillaume;M;VALLET;Guillaume;DIV;0
Législatives 2007 - 1er tour;Législatives;2007;1;2;2ème circonscription;4;ASNIERES SUR SEINE;92004;44110;17783;26327;312;26015;GOISET Philippe;M;GOISET;Philippe;EXG;151
Législatives 2007 - 1er tour;Législatives;2007;1;2;2ème circonscription;4;ASNIERES SUR SEINE;92004;44110;17783;26327;312;26015;SALLES Laurent;M;SALLES;Laurent;FN;824
Législatives 2007 - 1er tour;Législatives;2007;1;3;3ème circonscription;9;BOIS COLOMBES;92009;16245;6561;9684;288;9396;BERKOUKI Sarah;F;BERKOUKI;Sarah;DIV;51
Législatives 2007 - 1er tour;Législatives;2007;1;13;13ème circonscription;71;SCEAUX;92071;14129;4679;9450;74;9376;HOLLEBEKE Dominique;F;HOLLEBEKE;Dominique;MPF;106
Législatives 2007 - 1er tour;Législatives;2007;1;12;12ème circonscription;32;FONTENAY AUX ROSES;92032;15468;5605;9863;84;9779;DIAZ GOMEZ Elisabeth;F;DIAZ GOMEZ;Elisabeth;DIV;0
Législatives 2007 - 1er tour;Législatives;2007;1;3;3ème circonscription;26;COURBEVOIE;92026;49151;19345;29806;541;29265;ROYON Francine;F;ROYON;Francine;EXG;467
Législatives 2007 - 1er tour;Législatives;2007;1;2;2ème circonscription;25;COLOMBES;92025;18336;7144;11192;207;10985;TRUPIN Laurent;M;TRUPIN;Laurent;UDFD;1193
Législatives 2007 - 1er tour;Législatives;2007;1;10;10ème circonscription;48;MEUDON;92048;5066;1864;3202;29;3173;TERRET Eugène;M;TERRET;Eugène;FN;75
Législatives 2007 - 1er tour;Législatives;2007;1;5;5ème circonscription;44;LEVALLOIS PERRET;92044;39466;14724;24742;404;24338;COCHEPAIN Stéphane;M;COCHEPAIN;Stéphane;UDFD;2736
Législatives 2007 - 1er tour;Législatives;2007;1;5;5ème circonscription;44;LEVALLOIS PERRET;92044;39466;14724;24742;404;24338;GALLAIS Alain;M;GALLAIS;Alain;FN;664
Législatives 2007 - 1er tour;Législatives;2007;1;5;5ème circonscription;44;LEVALLOIS PERRET;92044;39466;14724;24742;404;24338;MENDEZ Annie;F;MENDEZ;Annie;COM;409
Législatives 2007 - 1er tour;Législatives;2007;1;11;11ème circonscription;46;MALAKOFF;92046;18478;7045;11433;204;11229;MORILLERE Denis;M;MORILLERE;Denis;DIV;0
Législatives 2007 - 1er tour;Législatives;2007;1;13;13ème circonscription;19;CHATENAY MALABRY;92019;17835;6584;11251;211;11040;DEVEDJIAN Patrick;M;DEVEDJIAN;Patrick;UMP;4938
Législatives 2007 - 1er tour;Législatives;2007;1;13;13ème circonscription;14;BOURG LA REINE;92014;13381;4391;8990;78;8912;FONTAN Huguette;F;FONTAN;Huguette;DIV;0
Législatives 2007 - 1er tour;Législatives;2007;1;12;12ème circonscription;20;CHATILLON;92020;20661;7083;13578;137;13441;BRILLON Freddy;M;BRILLON;Freddy;DVD;50
Législatives 2007 - 1er tour;Législatives;2007;1;12;12ème circonscription;60;LE PLESSIS ROBINSON;92060;16776;5588;11188;123;11065;CHABRAN Isabelle;F;CHABRAN;Isabelle;VEC;313
Législatives 2007 - 1er tour;Législatives;2007;1;6;6ème circonscription;62;PUTEAUX;92062;26791;8829;17962;396;17566;SALIOU Valérie;F;SALIOU;Valérie;VEC;485
Législatives 2007 - 1er tour;Législatives;2007;1;6;6ème circonscription;62;PUTEAUX;92062;26791;8829;17962;396;17566;MINARDI Gaëtan;M;MINARDI;Gaëtan;EXG;81
Législatives 2007 - 1er tour;Législatives;2007;1;8;8ème circonscription;47;MARNES LA COQUETTE;92047;1074;316;758;5;753;DEQUEANT Annie;F;DEQUEANT;Annie;FN;20
Législatives 2007 - 1er tour;Législatives;2007;1;8;8ème circonscription;48;MEUDON;92048;25427;9683;15744;202;15542;FILLOUX Delphine;F;FILLOUX;Delphine;DIV;273
Législatives 2007 - 2ème tour;Législatives;2007;2;12;12ème circonscription;60;LE PLESSIS ROBINSON;92060;16773;6008;10765;223;10542;PEMEZEC Philippe;M;PEMEZEC;Philippe;UMP;6657
Législatives 2007 - 2ème tour;Législatives;2007;2;10;10ème circonscription;75;VANVES;92075;17351;6819;10532;243;10289;SCHMID Lucille;F;SCHMID;Lucille;SOC;5043
Législatives 2017 - 1er tour;Législatives;2017;1;2;2ème circonscription;25;COLOMBES;92025;19668;8354;11314;229;11085;HÉBERT Pierre;M;HÉBERT;Pierre;DVD;191
Législatives 2017 - 2ème tour;Législatives;2017;2;1;1ère circonscription;25;COLOMBES;92025;27867;17939;9928;902;9026;KHALFI Isia;F;KHALFI;Isia;REM;4925
Législatives 2017 - 2ème tour;Législatives;2017;2;1;1ère circonscription;36;GENNEVILLIERS;92036;22174;14091;8083;522;7561;KHALFI Isia;F;KHALFI;Isia;REM;2320
Législatives 2017 - 2ème tour;Législatives;2017;2;9;9ème circonscription;12;BOULOGNE BILLANCOURT;92012;64985;36143;28842;2663;26179;GODIN Marie-Laure;F;GODIN;Marie-Laure;DVD;11379
Législatives 2017 - 2ème tour;Législatives;2017;2;13;13ème circonscription;14;BOURG LA REINE;92014;13736;6580;7156;682;6474;SIFFREDI Georges;M;SIFFREDI;Georges;LR;2357
Législatives 2007 - 1er tour;Législatives;2007;1;8;8ème circonscription;76;VAUCRESSON;92076;6076;2206;3870;46;3824;RUSSO Annick;F;RUSSO;Annick;DIV;2
Législatives 2002 - 1er tour;Législatives;2002;1;6;6ème circonscription;51;NEUILLY SUR SEINE;92051;39134;14738;24396;185;24211;LARAQUE Isabelle;F;LARAQUE;Isabelle;EXD;111
Législatives 2002 - 1er tour;Législatives;2002;1;6;6ème circonscription;62;PUTEAUX;92062;26791;8829;17962;396;17566;MINARDI Gaëtan;M;MINARDI;Gaëtan;EXG;81
Législatives 2002 - 1er tour;Législatives;2002;1;6;6ème circonscription;62;PUTEAUX;92062;26791;8829;17962;396;17566;SALIOU Valérie;F;SALIOU;Valérie;VEC;485
Législatives 2002 - 1er tour;Législatives;2002;1;8;8ème circonscription;76;VAUCRESSON;92076;6076;2206;3870;46;3824;FILLOUX Delphine;F;FILLOUX;Delphine;DIV;36
Législatives 2002 - 1er tour;Législatives;2002;1;8;8ème circonscription;77;VILLE D'AVRAY;92077;7475;2429;5046;60;4986;ROY Caroline;F;ROY;Caroline;RDG;668
Législatives 2002 - 2ème tour;Législatives;2002;2;2;2ème circonscription;4;ASNIERES SUR SEINE;92004;35993;14675;21318;733;20585;AESCHLIMANN MANUEL;M;AESCHLIMANN;MANUEL;UMP;13497
Législatives 2002 - 2ème tour;Législatives;2002;2;5;5ème circonscription;24;CLICHY;92024;24685;10326;14359;540;13819;CHAZEAUX DE OLIVIER;M;CHAZEAUX DE;OLIVIER;UMP;3990
Législatives 2002 - 2ème tour;Législatives;2002;2;2;2ème circonscription;25;COLOMBES;92025;16443;6093;10350;347;10003;RIERA DOMINIQUE;M;RIERA;DOMINIQUE;SOC;4037
Législatives 2002 - 2ème tour;Législatives;2002;2;7;7ème circonscription;33;GARCHES;92033;11902;4852;7050;170;6880;NADOR SOUHILA;F;NADOR;SOUHILA;SOC;1912
Législatives 2002 - 2ème tour;Législatives;2002;2;5;5ème circonscription;44;LEVALLOIS PERRET;92044;34014;10618;23396;339;23057;BALKANY PATRICK;M;BALKANY;PATRICK;DVD;9478
Législatives 1997 - 2ème tour;Législatives;1997;2;12;12ème circonscription;60;LE PLESSIS ROBINSON;92060;13001;3659;9342;430;8912;FOUCHER J.PIERRE;M;FOUCHER;J.PIERRE;UDF;4654
Législatives 1997 - 2ème tour;Législatives;1997;2;4;4ème circonscription;50;NANTERRE;92050;38533;12430;26103;1248;24855;FRAYSSE JACQUELINE;F;FRAYSSE;JACQUELINE;COM;14770
Législatives 1997 - 2ème tour;Législatives;1997;2;12;12ème circonscription;23;CLAMART;92023;30272;8928;21344;1067;20277;BUCHET PASCAL;M;BUCHET;PASCAL;SOC;9790
Législatives 2012 - 1er tour;Législatives;2012;1;8;8ème circonscription;76;VAUCRESSON;92076;6093;2463;3630;39;3591;MORDELET-CARRIERE Nadia;F;MORDELET-CARRIERE;Nadia;CEN;103
Législatives 2012 - 2ème tour;Législatives;2012;2;13;13ème circonscription;2;ANTONY;92002;40941;14882;26059;771;25288;LANDFRIED Julien;M;LANDFRIED;Julien;DVG;12330
Législatives 2012 - 2ème tour;Législatives;2012;2;12;12ème circonscription;20;CHATILLON;92020;21682;8175;13507;266;13241;PEMEZEC Philippe;M;PEMEZEC;Philippe;UMP;6203
Législatives 2012 - 2ème tour;Législatives;2012;2;2;2ème circonscription;25;COLOMBES;92025;18459;7690;10769;430;10339;PIETRASANTA Sébastien;M;PIETRASANTA;Sébastien;SOC;5348
Législatives 2012 - 2ème tour;Législatives;2012;2;11;11ème circonscription;46;MALAKOFF;92046;18858;8508;10350;538;9812;METTON Jean-Loup;M;METTON;Jean-Loup;NCE;2722
Législatives 2012 - 2ème tour;Législatives;2012;2;8;8ème circonscription;47;MARNES LA COQUETTE;92047;1085;358;727;22;705;GUILLET Jean-Jacques;M;GUILLET;Jean-Jacques;UMP;564
Législatives 2012 - 2ème tour;Législatives;2012;2;10;10ème circonscription;48;MEUDON;92048;5576;2204;3372;54;3318;SCHMID Lucile;F;SCHMID;Lucile;VEC;1665
Législatives 2002 - 1er tour;Législatives;2002;1;13;13ème circonscription;2;ANTONY;92002;39807;13942;25865;456;25409;FONTAN Huguette;F;FONTAN;Huguette;DIV;26
Législatives 2002 - 1er tour;Législatives;2002;1;13;13ème circonscription;2;ANTONY;92002;39807;13942;25865;456;25409;IORIO Catherine;F;IORIO;Catherine;FN;669
Législatives 2002 - 1er tour;Législatives;2002;1;11;11ème circonscription;7;BAGNEUX;92007;20520;8538;11982;178;11804;MORILLERE Denis;M;MORILLERE;Denis;DIV;0
Législatives 2002 - 1er tour;Législatives;2002;1;9;9ème circonscription;12;BOULOGNE BILLANCOURT;92012;60773;22422;38351;535;37816;PICARD Marianne;F;PICARD;Marianne;DVG;240
Législatives 2002 - 1er tour;Législatives;2002;1;13;13ème circonscription;19;CHATENAY MALABRY;92019;17835;6584;11251;211;11040;BASTIDE Anne;F;BASTIDE;Anne;ECO;15
Législatives 2012 - 1er tour;Législatives;2012;1;2;2ème circonscription;4;ASNIERES SUR SEINE;92004;45114;18545;26569;310;26259;YADE Rama;F;YADE;Rama;PRV;3211
Législatives 2012 - 1er tour;Législatives;2012;1;11;11ème circonscription;7;BAGNEUX;92007;20609;9648;10961;145;10816;BOURHIS Nadine;F;BOURHIS;Nadine;ECO;50
Législatives 2012 - 1er tour;Législatives;2012;1;11;11ème circonscription;7;BAGNEUX;92007;20609;9648;10961;145;10816;METTON Jean-Loup;M;METTON;Jean-Loup;NCE;1687
Législatives 2012 - 1er tour;Législatives;2012;1;3;3ème circonscription;9;BOIS COLOMBES;92009;16783;6763;10020;331;9689;EISENBERG Mathilde;F;EISENBERG;Mathilde;EXG;37
Législatives 2012 - 1er tour;Législatives;2012;1;13;13ème circonscription;14;BOURG LA REINE;92014;13305;4436;8869;87;8782;CASSIA Paul;M;CASSIA;Paul;CEN;426
Législatives 2012 - 1er tour;Législatives;2012;1;13;13ème circonscription;19;CHATENAY MALABRY;92019;17908;6775;11133;210;10923;CASSIA Paul;M;CASSIA;Paul;CEN;354
Législatives 2012 - 1er tour;Législatives;2012;1;13;13ème circonscription;19;CHATENAY MALABRY;92019;17908;6775;11133;210;10923;DE ZAYAS Marie;F;DE ZAYAS;Marie;DVD;35
Législatives 2012 - 1er tour;Législatives;2012;1;12;12ème circonscription;20;CHATILLON;92020;21681;8265;13416;122;13294;LE METAYER Jocelyne;F;LE METAYER;Jocelyne;FG;814
Législatives 2012 - 1er tour;Législatives;2012;1;8;8ème circonscription;22;CHAVILLE;92022;12808;4688;8120;75;8045;MOGHIR Naïma;F;MOGHIR;Naïma;ECO;51
Législatives 2012 - 1er tour;Législatives;2012;1;1;1ère circonscription;25;COLOMBES;92025;26337;13144;13193;209;12984;HALEM Taoufik;M;HALEM;Taoufik;VEC;271
Législatives 2012 - 1er tour;Législatives;2012;1;3;3ème circonscription;26;COURBEVOIE;92026;42456;16939;25517;317;25200;NATUREL Adélaïde;F;NATUREL;Adélaïde;FG;610
Législatives 2012 - 1er tour;Législatives;2012;1;3;3ème circonscription;35;LA GARENNE COLOMBES;92035;17314;7036;10278;79;10199;DENIAU Floriane;F;DENIAU;Floriane;FN;739
Législatives 2012 - 1er tour;Législatives;2012;1;11;11ème circonscription;46;MALAKOFF;92046;18858;7608;11250;119;11131;JACQUES Alain;M;JACQUES;Alain;EXG;44
Législatives 2012 - 1er tour;Législatives;2012;1;8;8ème circonscription;47;MARNES LA COQUETTE;92047;1085;330;755;2;753;LIME-BIFFE Catherine;F;LIME-BIFFE;Catherine;SOC;105
Législatives 2012 - 1er tour;Législatives;2012;1;10;10ème circonscription;48;MEUDON;92048;5576;2083;3493;26;3467;GAMBIEZ Fabienne;F;GAMBIEZ;Fabienne;CEN;157
Législatives 2012 - 1er tour;Législatives;2012;1;7;7ème circonscription;64;SAINT CLOUD;92064;19029;7431;11598;97;11501;JEANMAIRE François;M;JEANMAIRE;François;DVD;635
Législatives 2012 - 1er tour;Législatives;2012;1;13;13ème circonscription;71;SCEAUX;92071;14395;5253;9142;70;9072;LANDFRIED Julien;M;LANDFRIED;Julien;DVG;2775
Législatives 2012 - 1er tour;Législatives;2012;1;8;8ème circonscription;72;SEVRES;92072;14861;5785;9076;101;8975;LIME-BIFFE Catherine;F;LIME-BIFFE;Catherine;SOC;3163
Législatives 2012 - 1er tour;Législatives;2012;1;8;8ème circonscription;72;SEVRES;92072;14861;5785;9076;101;8975;LE BAUT Anne;F;LE BAUT;Anne;FN;569
Législatives 2002 - 1er tour;Législatives;2002;1;12;12ème circonscription;23;CLAMART;92023;32916;11487;21429;154;21275;DELVITTO Denis;M;DELVITTO;Denis;DIV;0
Législatives 2017 - 1er tour;Législatives;2017;1;1;1ère circonscription;36;GENNEVILLIERS;92036;22174;13223;8951;243;8708;DJELLAB Nora;F;DJELLAB;Nora;DVD;37
Législatives 2017 - 1er tour;Législatives;2017;1;6;6ème circonscription;26;COURBEVOIE;92026;8107;4228;3879;107;3772;LANDOWSKI Sophie;F;LANDOWSKI;Sophie;DIV;34
Législatives 2017 - 1er tour;Législatives;2017;1;7;7ème circonscription;33;GARCHES;92033;12777;5514;7263;115;7148;NGUYEN Maryline;F;NGUYEN;Maryline;COM;46
Législatives 2017 - 1er tour;Législatives;2017;1;7;7ème circonscription;33;GARCHES;92033;12777;5514;7263;115;7148;LECART Jérôme;M;LECART;Jérôme;DIV;70
Législatives 2017 - 1er tour;Législatives;2017;1;4;4ème circonscription;50;NANTERRE;92050;47651;26455;21196;432;20764;FLORENNES Isabelle;F;FLORENNES;Isabelle;REM;7564
Législatives 2017 - 1er tour;Législatives;2017;1;3;3ème circonscription;26;COURBEVOIE;92026;44322;19890;24432;415;24017;DENIAU Floriane;F;DENIAU;Floriane;FN;1013
Législatives 2017 - 1er tour;Législatives;2017;1;10;10ème circonscription;75;VANVES;92075;18507;7626;10881;125;10756;VIGNON Anne-Violaine;F;VIGNON;Anne-Violaine;DVD;105
Législatives 2017 - 1er tour;Législatives;2017;1;11;11ème circonscription;46;MALAKOFF;92046;18448;8148;10300;133;10167;LEMÉTAIS François;M;LEMÉTAIS;François;DIV;101
Législatives 2017 - 1er tour;Législatives;2017;1;12;12ème circonscription;32;FONTENAY AUX ROSES;92032;16049;7756;8293;93;8200;BERNARD Yann;M;BERNARD;Yann;EXG;39
Législatives 2017 - 1er tour;Législatives;2017;1;12;12ème circonscription;32;FONTENAY AUX ROSES;92032;16049;7756;8293;93;8200;LEROY Christophe;M;LEROY;Christophe;COM;151
Législatives 2017 - 1er tour;Législatives;2017;1;12;12ème circonscription;32;FONTENAY AUX ROSES;92032;16049;7756;8293;93;8200;ASCOUET Florence;F;ASCOUET;Florence;DIV;74
Législatives 2017 - 1er tour;Législatives;2017;1;12;12ème circonscription;32;FONTENAY AUX ROSES;92032;16049;7756;8293;93;8200;BOURLANGES Jean-Louis;M;BOURLANGES;Jean-Louis;MDM;3437
Législatives 2017 - 1er tour;Législatives;2017;1;12;12ème circonscription;60;LE PLESSIS ROBINSON;92060;19154;7496;11658;130;11528;CAMARA Makhtar;M;CAMARA;Makhtar;DVD;17
Législatives 2017 - 1er tour;Législatives;2017;1;13;13ème circonscription;14;BOURG LA REINE;92014;13736;5356;8380;81;8299;NICOLAS Cédric;M;NICOLAS;Cédric;DVD;166
Législatives 2017 - 1er tour;Législatives;2017;1;13;13ème circonscription;19;CHATENAY MALABRY;92019;18752;8166;10586;245;10341;DUMAS Frédérique;F;DUMAS;Frédérique;REM;4101
Législatives 2017 - 1er tour;Législatives;2017;1;13;13ème circonscription;71;SCEAUX;92071;15078;6395;8683;84;8599;SIFFREDI Georges;M;SIFFREDI;Georges;LR;2019
Législatives 2017 - 2ème tour;Législatives;2017;2;6;6ème circonscription;51;NEUILLY SUR SEINE;92051;37215;18361;18854;874;17980;LE GRIP Constance;F;LE GRIP;Constance;LR;11343
Législatives 2017 - 1er tour;Législatives;2017;1;8;8ème circonscription;76;VAUCRESSON;92076;6187;2474;3713;42;3671;SCHNEIDER Frédéric;M;SCHNEIDER;Frédéric;DIV;6
Législatives 2017 - 1er tour;Législatives;2017;1;10;10ème circonscription;12;BOULOGNE BILLANCOURT;92012;9082;4562;4520;114;4406;AMOROZ Boris;M;AMOROZ;Boris;COM;76
Législatives 2017 - 1er tour;Législatives;2017;1;8;8ème circonscription;77;VILLE D'AVRAY;92077;7440;2857;4583;44;4539;ROURE Françoise;F;ROURE;Françoise;RDG;110
Législatives 2017 - 1er tour;Législatives;2017;1;10;10ème circonscription;12;BOULOGNE BILLANCOURT;92012;9082;4562;4520;114;4406;PUIJALON Thomas;M;PUIJALON;Thomas;SOC;178
Législatives 2017 - 1er tour;Législatives;2017;1;10;10ème circonscription;12;BOULOGNE BILLANCOURT;92012;9082;4562;4520;114;4406;COUVENT Pauline;F;COUVENT;Pauline;ECO;202
Législatives 2017 - 1er tour;Législatives;2017;1;7;7ème circonscription;63;RUEIL MALMAISON;92063;54498;24335;30163;377;29786;LAPORTE Lucia;F;LAPORTE;Lucia;FN;1337
Législatives 2017 - 1er tour;Législatives;2017;1;8;8ème circonscription;22;CHAVILLE;92022;13523;5385;8138;93;8045;CHETAILLE Romain;M;CHETAILLE;Romain;DVD;105
Législatives 2017 - 1er tour;Législatives;2017;1;8;8ème circonscription;22;CHAVILLE;92022;13523;5385;8138;93;8045;MAIRE Jacques;M;MAIRE;Jacques;REM;3876
Législatives 2017 - 1er tour;Législatives;2017;1;8;8ème circonscription;22;CHAVILLE;92022;13523;5385;8138;93;8045;BOYER Gilles;M;BOYER;Gilles;LR;1455
Législatives 2017 - 1er tour;Législatives;2017;1;1;1ère circonscription;78;VILLENEUVE LA GARENNE;92078;12445;8430;4015;143;3872;BACHELAY Alexis;M;BACHELAY;Alexis;SOC;329
Législatives 2017 - 1er tour;Législatives;2017;1;3;3ème circonscription;9;BOIS COLOMBES;92009;17921;7869;10052;437;9615;PARRY Jean-Marie;M;PARRY;Jean-Marie;EXG;23
Présidentielles 1995 - 1er tour;Présidentielles;1995;1;;;20;CHATILLON;92020;16579;4065;12514;245;12269;CHEMINADE JACQUES;M;CHEMINADE;JACQUES;;33
Présidentielles 1995 - 1er tour;Présidentielles;1995;1;;;25;COLOMBES;92025;44864;11966;32898;703;32195;LE PEN J.MARIE;M;LE PEN;J.MARIE;;4748
Présidentielles 1995 - 1er tour;Présidentielles;1995;1;;;25;COLOMBES;92025;44864;11966;32898;703;32195;JOSPIN LIONEL;M;JOSPIN;LIONEL;;7699
Présidentielles 1995 - 1er tour;Présidentielles;1995;1;;;25;COLOMBES;92025;44864;11966;32898;703;32195;VOYNET DOMINIQUE;F;VOYNET;DOMINIQUE;;1212
Présidentielles 1995 - 1er tour;Présidentielles;1995;1;;;46;MALAKOFF;92046;19489;5677;13812;258;13554;VILLIERS DE PHILIPPE;M;VILLIERS DE;PHILIPPE;;375
Présidentielles 1995 - 1er tour;Présidentielles;1995;1;;;51;NEUILLY SUR SEINE;92051;35904;7798;28106;261;27845;HUE ROBERT;M;HUE;ROBERT;;243
Présidentielles 1995 - 1er tour;Présidentielles;1995;1;;;62;PUTEAUX;92062;24192;6165;18027;379;17648;LE PEN J.MARIE;M;LE PEN;J.MARIE;;2457
Présidentielles 1995 - 1er tour;Présidentielles;1995;1;;;75;VANVES;92075;15499;3343;12156;236;11920;CHIRAC JACQUES;M;CHIRAC;JACQUES;;3084
Présidentielles 1995 - 1er tour;Présidentielles;1995;1;;;76;VAUCRESSON;92076;5529;1334;4195;65;4130;BALLADUR EDOUARD;M;BALLADUR;EDOUARD;;1192
Présidentielles 1995 - 1er tour;Présidentielles;1995;1;;;78;VILLENEUVE LA GARENNE;92078;11588;3130;8458;196;8262;CHEMINADE JACQUES;M;CHEMINADE;JACQUES;;24
Présidentielles 1995 - 2ème tour;Présidentielles;1995;2;;;46;MALAKOFF;92046;19489;5567;13922;872;13050;JOSPIN LIONEL;M;JOSPIN;LIONEL;;7488
Présidentielles 1995 - 2ème tour;Présidentielles;1995;2;;;51;NEUILLY SUR SEINE;92051;35905;5995;29910;639;29271;CHIRAC JACQUES;M;CHIRAC;JACQUES;;25139
Présidentielles 1995 - 1er tour;Présidentielles;1995;1;;;14;BOURG LA REINE;92014;12770;3430;9340;135;9205;VOYNET DOMINIQUE;F;VOYNET;DOMINIQUE;;331
Législatives 2007 - 1er tour;Législatives;2007;1;6;6ème circonscription;51;NEUILLY SUR SEINE;92051;39134;14738;24396;185;24211;LEPIDI Bernard;M;LEPIDI;Bernard;DVD;2622
Législatives 2007 - 1er tour;Législatives;2007;1;12;12ème circonscription;60;LE PLESSIS ROBINSON;92060;16776;5588;11188;123;11065;BENARD Paul;M;BENARD;Paul;EXG;24
Législatives 2007 - 1er tour;Législatives;2007;1;7;7ème circonscription;63;RUEIL MALMAISON;92063;51481;18902;32579;337;32242;BARRE Camille;F;BARRE;Camille;COM;489
Législatives 2007 - 1er tour;Législatives;2007;1;7;7ème circonscription;64;SAINT CLOUD;92064;19115;6812;12303;93;12210;PIJOAN David;M;PIJOAN;David;EXG;101
Législatives 2007 - 1er tour;Législatives;2007;1;6;6ème circonscription;62;PUTEAUX;92062;26791;8829;17962;396;17566;GRANGER Marie;M;GRANGER;Marie;DIV;0
Législatives 2007 - 1er tour;Législatives;2007;1;4;4ème circonscription;73;SURESNES;92073;24666;8949;15717;206;15511;BAUDELET Ginette;F;BAUDELET;Ginette;DIV;11
Législatives 2007 - 1er tour;Législatives;2007;1;8;8ème circonscription;76;VAUCRESSON;92076;6076;2206;3870;46;3824;LEHIDEUX Bernard;M;LEHIDEUX;Bernard;UDFD;408
Législatives 2007 - 1er tour;Législatives;2007;1;8;8ème circonscription;77;VILLE D'AVRAY;92077;7475;2429;5046;60;4986;ROY Caroline;F;ROY;Caroline;RDG;668
Législatives 2007 - 1er tour;Législatives;2007;1;8;8ème circonscription;76;VAUCRESSON;92076;6076;2206;3870;46;3824;BLANCHARD Luc;M;BLANCHARD;Luc;VEC;98
Législatives 2007 - 2ème tour;Législatives;2007;2;12;12ème circonscription;32;FONTENAY AUX ROSES;92032;15467;6190;9277;173;9104;PEMEZEC Philippe;M;PEMEZEC;Philippe;UMP;4223
Législatives 2007 - 2ème tour;Législatives;2007;2;5;5ème circonscription;44;LEVALLOIS PERRET;92044;39466;17427;22039;1112;20927;CATOIRE Gilles;M;CATOIRE;Gilles;SOC;7061
Législatives 2007 - 1er tour;Législatives;2007;1;9;9ème circonscription;12;BOULOGNE BILLANCOURT;92012;60773;22422;38351;535;37816;GABORIT Pierre;M;GABORIT;Pierre;SOC;6873
Législatives 2007 - 1er tour;Législatives;2007;1;3;3ème circonscription;9;BOIS COLOMBES;92009;16245;6561;9684;288;9396;ROYON Francine;F;ROYON;Francine;EXG;164
Législatives 2007 - 1er tour;Législatives;2007;1;1;1ère circonscription;36;GENNEVILLIERS;92036;20048;9522;10526;189;10337;SARRE Philippe;M;SARRE;Philippe;SOC;1298
Législatives 2007 - 1er tour;Législatives;2007;1;1;1ère circonscription;25;COLOMBES;92025;26192;12273;13919;366;13553;BRETON Michel;M;BRETON;Michel;EXG;99
Législatives 2007 - 1er tour;Législatives;2007;1;1;1ère circonscription;25;COLOMBES;92025;26192;12273;13919;366;13553;GRIMAL Jean;M;GRIMAL;Jean;EXG;55
Législatives 2007 - 1er tour;Législatives;2007;1;12;12ème circonscription;32;FONTENAY AUX ROSES;92032;15468;5605;9863;84;9779;PEMEZEC Philippe;M;PEMEZEC;Philippe;UMP;3974
Législatives 2007 - 1er tour;Législatives;2007;1;7;7ème circonscription;33;GARCHES;92033;12286;4601;7685;112;7573;BITTERLIN Anne;F;BITTERLIN;Anne;ECO;60
Législatives 2007 - 1er tour;Législatives;2007;1;7;7ème circonscription;33;GARCHES;92033;12286;4601;7685;112;7573;NAERT Jeannine;F;NAERT;Jeannine;FN;237
Législatives 2007 - 1er tour;Législatives;2007;1;7;7ème circonscription;33;GARCHES;92033;12286;4601;7685;112;7573;BARRE Camille;F;BARRE;Camille;COM;69
Législatives 2007 - 1er tour;Législatives;2007;1;11;11ème circonscription;49;MONTROUGE;92049;26595;9698;16897;213;16684;BARBEROUSSE Olivier;M;BARBEROUSSE;Olivier;EXG;464
Législatives 2007 - 1er tour;Législatives;2007;1;8;8ème circonscription;48;MEUDON;92048;25427;9683;15744;202;15542;LEHIDEUX Bernard;M;LEHIDEUX;Bernard;UDFD;2373
Législatives 2007 - 1er tour;Législatives;2007;1;6;6ème circonscription;51;NEUILLY SUR SEINE;92051;39134;14738;24396;185;24211;SALIOU Valérie;F;SALIOU;Valérie;VEC;342
Législatives 2007 - 1er tour;Législatives;2007;1;4;4ème circonscription;50;NANTERRE;92050;42631;18721;23910;314;23596;FRANCOIS Jean-Michel;M;FRANCOIS;Jean-Michel;EXG;62
Législatives 2007 - 1er tour;Législatives;2007;1;4;4ème circonscription;50;NANTERRE;92050;42631;18721;23910;314;23596;BAUDELET Ginette;F;BAUDELET;Ginette;DIV;0
Législatives 2007 - 1er tour;Législatives;2007;1;8;8ème circonscription;72;SEVRES;92072;14460;5279;9181;151;9030;CYROULNIK Marie-France;F;CYROULNIK;Marie-France;EXG;127
Législatives 2007 - 1er tour;Législatives;2007;1;13;13ème circonscription;71;SCEAUX;92071;14129;4679;9450;74;9376;CANET Michèle;F;CANET;Michèle;SOC;1881
Législatives 2007 - 1er tour;Législatives;2007;1;7;7ème circonscription;64;SAINT CLOUD;92064;19115;6812;12303;93;12210;CROS André;M;CROS;André;UDFD;1304
Législatives 2007 - 1er tour;Législatives;2007;1;3;3ème circonscription;26;COURBEVOIE;92026;49151;19345;29806;541;29265;LASSERRE Jean-André;M;LASSERRE;Jean-André;SOC;5003
Législatives 2007 - 1er tour;Législatives;2007;1;1;1ère circonscription;25;COLOMBES;92025;26192;12273;13919;366;13553;LEGHMARA Leïla;F;LEGHMARA;Leïla;UDFD;1154
Présidentielles 2002 - 1er tour;Présidentielles;2002;1;;;2;ANTONY;92002;36989;11047;25942;517;25425;BOUTIN CHRISTINE;F;BOUTIN;CHRISTINE;;421
Présidentielles 2002 - 1er tour;Présidentielles;2002;1;;;4;ASNIERES SUR SEINE;92004;35702;11271;24431;515;23916;LE PEN JEAN-MARIE;M;LE PEN;JEAN-MARIE;;3303
Présidentielles 2002 - 1er tour;Présidentielles;2002;1;;;4;ASNIERES SUR SEINE;92004;35702;11271;24431;515;23916;BOUTIN CHRISTINE;F;BOUTIN;CHRISTINE;;355
Présidentielles 2002 - 1er tour;Présidentielles;2002;1;;;12;BOULOGNE BILLANCOURT;92012;57382;17570;39812;645;39167;BAYROU FRANCOIS;M;BAYROU;FRANCOIS;;4416
Présidentielles 2002 - 1er tour;Présidentielles;2002;1;;;14;BOURG LA REINE;92014;12075;3519;8556;149;8407;GLUCKSTEIN DANIEL;M;GLUCKSTEIN;DANIEL;;15
Présidentielles 2002 - 1er tour;Présidentielles;2002;1;;;23;CLAMART;92023;31130;10977;20153;427;19726;HUE ROBERT;M;HUE;ROBERT;;642
Présidentielles 2002 - 1er tour;Présidentielles;2002;1;;;24;CLICHY;92024;24491;8395;16096;399;15697;MAMERE NOEL;M;MAMERE;NOEL;;1199
Présidentielles 2002 - 1er tour;Présidentielles;2002;1;;;33;GARCHES;92033;11708;3920;7788;137;7651;LE PEN JEAN-MARIE;M;LE PEN;JEAN-MARIE;;897
Présidentielles 2002 - 1er tour;Présidentielles;2002;1;;;46;MALAKOFF;92046;17268;6020;11248;271;10977;MAMERE NOEL;M;MAMERE;NOEL;;868
Présidentielles 2002 - 1er tour;Présidentielles;2002;1;;;47;MARNES LA COQUETTE;92047;997;272;725;7;718;CHIRAC JACQUES;M;CHIRAC;JACQUES;;266
Présidentielles 2002 - 1er tour;Présidentielles;2002;1;;;48;MEUDON;92048;28283;9341;18942;321;18621;CHIRAC JACQUES;M;CHIRAC;JACQUES;;4144
Présidentielles 2002 - 1er tour;Présidentielles;2002;1;;;50;NANTERRE;92050;37590;13303;24287;669;23618;MEGRET BRUNO;M;MEGRET;BRUNO;;435
Présidentielles 2002 - 1er tour;Présidentielles;2002;1;;;50;NANTERRE;92050;37590;13303;24287;669;23618;MAMERE NOEL;M;MAMERE;NOEL;;1644
Présidentielles 2002 - 1er tour;Présidentielles;2002;1;;;50;NANTERRE;92050;37590;13303;24287;669;23618;CHEVENEMENT JEAN-PIERRE;M;CHEVENEMENT;JEAN-PIERRE;;1699
Présidentielles 2002 - 1er tour;Présidentielles;2002;1;;;51;NEUILLY SUR SEINE;92051;34066;10108;23958;309;23649;MEGRET BRUNO;M;MEGRET;BRUNO;;281
Présidentielles 2002 - 1er tour;Présidentielles;2002;1;;;60;LE PLESSIS ROBINSON;92060;14503;4736;9767;230;9537;LEPAGE CORINNE;F;LEPAGE;CORINNE;;243
Présidentielles 2002 - 1er tour;Présidentielles;2002;1;;;60;LE PLESSIS ROBINSON;92060;14503;4736;9767;230;9537;HUE ROBERT;M;HUE;ROBERT;;381
Présidentielles 2002 - 1er tour;Présidentielles;2002;1;;;63;RUEIL MALMAISON;92063;48302;17158;31144;693;30451;MADELIN ALAIN;M;MADELIN;ALAIN;;2040
Présidentielles 2002 - 1er tour;Présidentielles;2002;1;;;71;SCEAUX;92071;12917;3930;8987;154;8833;GLUCKSTEIN DANIEL;M;GLUCKSTEIN;DANIEL;;16
Présidentielles 2002 - 1er tour;Présidentielles;2002;1;;;72;SEVRES;92072;13367;4140;9227;153;9074;LE PEN JEAN-MARIE;M;LE PEN;JEAN-MARIE;;869
Présidentielles 2002 - 1er tour;Présidentielles;2002;1;;;75;VANVES;92075;15493;4648;10845;221;10624;LEPAGE CORINNE;F;LEPAGE;CORINNE;;263
Présidentielles 2002 - 1er tour;Présidentielles;2002;1;;;76;VAUCRESSON;92076;5861;2048;3813;62;3751;GLUCKSTEIN DANIEL;M;GLUCKSTEIN;DANIEL;;5
Présidentielles 2002 - 1er tour;Présidentielles;2002;1;;;76;VAUCRESSON;92076;5861;2048;3813;62;3751;CHIRAC JACQUES;M;CHIRAC;JACQUES;;1246
Présidentielles 2002 - 1er tour;Présidentielles;2002;1;;;78;VILLENEUVE LA GARENNE;92078;11406;4746;6660;180;6480;BAYROU FRANCOIS;M;BAYROU;FRANCOIS;;309
Présidentielles 2012 - 1er tour;Présidentielles;2012;1;;;2;ANTONY;92002;40169;7755;32414;674;31740;CHEMINADE Jacques;M;CHEMINADE;Jacques;;101
Présidentielles 2012 - 1er tour;Présidentielles;2012;1;;;9;BOIS COLOMBES;92009;16746;3612;13134;231;12903;SARKOZY Nicolas;M;SARKOZY;Nicolas;;4717
Présidentielles 2012 - 1er tour;Présidentielles;2012;1;;;9;BOIS COLOMBES;92009;16746;3612;13134;231;12903;CHEMINADE Jacques;M;CHEMINADE;Jacques;;45
Présidentielles 2012 - 1er tour;Présidentielles;2012;1;;;12;BOULOGNE BILLANCOURT;92012;67579;13310;54269;818;53451;MÉLENCHON Jean-Luc;M;MÉLENCHON;Jean-Luc;;3319
Présidentielles 2012 - 1er tour;Présidentielles;2012;1;;;22;CHAVILLE;92022;12768;2527;10241;147;10094;ARTHAUD Nathalie;F;ARTHAUD;Nathalie;;28
Présidentielles 2012 - 1er tour;Présidentielles;2012;1;;;24;CLICHY;92024;29226;6786;22440;374;22066;CHEMINADE Jacques;M;CHEMINADE;Jacques;;57
Présidentielles 2012 - 1er tour;Présidentielles;2012;1;;;33;GARCHES;92033;12388;2501;9887;167;9720;SARKOZY Nicolas;M;SARKOZY;Nicolas;;4800
Présidentielles 2012 - 1er tour;Présidentielles;2012;1;;;36;GENNEVILLIERS;92036;20990;5264;15726;342;15384;SARKOZY Nicolas;M;SARKOZY;Nicolas;;1845
Présidentielles 2012 - 1er tour;Présidentielles;2012;1;;;46;MALAKOFF;92046;18852;4162;14690;207;14483;CHEMINADE Jacques;M;CHEMINADE;Jacques;;42
Présidentielles 2012 - 1er tour;Présidentielles;2012;1;;;47;MARNES LA COQUETTE;92047;1082;163;919;8;911;ARTHAUD Nathalie;F;ARTHAUD;Nathalie;;2
Présidentielles 2012 - 1er tour;Présidentielles;2012;1;;;48;MEUDON;92048;30572;6341;24231;318;23913;LE PEN Marine;F;LE PEN;Marine;;1974
Présidentielles 2012 - 1er tour;Présidentielles;2012;1;;;48;MEUDON;92048;30572;6341;24231;318;23913;DUPONT-AIGNAN Nicolas;M;DUPONT-AIGNAN;Nicolas;;326
Présidentielles 2012 - 1er tour;Présidentielles;2012;1;;;49;MONTROUGE;92049;27851;5527;22324;289;22035;CHEMINADE Jacques;M;CHEMINADE;Jacques;;51
Présidentielles 2012 - 1er tour;Présidentielles;2012;1;;;71;SCEAUX;92071;14355;2941;11414;118;11296;SARKOZY Nicolas;M;SARKOZY;Nicolas;;4152
Présidentielles 2012 - 1er tour;Présidentielles;2012;1;;;72;SEVRES;92072;14837;2876;11961;219;11742;HOLLANDE François;M;HOLLANDE;François;;3582
Présidentielles 2012 - 1er tour;Présidentielles;2012;1;;;73;SURESNES;92073;26458;5110;21348;425;20923;BAYROU François;M;BAYROU;François;;2430
Présidentielles 2007 - 1er tour;Présidentielles;2007;1;;;9;BOIS COLOMBES;92009;16113;2534;13579;152;13427;LE PEN Jean-Marie;M;LE PEN;Jean-Marie;;738
Présidentielles 2007 - 1er tour;Présidentielles;2007;1;;;20;CHATILLON;92020;20466;2231;18235;177;18058;BESANCENOT Olivier;M;BESANCENOT;Olivier;;494
Présidentielles 2007 - 1er tour;Présidentielles;2007;1;;;32;FONTENAY AUX ROSES;92032;15234;2027;13207;123;13084;SCHIVARDI Gérard;M;SCHIVARDI;Gérard;;39
Présidentielles 2007 - 1er tour;Présidentielles;2007;1;;;32;FONTENAY AUX ROSES;92032;15234;2027;13207;123;13084;ROYAL Ségolène;F;ROYAL;Ségolène;;4027
Présidentielles 2007 - 1er tour;Présidentielles;2007;1;;;33;GARCHES;92033;11957;1346;10611;106;10505;de VILLIERS Philippe;M;de VILLIERS;Philippe;;167
Présidentielles 2007 - 1er tour;Présidentielles;2007;1;;;46;MALAKOFF;92046;18259;2640;15619;178;15441;ROYAL Ségolène;F;ROYAL;Ségolène;;5333
Présidentielles 2007 - 1er tour;Présidentielles;2007;1;;;48;MEUDON;92048;29936;4129;25807;223;25584;NIHOUS Frédéric;M;NIHOUS;Frédéric;;77
Présidentielles 2007 - 1er tour;Présidentielles;2007;1;;;49;MONTROUGE;92049;26299;3093;23206;219;22987;NIHOUS Frédéric;M;NIHOUS;Frédéric;;57
Présidentielles 2007 - 1er tour;Présidentielles;2007;1;;;60;LE PLESSIS ROBINSON;92060;16571;1989;14582;159;14423;LAGUILLER Arlette;F;LAGUILLER;Arlette;;99
Présidentielles 2007 - 1er tour;Présidentielles;2007;1;;;60;LE PLESSIS ROBINSON;92060;16571;1989;14582;159;14423;SARKOZY Nicolas;M;SARKOZY;Nicolas;;5346
Présidentielles 2007 - 1er tour;Présidentielles;2007;1;;;62;PUTEAUX;92062;26761;3397;23364;263;23101;BOVÉ José;M;BOVÉ;José;;188
Présidentielles 2007 - 1er tour;Présidentielles;2007;1;;;71;SCEAUX;92071;13824;1539;12285;86;12199;BESANCENOT Olivier;M;BESANCENOT;Olivier;;168
Présidentielles 2007 - 1er tour;Présidentielles;2007;1;;;72;SEVRES;92072;14178;1738;12440;129;12311;NIHOUS Frédéric;M;NIHOUS;Frédéric;;29
Présidentielles 2007 - 1er tour;Présidentielles;2007;1;;;78;VILLENEUVE LA GARENNE;92078;12897;2898;9999;145;9854;ROYAL Ségolène;F;ROYAL;Ségolène;;3643
Présidentielles 2017 - 1er tour;Présidentielles;2017;1;;;20;CHATILLON;92020;22292;3682;18610;351;18259;CHEMINADE Jacques;M;CHEMINADE;Jacques;;36
Présidentielles 2017 - 1er tour;Présidentielles;2017;1;;;20;CHATILLON;92020;22292;3682;18610;351;18259;POUTOU Philippe;M;POUTOU;Philippe;;106
Présidentielles 2017 - 1er tour;Présidentielles;2017;1;;;23;CLAMART;92023;35291;6330;28961;560;28401;LE PEN Marine;F;LE PEN;Marine;;2598
Présidentielles 2017 - 1er tour;Présidentielles;2017;1;;;23;CLAMART;92023;35291;6330;28961;560;28401;POUTOU Philippe;M;POUTOU;Philippe;;226
Présidentielles 2017 - 1er tour;Présidentielles;2017;1;;;32;FONTENAY AUX ROSES;92032;16036;3739;12297;218;12078;MACRON Emmanuel;M;MACRON;Emmanuel;;4193
Présidentielles 2017 - 1er tour;Présidentielles;2017;1;;;47;MARNES LA COQUETTE;92047;1215;171;1044;5;1039;ARTHAUD Nathalie;F;ARTHAUD;Nathalie;;0
Présidentielles 2017 - 1er tour;Présidentielles;2017;1;;;47;MARNES LA COQUETTE;92047;1215;171;1044;5;1039;LE PEN Marine;F;LE PEN;Marine;;50
Présidentielles 2017 - 1er tour;Présidentielles;2017;1;;;49;MONTROUGE;92049;28899;4312;24587;429;24158;ASSELINEAU François;M;ASSELINEAU;François;;231
Présidentielles 2017 - 1er tour;Présidentielles;2017;1;;;64;SAINT CLOUD;92064;19370;2628;16742;186;16556;MACRON Emmanuel;M;MACRON;Emmanuel;;5254
Présidentielles 2017 - 1er tour;Présidentielles;2017;1;;;75;VANVES;92075;18500;3228;15272;248;15024;FILLON François;M;FILLON;François;;3584
Présidentielles 2017 - 1er tour;Présidentielles;2017;1;;;75;VANVES;92075;18500;3228;15272;248;15024;HAMON Benoît;M;HAMON;Benoît;;1502
Présidentielles 2002 - 2ème tour;Présidentielles;2002;2;;;19;CHATENAY MALABRY;92019;15957;2451;13506;460;13046;LE PEN JEAN-MARIE;M;LE PEN;JEAN-MARIE;;1477
Présidentielles 2002 - 2ème tour;Présidentielles;2002;2;;;20;CHATILLON;92020;18070;3136;14934;517;14417;CHIRAC JACQUES;M;CHIRAC;JACQUES;;12767
Présidentielles 2002 - 2ème tour;Présidentielles;2002;2;;;32;FONTENAY AUX ROSES;92032;14148;2388;11760;372;11388;LE PEN JEAN-MARIE;M;LE PEN;JEAN-MARIE;;1245
Présidentielles 2007 - 2ème tour;Présidentielles;2007;2;;;23;CLAMART;92023;32581;4261;28320;1121;27199;SARKOZY Nicolas;M;SARKOZY;Nicolas;;14326
Présidentielles 2007 - 2ème tour;Présidentielles;2007;2;;;32;FONTENAY AUX ROSES;92032;15238;2269;12969;498;12471;ROYAL Ségolène;F;ROYAL;Ségolène;;6606
Présidentielles 2017 - 2ème tour;Présidentielles;2017;2;;;40;ISSY LES MOULINEAUX;92040;46803;11572;35231;3270;31961;LE PEN Marine;F;LE PEN;Marine;;4033
Présidentielles 2017 - 2ème tour;Présidentielles;2017;2;;;71;SCEAUX;92071;15052;3631;11421;934;10487;LE PEN Marine;F;LE PEN;Marine;;1158
Présidentielles 2012 - 2ème tour;Présidentielles;2012;2;;;23;CLAMART;92023;34151;5501;28650;1270;27380;SARKOZY Nicolas;M;SARKOZY;Nicolas;;12860
Présidentielles 2012 - 2ème tour;Présidentielles;2012;2;;;77;VILLE D'AVRAY;92077;7161;809;6352;228;6124;HOLLANDE François;M;HOLLANDE;François;;2116
Législatives 1997 - 2ème tour;Législatives;1997;2;11;11ème circonscription;49;MONTROUGE;92049;21975;7378;14597;719;13878;METTON J.LOUP;M;METTON;J.LOUP;UDF;7456
Législatives 1993 - 1er tour;Législatives;1993;1;13;13ème circonscription;2;ANTONY;92002;36749;10226;26523;1007;25516;DEVEDJIAN PATRICK;M;DEVEDJIAN;PATRICK;RPR;11689
Législatives 1993 - 1er tour;Législatives;1993;1;6;6ème circonscription;62;PUTEAUX;92062;23271;6636;16635;697;15938;GRANGER J.MICHEL;M;GRANGER;J.MICHEL;DVD;0
Législatives 1993 - 1er tour;Législatives;1993;1;12;12ème circonscription;20;CHATILLON;92020;15705;4455;11250;435;10815;DUMAS J.FRANCOIS;M;DUMAS;J.FRANCOIS;VEC;914
Législatives 1993 - 1er tour;Législatives;1993;1;7;7ème circonscription;33;GARCHES;92033;11440;3330;8110;328;7782;BAUMEL JACQUES;M;BAUMEL;JACQUES;RPR;4292
Législatives 1993 - 2ème tour;Législatives;1993;2;1;1ère circonscription;25;COLOMBES;92025;26587;9243;17344;988;16356;PREVOT ROGER;M;PREVOT;ROGER;UDF;7578
Législatives 1993 - 1er tour;Législatives;1993;1;13;13ème circonscription;14;BOURG LA REINE;92014;12754;4085;8669;303;8366;MERLE J.FRANCOIS;M;MERLE;J.FRANCOIS;SOC;1606
Législatives 1993 - 1er tour;Législatives;1993;1;11;11ème circonscription;7;BAGNEUX;92007;21150;7754;13396;474;12922;MACHEREY MONIQUE;F;MACHEREY;MONIQUE;GEC;1254
Législatives 1993 - 1er tour;Législatives;1993;1;12;12ème circonscription;60;LE PLESSIS ROBINSON;92060;13118;4266;8852;315;8537;BUFFET M.GEORGE;F;BUFFET;M.GEORGE;COM;1091
Législatives 1993 - 1er tour;Législatives;1993;1;11;11ème circonscription;49;MONTROUGE;92049;22632;7554;15078;554;14524;ROBERT ALAIN;M;ROBERT;ALAIN;RPR;5901
Législatives 1993 - 1er tour;Législatives;1993;1;8;8ème circonscription;76;VAUCRESSON;92076;5515;1574;3941;93;3848;JASSERAND BERNARD;M;JASSERAND;BERNARD;COM;77
Législatives 1993 - 1er tour;Législatives;1993;1;8;8ème circonscription;77;VILLE D'AVRAY;92077;7199;1786;5413;149;5264;KONOPNICKI GUY;M;KONOPNICKI;GUY;GEC;468
Législatives 1993 - 1er tour;Législatives;1993;1;8;8ème circonscription;76;VAUCRESSON;92076;5515;1574;3941;93;3848;BRISSAUD SOPHIE;F;BRISSAUD;SOPHIE;FRN;427
Législatives 1993 - 1er tour;Législatives;1993;1;8;8ème circonscription;77;VILLE D'AVRAY;92077;7199;1786;5413;149;5264;SUCHIER ANDRE;M;SUCHIER;ANDRE;DIV;121
Législatives 1993 - 1er tour;Législatives;1993;1;1;1ère circonscription;36;GENNEVILLIERS;92036;19185;6818;12367;395;11972;BRUNHES JACQUES;M;BRUNHES;JACQUES;COM;5456
Législatives 1993 - 1er tour;Législatives;1993;1;11;11ème circonscription;46;MALAKOFF;92046;19559;6951;12608;416;12192;BONELLI PIERRE;M;BONELLI;PIERRE;MAJ;171
Législatives 1993 - 1er tour;Législatives;1993;1;10;10ème circonscription;12;BOULOGNE BILLANCOURT;92012;4523;1581;2942;133;2809;WALLE JOCELYNE;F;WALLE;JOCELYNE;DIV;85
Législatives 1993 - 1er tour;Législatives;1993;1;10;10ème circonscription;48;MEUDON;92048;4225;1396;2829;92;2737;BITON MARLENE;F;BITON;MARLENE;SOC;481
Législatives 1993 - 1er tour;Législatives;1993;1;8;8ème circonscription;72;SEVRES;92072;13536;3690;9846;336;9510;NICOLAS PATRICK;M;NICOLAS;PATRICK;DVD;44
Législatives 2002 - 1er tour;Législatives;2002;1;13;13ème circonscription;2;ANTONY;92002;39807;13942;25865;456;25409;BENLOLO Martine;F;BENLOLO;Martine;EXG;124
Législatives 2002 - 1er tour;Législatives;2002;1;3;3ème circonscription;9;BOIS COLOMBES;92009;16245;6561;9684;288;9396;SOUILLART Marie-Jeanne;F;SOUILLART;Marie-Jeanne;EXD;33
Législatives 2002 - 1er tour;Législatives;2002;1;10;10ème circonscription;12;BOULOGNE BILLANCOURT;92012;5551;2367;3184;78;3106;WOUTERS Nina;F;WOUTERS;Nina;EXG;70
Législatives 2002 - 1er tour;Législatives;2002;1;13;13ème circonscription;19;CHATENAY MALABRY;92019;17835;6584;11251;211;11040;CANET Michèle;F;CANET;Michèle;SOC;3100
Législatives 2002 - 1er tour;Législatives;2002;1;13;13ème circonscription;19;CHATENAY MALABRY;92019;17835;6584;11251;211;11040;SARFATI André;M;SARFATI;André;DIV;75
Législatives 2002 - 1er tour;Législatives;2002;1;12;12ème circonscription;20;CHATILLON;92020;20661;7083;13578;137;13441;BRILLON Freddy;M;BRILLON;Freddy;DVD;50
Législatives 2002 - 1er tour;Législatives;2002;1;8;8ème circonscription;22;CHAVILLE;92022;12928;4682;8246;120;8126;CYROULNIK Marie-France;F;CYROULNIK;Marie-France;EXG;136
Législatives 2002 - 1er tour;Législatives;2002;1;12;12ème circonscription;23;CLAMART;92023;32916;11487;21429;154;21275;BRILLON Freddy;M;BRILLON;Freddy;DVD;73
Législatives 2002 - 1er tour;Législatives;2002;1;1;1ère circonscription;25;COLOMBES;92025;26192;12273;13919;366;13553;JEAN Yves;M;JEAN;Yves;DVD;26
Législatives 2002 - 1er tour;Législatives;2002;1;2;2ème circonscription;25;COLOMBES;92025;18336;7144;11192;207;10985;JOURDAN Pascal;M;JOURDAN;Pascal;ECO;132
Législatives 2002 - 1er tour;Législatives;2002;1;3;3ème circonscription;26;COURBEVOIE;92026;49151;19345;29806;541;29265;MARCEL Françoise;F;MARCEL;Françoise;EXG;119
Législatives 2002 - 1er tour;Législatives;2002;1;3;3ème circonscription;26;COURBEVOIE;92026;49151;19345;29806;541;29265;BERKOUKI Sarah;F;BERKOUKI;Sarah;DIV;113
Législatives 2002 - 1er tour;Législatives;2002;1;7;7ème circonscription;33;GARCHES;92033;12286;4601;7685;112;7573;BARRE Camille;F;BARRE;Camille;COM;69
Législatives 2002 - 1er tour;Législatives;2002;1;1;1ère circonscription;36;GENNEVILLIERS;92036;20048;9522;10526;189;10337;MOURRE Odile;F;MOURRE;Odile;EXG;41
Législatives 2002 - 1er tour;Législatives;2002;1;5;5ème circonscription;44;LEVALLOIS PERRET;92044;39466;14724;24742;404;24338;FOURNIER Alain;M;FOURNIER;Alain;VEC;558
Législatives 2002 - 1er tour;Législatives;2002;1;5;5ème circonscription;44;LEVALLOIS PERRET;92044;39466;14724;24742;404;24338;BOUAKKA Lakdar;M;BOUAKKA;Lakdar;DIV;121
Législatives 2002 - 1er tour;Législatives;2002;1;8;8ème circonscription;47;MARNES LA COQUETTE;92047;1074;316;758;5;753;GONNET Nicolas;M;GONNET;Nicolas;COM;5
Législatives 2002 - 1er tour;Législatives;2002;1;8;8ème circonscription;47;MARNES LA COQUETTE;92047;1074;316;758;5;753;GUILLET Jean-Jacques;M;GUILLET;Jean-Jacques;UMP;567
Législatives 2002 - 1er tour;Législatives;2002;1;10;10ème circonscription;48;MEUDON;92048;5066;1864;3202;29;3173;BOTTET Philippe;M;BOTTET;Philippe;EXG;15
Législatives 2002 - 1er tour;Législatives;2002;1;4;4ème circonscription;50;NANTERRE;92050;42631;18721;23910;314;23596;HOUTART Arnaud;M;HOUTART;Arnaud;MPF;66
Législatives 2002 - 1er tour;Législatives;2002;1;12;12ème circonscription;60;LE PLESSIS ROBINSON;92060;16776;5588;11188;123;11065;DIAZ GOMEZ Elisabeth;F;DIAZ GOMEZ;Elisabeth;DIV;2
Législatives 2002 - 1er tour;Législatives;2002;1;7;7ème circonscription;64;SAINT CLOUD;92064;19115;6812;12303;93;12210;PIJOAN David;M;PIJOAN;David;EXG;101
Législatives 2002 - 1er tour;Législatives;2002;1;4;4ème circonscription;73;SURESNES;92073;24666;8949;15717;206;15511;PELLET Tony;M;PELLET;Tony;EXG;107
Législatives 2002 - 1er tour;Législatives;2002;1;8;8ème circonscription;76;VAUCRESSON;92076;6076;2206;3870;46;3824;LEHIDEUX Bernard;M;LEHIDEUX;Bernard;UDFD;408
Législatives 2002 - 1er tour;Législatives;2002;1;1;1ère circonscription;78;VILLENEUVE LA GARENNE;92078;13038;7211;5827;131;5696;BRETON Michel;M;BRETON;Michel;EXG;57
Législatives 2002 - 1er tour;Législatives;2002;1;1;1ère circonscription;78;VILLENEUVE LA GARENNE;92078;13038;7211;5827;131;5696;KADUR Alexandre;M;KADUR;Alexandre;DVD;36
Législatives 1997 - 1er tour;Législatives;1997;1;3;3ème circonscription;35;LA GARENNE COLOMBES;92035;13992;5163;8829;294;8535;POULTIER LAURENT;M;POULTIER;LAURENT;DVD;221
Législatives 1997 - 1er tour;Législatives;1997;1;3;3ème circonscription;35;LA GARENNE COLOMBES;92035;13992;5163;8829;294;8535;LAIDI AMIROUCHE;M;LAIDI;AMIROUCHE;ECO;189
Législatives 1997 - 1er tour;Législatives;1997;1;1;1ère circonscription;36;GENNEVILLIERS;92036;19277;7226;12051;295;11756;BRUNHES JACQUES;M;BRUNHES;JACQUES;COM;5871
Législatives 1997 - 1er tour;Législatives;1997;1;7;7ème circonscription;33;GARCHES;92033;11323;3745;7578;290;7288;BAUMEL JACQUES;M;BAUMEL;JACQUES;RPR;3739
Législatives 1997 - 1er tour;Législatives;1997;1;13;13ème circonscription;19;CHATENAY MALABRY;92019;17859;6462;11397;367;11030;MERLE J.FRANCOIS;M;MERLE;J.FRANCOIS;SOC;3141
Législatives 1997 - 1er tour;Législatives;1997;1;13;13ème circonscription;19;CHATENAY MALABRY;92019;17859;6462;11397;367;11030;LAVAL J.MARIE;M;LAVAL;J.MARIE;DVD;290
Législatives 2002 - 1er tour;Législatives;2002;1;1;1ère circonscription;25;COLOMBES;92025;26192;12273;13919;366;13553;BRETON Michel;M;BRETON;Michel;EXG;99
Législatives 2002 - 1er tour;Législatives;2002;1;1;1ère circonscription;25;COLOMBES;92025;26192;12273;13919;366;13553;BINDER Sylvain;M;BINDER;Sylvain;DIV;44
Législatives 2002 - 1er tour;Législatives;2002;1;1;1ère circonscription;25;COLOMBES;92025;26192;12273;13919;366;13553;VIGNON Véronique;F;VIGNON;Véronique;UMP;4343
Législatives 2002 - 1er tour;Législatives;2002;1;3;3ème circonscription;26;COURBEVOIE;92026;49151;19345;29806;541;29265;CHAGNON Louis;M;CHAGNON;Louis;MPF;278
Législatives 2002 - 1er tour;Législatives;2002;1;7;7ème circonscription;33;GARCHES;92033;12286;4601;7685;112;7573;PIJOAN David;M;PIJOAN;David;EXG;68
Législatives 2002 - 1er tour;Législatives;2002;1;7;7ème circonscription;33;GARCHES;92033;12286;4601;7685;112;7573;SAGE Julien;M;SAGE;Julien;VEC;196
Législatives 2002 - 1er tour;Législatives;2002;1;1;1ère circonscription;36;GENNEVILLIERS;92036;20048;9522;10526;189;10337;BRETON Michel;M;BRETON;Michel;EXG;92
Législatives 2002 - 1er tour;Législatives;2002;1;1;1ère circonscription;36;GENNEVILLIERS;92036;20048;9522;10526;189;10337;JEAN Yves;M;JEAN;Yves;DVD;25
Législatives 2002 - 1er tour;Législatives;2002;1;11;11ème circonscription;46;MALAKOFF;92046;18478;7045;11433;204;11229;TEIXEIRA Dominique;M;TEIXEIRA;Dominique;EXG;55
Législatives 2002 - 1er tour;Législatives;2002;1;10;10ème circonscription;48;MEUDON;92048;5066;1864;3202;29;3173;WOUTERS Nina;F;WOUTERS;Nina;EXG;71
Législatives 2002 - 1er tour;Législatives;2002;1;10;10ème circonscription;48;MEUDON;92048;5066;1864;3202;29;3173;SCHMID Lucille;F;SCHMID;Lucille;SOC;752
Législatives 2002 - 1er tour;Législatives;2002;1;10;10ème circonscription;48;MEUDON;92048;5066;1864;3202;29;3173;NAVIAUX Catherine;F;NAVIAUX;Catherine;VEC;148
Législatives 2002 - 1er tour;Législatives;2002;1;11;11ème circonscription;49;MONTROUGE;92049;26595;9698;16897;213;16684;PICARD Catherine;F;PICARD;Catherine;SOC;4738
Législatives 2002 - 1er tour;Législatives;2002;1;11;11ème circonscription;49;MONTROUGE;92049;26595;9698;16897;213;16684;BONJEAN Hubert;M;BONJEAN;Hubert;FN;455
Législatives 2002 - 1er tour;Législatives;2002;1;4;4ème circonscription;50;NANTERRE;92050;42631;18721;23910;314;23596;LE ROUX Cécile;M;LE ROUX;Cécile;DIV;39
Législatives 2002 - 1er tour;Législatives;2002;1;4;4ème circonscription;50;NANTERRE;92050;42631;18721;23910;314;23596;MARINESE Vito;M;MARINESE;Vito;DIV;1
Législatives 2002 - 1er tour;Législatives;2002;1;6;6ème circonscription;51;NEUILLY SUR SEINE;92051;39134;14738;24396;185;24211;FROMANTIN Jean-Christophe;M;FROMANTIN;Jean-Christophe;DIV;3569
Législatives 2002 - 1er tour;Législatives;2002;1;4;4ème circonscription;73;SURESNES;92073;24666;8949;15717;206;15511;MARINESE Vito;M;MARINESE;Vito;DIV;0
Législatives 2002 - 1er tour;Législatives;2002;1;10;10ème circonscription;75;VANVES;92075;17351;5929;11422;137;11285;HOCINI Malek;M;HOCINI;Malek;DIV;45
Législatives 2002 - 1er tour;Législatives;2002;1;1;1ère circonscription;78;VILLENEUVE LA GARENNE;92078;13038;7211;5827;131;5696;BINDER Sylvain;M;BINDER;Sylvain;DIV;28
Législatives 1997 - 1er tour;Législatives;1997;1;2;2ème circonscription;25;COLOMBES;92025;17603;6110;11493;415;11078;MACE J.PAUL;M;MACE;J.PAUL;EXG;329
Législatives 1997 - 1er tour;Législatives;1997;1;7;7ème circonscription;64;SAINT CLOUD;92064;18908;7095;11813;417;11396;MORTIMORE STEPHANIE;F;MORTIMORE;STEPHANIE;DVD;241
Législatives 1997 - 1er tour;Législatives;1997;1;7;7ème circonscription;64;SAINT CLOUD;92064;18908;7095;11813;417;11396;TRON ROGER;M;TRON;ROGER;DVD;331
Législatives 1997 - 1er tour;Législatives;1997;1;13;13ème circonscription;71;SCEAUX;92071;13168;3887;9281;266;9015;SEXER YVES;M;SEXER;YVES;DVD;184
Législatives 1997 - 1er tour;Législatives;1997;1;2;2ème circonscription;4;ASNIERES SUR SEINE;92004;37154;13729;23425;737;22688;PIGAULT J.MARC;M;PIGAULT;J.MARC;EXG;407
Législatives 1997 - 1er tour;Législatives;1997;1;12;12ème circonscription;23;CLAMART;92023;30471;10310;20161;590;19571;SCRIVE SIMON;M;SCRIVE;SIMON;ECO;820
Législatives 1997 - 1er tour;Législatives;1997;1;8;8ème circonscription;22;CHAVILLE;92022;12268;3930;8338;262;8076;LEVAIN JEAN;M;LEVAIN;JEAN;PRS;2343
Législatives 1997 - 2ème tour;Législatives;1997;2;3;3ème circonscription;9;BOIS COLOMBES;92009;14757;4716;10041;430;9611;HABY J.YVES;M;HABY;J.YVES;UDF;1730
Législatives 1997 - 1er tour;Législatives;1997;1;8;8ème circonscription;47;MARNES LA COQUETTE;92047;985;289;696;19;677;JASSERAND BERNARD;M;JASSERAND;BERNARD;COM;14
Législatives 1997 - 1er tour;Législatives;1997;1;8;8ème circonscription;48;MEUDON;92048;24248;8136;16112;629;15483;MARKOVITCH ISABELLE;F;MARKOVITCH;ISABELLE;DVD;0
Législatives 1997 - 1er tour;Législatives;1997;1;11;11ème circonscription;46;MALAKOFF;92046;19124;7233;11891;338;11553;FAGES PATRICK;M;FAGES;PATRICK;DVD;48
Législatives 1997 - 1er tour;Législatives;1997;1;10;10ème circonscription;48;MEUDON;92048;4118;1375;2743;67;2676;LE ROY THIERRY;M;LE ROY;THIERRY;DVG;172
Législatives 1997 - 1er tour;Législatives;1997;1;11;11ème circonscription;49;MONTROUGE;92049;21975;7943;14032;388;13644;JAMBU JANINE;F;JAMBU;JANINE;COM;1676
Législatives 1997 - 1er tour;Législatives;1997;1;10;10ème circonscription;75;VANVES;92075;15446;4682;10764;329;10435;BRUNET FRANCOISE;F;BRUNET;FRANCOISE;EXG;247
Législatives 1997 - 1er tour;Législatives;1997;1;10;10ème circonscription;75;VANVES;92075;15446;4682;10764;329;10435;VIDAL ISABELLE;F;VIDAL;ISABELLE;EXG;45
Législatives 1997 - 1er tour;Législatives;1997;1;4;4ème circonscription;73;SURESNES;92073;20985;7217;13768;441;13327;KATZ AGNES;F;KATZ;AGNES;DVG;43
Législatives 2002 - 2ème tour;Législatives;2002;2;13;13ème circonscription;19;CHATENAY MALABRY;92019;16110;5574;10536;271;10265;LE NEOUANNIC PASCALE;F;LE NEOUANNIC;PASCALE;SOC;4722
Législatives 2002 - 2ème tour;Législatives;2002;2;13;13ème circonscription;19;CHATENAY MALABRY;92019;16110;5574;10536;271;10265;DEVEDJIAN PATRICK;M;DEVEDJIAN;PATRICK;UMP;5543
Législatives 2002 - 2ème tour;Législatives;2002;2;8;8ème circonscription;47;MARNES LA COQUETTE;92047;1000;305;695;30;665;GUILLET J.JACQUES;M;GUILLET;J.JACQUES;UMP;542
Législatives 1997 - 1er tour;Législatives;1997;1;3;3ème circonscription;35;LA GARENNE COLOMBES;92035;13992;5163;8829;294;8535;RONDEPIERRE GILDAS;M;RONDEPIERRE;GILDAS;DVD;6
Législatives 1997 - 2ème tour;Législatives;1997;2;1;1ère circonscription;78;VILLENEUVE LA GARENNE;92078;11471;4809;6662;598;6064;LE GALLOU J.YVES;M;LE GALLOU;J.YVES;FRN;2294
Législatives 1997 - 2ème tour;Législatives;1997;2;12;12ème circonscription;60;LE PLESSIS ROBINSON;92060;13001;3659;9342;430;8912;BUCHET PASCAL;M;BUCHET;PASCAL;SOC;4258
Législatives 1997 - 2ème tour;Législatives;1997;2;4;4ème circonscription;73;SURESNES;92073;20985;6153;14832;688;14144;FRAYSSE JACQUELINE;F;FRAYSSE;JACQUELINE;COM;5961
Législatives 1997 - 2ème tour;Législatives;1997;2;11;11ème circonscription;49;MONTROUGE;92049;21975;7378;14597;719;13878;JAMBU JANINE;F;JAMBU;JANINE;COM;6422
Législatives 1997 - 1er tour;Législatives;1997;1;3;3ème circonscription;26;COURBEVOIE;92026;35738;12354;23384;653;22731;MERRHEIM J.CHRISTOPHE;M;MERRHEIM;J.CHRISTOPHE;DIV;1
Législatives 1997 - 1er tour;Législatives;1997;1;3;3ème circonscription;35;LA GARENNE COLOMBES;92035;13992;5163;8829;294;8535;SCHWARTZ A.MARIE;F;SCHWARTZ;A.MARIE;EXG;261
Législatives 1997 - 1er tour;Législatives;1997;1;3;3ème circonscription;35;LA GARENNE COLOMBES;92035;13992;5163;8829;294;8535;LAHEURTE RENAUD;M;LAHEURTE;RENAUD;SOC;1841
Législatives 1997 - 2ème tour;Législatives;1997;2;5;5ème circonscription;24;CLICHY;92024;23725;7917;15808;893;14915;CHAZEAUX DE OLIVIER;M;CHAZEAUX DE;OLIVIER;RPR;6547
Législatives 1997 - 2ème tour;Législatives;1997;2;2;2ème circonscription;25;COLOMBES;92025;17596;5371;12225;649;11576;TAITTINGER FRANTZ;M;TAITTINGER;FRANTZ;RPR;6588
Législatives 1997 - 2ème tour;Législatives;1997;2;12;12ème circonscription;20;CHATILLON;92020;16406;4481;11925;489;11436;BUCHET PASCAL;M;BUCHET;PASCAL;SOC;5632
Législatives 1997 - 1er tour;Législatives;1997;1;5;5ème circonscription;44;LEVALLOIS PERRET;92044;28281;9315;18966;650;18316;DESMOULIN CHRISTINE;F;DESMOULIN;CHRISTINE;DVD;446
Législatives 1997 - 1er tour;Législatives;1997;1;4;4ème circonscription;50;NANTERRE;92050;38533;13799;24734;766;23968;EDORH LAWSON MARGUERITE;F;EDORH LAWSON;MARGUERITE;DVG;66
Législatives 1997 - 1er tour;Législatives;1997;1;6;6ème circonscription;51;NEUILLY SUR SEINE;92051;35571;12347;23224;570;22654;BENARD JOEL;M;BENARD;JOEL;COM;231
Législatives 1993 - 2ème tour;Législatives;1993;2;4;4ème circonscription;50;NANTERRE;92050;38008;11176;26832;1311;25521;FRAYSSE JACQUELINE;F;FRAYSSE;JACQUELINE;COM;13403
Législatives 1993 - 2ème tour;Législatives;1993;2;8;8ème circonscription;72;SEVRES;92072;13536;6610;6926;2577;4349;GUILLET J.JACQUES;M;GUILLET;J.JACQUES;RPR;4349
Législatives 1997 - 1er tour;Législatives;1997;1;11;11ème circonscription;7;BAGNEUX;92007;20284;7388;12896;374;12522;RAGOT ROGER;M;RAGOT;ROGER;DVD;313
Législatives 2012 - 2ème tour;Législatives;2012;2;8;8ème circonscription;72;SEVRES;92072;14861;6026;8835;279;8556;GUILLET Jean-Jacques;M;GUILLET;Jean-Jacques;UMP;4292
Législatives 1997 - 1er tour;Législatives;1997;1;2;2ème circonscription;4;ASNIERES SUR SEINE;92004;37154;13729;23425;737;22688;MASSOL HUBERT;M;MASSOL;HUBERT;FRN;4110
Législatives 2012 - 1er tour;Législatives;2012;1;3;3ème circonscription;26;COURBEVOIE;92026;42456;16939;25517;317;25200;EL-BOUZAIDI CHEIKHI Azedine;M;EL-BOUZAIDI CHEIKHI;Azedine;ECO;80
Législatives 2012 - 1er tour;Législatives;2012;1;3;3ème circonscription;26;COURBEVOIE;92026;42456;16939;25517;317;25200;FRATELLIA Jacques;M;FRATELLIA;Jacques;AUT;149
Législatives 2012 - 1er tour;Législatives;2012;1;6;6ème circonscription;26;COURBEVOIE;92026;8123;3742;4381;140;4241;GRANGER Marie;F;GRANGER;Marie;AUT;10
Législatives 2012 - 1er tour;Législatives;2012;1;8;8ème circonscription;47;MARNES LA COQUETTE;92047;1085;330;755;2;753;GRILLARD Jean;M;GRILLARD;Jean;AUT;2
Législatives 2012 - 1er tour;Législatives;2012;1;11;11ème circonscription;49;MONTROUGE;92049;27889;10680;17209;123;17086;SAUVANAUD Juliette;F;SAUVANAUD;Juliette;EXG;38
Législatives 2012 - 1er tour;Législatives;2012;1;6;6ème circonscription;51;NEUILLY SUR SEINE;92051;37031;14672;22359;177;22182;LEPIDI Bernard;M;LEPIDI;Bernard;DVD;4419
Législatives 2012 - 1er tour;Législatives;2012;1;6;6ème circonscription;62;PUTEAUX;92062;28253;11141;17112;441;16671;HERVE Nicole;F;HERVE;Nicole;FN;1597
Législatives 2012 - 1er tour;Législatives;2012;1;8;8ème circonscription;72;SEVRES;92072;14861;5785;9076;101;8975;HENIQUE Philippe;M;HENIQUE;Philippe;EXG;13
Législatives 2012 - 1er tour;Législatives;2012;1;8;8ème circonscription;72;SEVRES;92072;14861;5785;9076;101;8975;CANDELIER Catherine;F;CANDELIER;Catherine;VEC;503
Législatives 2012 - 1er tour;Législatives;2012;1;4;4ème circonscription;73;SURESNES;92073;26492;10723;15769;302;15467;HUNAUT Véronique;F;HUNAUT;Véronique;EXG;22
Législatives 2012 - 1er tour;Législatives;2012;1;8;8ème circonscription;76;VAUCRESSON;92076;6093;2463;3630;39;3591;MOGHIR Naïma;F;MOGHIR;Naïma;ECO;14
Législatives 2012 - 1er tour;Législatives;2012;1;1;1ère circonscription;78;VILLENEUVE LA GARENNE;92078;12349;6903;5446;131;5315;DJELLAB Nora;F;DJELLAB;Nora;UMP;763
Législatives 1997 - 1er tour;Législatives;1997;1;13;13ème circonscription;14;BOURG LA REINE;92014;12587;4431;8156;266;7890;PEURIERE GERARD;M;PEURIERE;GERARD;ECO;293
Législatives 1997 - 1er tour;Législatives;1997;1;3;3ème circonscription;35;LA GARENNE COLOMBES;92035;13992;5163;8829;294;8535;LEROY BUREL CORINNE;F;LEROY BUREL;CORINNE;ECO;410
Législatives 1997 - 1er tour;Législatives;1997;1;4;4ème circonscription;50;NANTERRE;92050;38533;13799;24734;766;23968;MARSAULT PHILIPPE;M;MARSAULT;PHILIPPE;EXG;537
Législatives 1997 - 1er tour;Législatives;1997;1;4;4ème circonscription;50;NANTERRE;92050;38533;13799;24734;766;23968;MONNOT MICHEL;M;MONNOT;MICHEL;EXG;133
Législatives 1997 - 1er tour;Législatives;1997;1;10;10ème circonscription;48;MEUDON;92048;4118;1375;2743;67;2676;SANTINI ANDRE;M;SANTINI;ANDRE;UDF;1025
Législatives 1997 - 1er tour;Législatives;1997;1;6;6ème circonscription;51;NEUILLY SUR SEINE;92051;35571;12347;23224;570;22654;VIDAL GEORGES;M;VIDAL;GEORGES;EXG;38
Législatives 1997 - 1er tour;Législatives;1997;1;7;7ème circonscription;64;SAINT CLOUD;92064;18908;7095;11813;417;11396;MUGNIER JEANNINE;F;MUGNIER;JEANNINE;EXG;163
Législatives 1997 - 1er tour;Législatives;1997;1;12;12ème circonscription;23;CLAMART;92023;30471;10310;20161;590;19571;PEMEZEC PHILIPPE;M;PEMEZEC;PHILIPPE;DVD;2686
Législatives 1997 - 1er tour;Législatives;1997;1;5;5ème circonscription;24;CLICHY;92024;23725;8942;14783;486;14297;SEMOUN J.JACQUES;M;SEMOUN;J.JACQUES;DVD;65
Législatives 1997 - 1er tour;Législatives;1997;1;10;10ème circonscription;75;VANVES;92075;15446;4682;10764;329;10435;DENIAU RAYMOND;M;DENIAU;RAYMOND;EXG;206
Législatives 1997 - 1er tour;Législatives;1997;1;8;8ème circonscription;72;SEVRES;92072;13776;4413;9363;352;9011;BRISSAUD SOPHIE;F;BRISSAUD;SOPHIE;FRN;965
Législatives 1997 - 1er tour;Législatives;1997;1;8;8ème circonscription;72;SEVRES;92072;13776;4413;9363;352;9011;LEVAIN JEAN;M;LEVAIN;JEAN;PRS;2272
Législatives 2012 - 1er tour;Législatives;2012;1;2;2ème circonscription;4;ASNIERES SUR SEINE;92004;45114;18545;26569;310;26259;PERTUS Armelle;F;PERTUS;Armelle;EXG;95
Législatives 2012 - 1er tour;Législatives;2012;1;13;13ème circonscription;14;BOURG LA REINE;92014;13305;4436;8869;87;8782;DEVEDJIAN Patrick;M;DEVEDJIAN;Patrick;UMP;3306
Législatives 2012 - 1er tour;Législatives;2012;1;13;13ème circonscription;14;BOURG LA REINE;92014;13305;4436;8869;87;8782;DE ZAYAS Marie;F;DE ZAYAS;Marie;DVD;62
Législatives 2012 - 1er tour;Législatives;2012;1;12;12ème circonscription;23;CLAMART;92023;34173;13440;20733;193;20540;BAVAY Francine;F;BAVAY;Francine;VEC;1187
Législatives 2012 - 1er tour;Législatives;2012;1;12;12ème circonscription;23;CLAMART;92023;34173;13440;20733;193;20540;DOUCET Blanche;F;DOUCET;Blanche;FN;1454
Législatives 2012 - 1er tour;Législatives;2012;1;2;2ème circonscription;25;COLOMBES;92025;18458;7115;11343;114;11229;TARRIN Jean-Michel;M;TARRIN;Jean-Michel;FG;628
Législatives 1997 - 1er tour;Législatives;1997;1;12;12ème circonscription;20;CHATILLON;92020;16406;5234;11172;367;10805;LECOMTE HERVE;M;LECOMTE;HERVE;EXG;83
Législatives 1997 - 1er tour;Législatives;1997;1;11;11ème circonscription;7;BAGNEUX;92007;20284;7388;12896;374;12522;BOURDIN YVES;M;BOURDIN;YVES;EXG;54
Législatives 1997 - 1er tour;Législatives;1997;1;8;8ème circonscription;76;VAUCRESSON;92076;5546;1861;3685;139;3546;MULLERIS KONOPNICKI A.PAULE;F;MULLERIS KONOPNICKI;A.PAULE;ECO;144
Législatives 1997 - 1er tour;Législatives;1997;1;1;1ère circonscription;78;VILLENEUVE LA GARENNE;92078;11471;4645;6826;211;6615;LOBRY MAURICE;M;LOBRY;MAURICE;SOC;1166
Législatives 2012 - 2ème tour;Législatives;2012;2;11;11ème circonscription;46;MALAKOFF;92046;18858;8508;10350;538;9812;SOMMARUGA Julie;F;SOMMARUGA;Julie;SOC;7090
Législatives 2012 - 2ème tour;Législatives;2012;2;6;6ème circonscription;62;PUTEAUX;92062;28253;11728;16525;586;15939;BRANNENS Marie;F;BRANNENS;Marie;SOC;6921
Législatives 2002 - 1er tour;Législatives;2002;1;11;11ème circonscription;7;BAGNEUX;92007;20520;8538;11982;178;11804;GALATEAU Marie-Thérèse;F;GALATEAU;Marie-Thérèse;EXD;88
Législatives 2002 - 1er tour;Législatives;2002;1;10;10ème circonscription;12;BOULOGNE BILLANCOURT;92012;5551;2367;3184;78;3106;ALEZARD Lysiane;F;ALEZARD;Lysiane;COM;104
Législatives 2002 - 1er tour;Législatives;2002;1;10;10ème circonscription;12;BOULOGNE BILLANCOURT;92012;5551;2367;3184;78;3106;GINISTY Christophe;M;GINISTY;Christophe;UDFD;304
Législatives 2002 - 1er tour;Législatives;2002;1;10;10ème circonscription;12;BOULOGNE BILLANCOURT;92012;5551;2367;3184;78;3106;TERRET Eugène;M;TERRET;Eugène;FN;91
Législatives 2002 - 1er tour;Législatives;2002;1;13;13ème circonscription;14;BOURG LA REINE;92014;13381;4391;8990;78;8912;RIEUX Françoise;F;RIEUX;Françoise;EXD;29
Législatives 2002 - 1er tour;Législatives;2002;1;12;12ème circonscription;23;CLAMART;92023;32916;11487;21429;154;21275;ANTZENBERGER Philippe;M;ANTZENBERGER;Philippe;EXG;384
Législatives 2002 - 1er tour;Législatives;2002;1;12;12ème circonscription;23;CLAMART;92023;32916;11487;21429;154;21275;DELMATTO Geneviève;F;DELMATTO;Geneviève;EXD;64
Législatives 2002 - 1er tour;Législatives;2002;1;2;2ème circonscription;25;COLOMBES;92025;18336;7144;11192;207;10985;GOISET Philippe;M;GOISET;Philippe;EXG;46
Législatives 2002 - 1er tour;Législatives;2002;1;12;12ème circonscription;32;FONTENAY AUX ROSES;92032;15468;5605;9863;84;9779;DELOM Christian;M;DELOM;Christian;UDFD;1092
Législatives 2002 - 1er tour;Législatives;2002;1;7;7ème circonscription;33;GARCHES;92033;12286;4601;7685;112;7573;CROS André;M;CROS;André;UDFD;791
Législatives 2002 - 1er tour;Législatives;2002;1;1;1ère circonscription;36;GENNEVILLIERS;92036;20048;9522;10526;189;10337;ROBERT Bertrand;M;ROBERT;Bertrand;EXD;45
Législatives 2002 - 1er tour;Législatives;2002;1;11;11ème circonscription;46;MALAKOFF;92046;18478;7045;11433;204;11229;PICARD Catherine;F;PICARD;Catherine;SOC;2441
Législatives 2002 - 1er tour;Législatives;2002;1;8;8ème circonscription;48;MEUDON;92048;25427;9683;15744;202;15542;RAFFALI Danielle;F;RAFFALI;Danielle;ECO;184
Législatives 2002 - 1er tour;Législatives;2002;1;10;10ème circonscription;48;MEUDON;92048;5066;1864;3202;29;3173;VIGUIE Laurence;F;VIGUIE;Laurence;EXG;18
Législatives 2002 - 1er tour;Législatives;2002;1;12;12ème circonscription;60;LE PLESSIS ROBINSON;92060;16776;5588;11188;123;11065;LARCHER Robert;M;LARCHER;Robert;EXG;64
Législatives 2002 - 1er tour;Législatives;2002;1;7;7ème circonscription;63;RUEIL MALMAISON;92063;51481;18902;32579;337;32242;SAGE Julien;M;SAGE;Julien;VEC;1134
Législatives 2002 - 1er tour;Législatives;2002;1;7;7ème circonscription;63;RUEIL MALMAISON;92063;51481;18902;32579;337;32242;CROS André;M;CROS;André;UDFD;3951
Législatives 2002 - 1er tour;Législatives;2002;1;7;7ème circonscription;64;SAINT CLOUD;92064;19115;6812;12303;93;12210;CHOLLOU Sylvia;F;CHOLLOU;Sylvia;DIV;0
Législatives 2002 - 1er tour;Législatives;2002;1;8;8ème circonscription;77;VILLE D'AVRAY;92077;7475;2429;5046;60;4986;RAFFALI Danielle;F;RAFFALI;Danielle;ECO;29
Législatives 2002 - 1er tour;Législatives;2002;1;1;1ère circonscription;78;VILLENEUVE LA GARENNE;92078;13038;7211;5827;131;5696;MOURRE Odile;F;MOURRE;Odile;EXG;28
Législatives 2002 - 1er tour;Législatives;2002;1;1;1ère circonscription;78;VILLENEUVE LA GARENNE;92078;13038;7211;5827;131;5696;LE GAL Anna;F;LE GAL;Anna;ECO;64
Législatives 2002 - 1er tour;Législatives;2002;1;1;1ère circonscription;78;VILLENEUVE LA GARENNE;92078;13038;7211;5827;131;5696;LEGHMARA Leïla;F;LEGHMARA;Leïla;UDFD;397
Législatives 2002 - 2ème tour;Législatives;2002;2;8;8ème circonscription;22;CHAVILLE;92022;12244;4240;8004;249;7755;LEVAIN JEAN - MARIE;M;LEVAIN;JEAN - MARIE;PRG;3508
Législatives 2002 - 2ème tour;Législatives;2002;2;8;8ème circonscription;22;CHAVILLE;92022;12244;4240;8004;249;7755;GUILLET J.JACQUES;M;GUILLET;J.JACQUES;UMP;4247
Législatives 2002 - 2ème tour;Législatives;2002;2;13;13ème circonscription;71;SCEAUX;92071;13108;4352;8756;232;8524;LE NEOUANNIC PASCALE;F;LE NEOUANNIC;PASCALE;SOC;3304
Législatives 1997 - 2ème tour;Législatives;1997;2;7;7ème circonscription;33;GARCHES;92033;26236;8908;17328;768;16560;MAULION CHRISTIANE;F;MAULION;CHRISTIANE;SOC;5393
Législatives 1997 - 1er tour;Législatives;1997;1;3;3ème circonscription;35;LA GARENNE COLOMBES;92035;13992;5163;8829;294;8535;HABANS ROGER;M;HABANS;ROGER;EXD;38
Législatives 1997 - 1er tour;Législatives;1997;1;7;7ème circonscription;33;GARCHES;92033;11323;3745;7578;290;7288;TRON ROGER;M;TRON;ROGER;DVD;250
Législatives 1997 - 1er tour;Législatives;1997;1;5;5ème circonscription;44;LEVALLOIS PERRET;92044;28281;9315;18966;650;18316;ZASLAVSKY HENRI;M;ZASLAVSKY;HENRI;DVG;40
Législatives 1997 - 1er tour;Législatives;1997;1;1;1ère circonscription;36;GENNEVILLIERS;92036;19277;7226;12051;295;11756;HAMON HENRI;M;HAMON;HENRI;DVD;43
Présidentielles 2017 - 1er tour;Présidentielles;2017;1;;;12;BOULOGNE BILLANCOURT;92012;77303;15227;62076;919;61157;LASSALLE Jean;M;LASSALLE;Jean;;292
Présidentielles 2017 - 1er tour;Présidentielles;2017;1;;;14;BOURG LA REINE;92014;13769;2202;11567;212;11355;ARTHAUD Nathalie;F;ARTHAUD;Nathalie;;27
Présidentielles 2017 - 1er tour;Présidentielles;2017;1;;;19;CHATENAY MALABRY;92019;18708;3336;15372;454;14918;MACRON Emmanuel;M;MACRON;Emmanuel;;4837
Présidentielles 2017 - 1er tour;Présidentielles;2017;1;;;24;CLICHY;92024;28553;5564;22989;498;22491;LE PEN Marine;F;LE PEN;Marine;;1841
Présidentielles 2017 - 1er tour;Présidentielles;2017;1;;;33;GARCHES;92033;12767;1975;10792;194;10598;LASSALLE Jean;M;LASSALLE;Jean;;69
Présidentielles 2017 - 1er tour;Présidentielles;2017;1;;;35;LA GARENNE COLOMBES;92035;18828;3121;15707;289;15418;MÉLENCHON Jean-Luc;M;MÉLENCHON;Jean-Luc;;2056
Présidentielles 2017 - 1er tour;Présidentielles;2017;1;;;40;ISSY LES MOULINEAUX;92040;46800;9050;37750;728;37022;CHEMINADE Jacques;M;CHEMINADE;Jacques;;66
Présidentielles 2017 - 1er tour;Présidentielles;2017;1;;;40;ISSY LES MOULINEAUX;92040;46800;9050;37750;728;37022;MACRON Emmanuel;M;MACRON;Emmanuel;;13709
Présidentielles 2017 - 1er tour;Présidentielles;2017;1;;;47;MARNES LA COQUETTE;92047;1215;171;1044;5;1039;CHEMINADE Jacques;M;CHEMINADE;Jacques;;1
Présidentielles 2017 - 1er tour;Présidentielles;2017;1;;;60;LE PLESSIS ROBINSON;92060;19141;2947;16194;344;15850;POUTOU Philippe;M;POUTOU;Philippe;;102
Présidentielles 2017 - 1er tour;Présidentielles;2017;1;;;71;SCEAUX;92071;15052;2914;12138;145;11993;FILLON François;M;FILLON;François;;3805
Présidentielles 2017 - 1er tour;Présidentielles;2017;1;;;71;SCEAUX;92071;15052;2914;12138;145;11993;MÉLENCHON Jean-Luc;M;MÉLENCHON;Jean-Luc;;1616
Présidentielles 2017 - 1er tour;Présidentielles;2017;1;;;72;SEVRES;92072;15142;2166;12976;213;12763;ASSELINEAU François;M;ASSELINEAU;François;;118
Présidentielles 2017 - 1er tour;Présidentielles;2017;1;;;72;SEVRES;92072;15142;2166;12976;213;12763;MÉLENCHON Jean-Luc;M;MÉLENCHON;Jean-Luc;;1906
Présidentielles 2017 - 1er tour;Présidentielles;2017;1;;;75;VANVES;92075;18500;3228;15272;248;15024;MÉLENCHON Jean-Luc;M;MÉLENCHON;Jean-Luc;;2841
Présidentielles 2017 - 1er tour;Présidentielles;2017;1;;;77;VILLE D'AVRAY;92077;7433;837;6596;89;6507;LE PEN Marine;F;LE PEN;Marine;;293
Présidentielles 2017 - 1er tour;Présidentielles;2017;1;;;78;VILLENEUVE LA GARENNE;92078;12429;3872;8557;315;8242;MACRON Emmanuel;M;MACRON;Emmanuel;;1924
Présidentielles 2017 - 2ème tour;Présidentielles;2017;2;;;2;ANTONY;92002;41491;8828;32663;3195;29468;MACRON Emmanuel;M;MACRON;Emmanuel;;25184
Présidentielles 2017 - 2ème tour;Présidentielles;2017;2;;;4;ASNIERES SUR SEINE;92004;48242;11098;37144;2982;34162;LE PEN Marine;F;LE PEN;Marine;;4452
Présidentielles 2017 - 2ème tour;Présidentielles;2017;2;;;19;CHATENAY MALABRY;92019;18708;4337;14371;1468;12903;MACRON Emmanuel;M;MACRON;Emmanuel;;10860
Présidentielles 2017 - 2ème tour;Présidentielles;2017;2;;;60;LE PLESSIS ROBINSON;92060;19141;4081;15060;1601;13459;MACRON Emmanuel;M;MACRON;Emmanuel;;10435
Présidentielles 2017 - 2ème tour;Présidentielles;2017;2;;;62;PUTEAUX;92062;28954;5852;23102;2162;20940;MACRON Emmanuel;M;MACRON;Emmanuel;;17285
Législatives 2007 - 1er tour;Législatives;2007;1;11;11ème circonscription;46;MALAKOFF;92046;18478;7045;11433;204;11229;TEIXEIRA Dominique;M;TEIXEIRA;Dominique;EXG;55
Législatives 2007 - 1er tour;Législatives;2007;1;11;11ème circonscription;46;MALAKOFF;92046;18478;7045;11433;204;11229;DE PABLO Carmelina;F;DE PABLO;Carmelina;VEC;465
Législatives 2007 - 1er tour;Législatives;2007;1;8;8ème circonscription;48;MEUDON;92048;25427;9683;15744;202;15542;LEGRAND Pauline;F;LEGRAND;Pauline;EXD;102
Législatives 2007 - 1er tour;Législatives;2007;1;4;4ème circonscription;50;NANTERRE;92050;42631;18721;23910;314;23596;MARDOCH Brigitte;F;MARDOCH;Brigitte;ECO;131
Législatives 2007 - 1er tour;Législatives;2007;1;4;4ème circonscription;50;NANTERRE;92050;42631;18721;23910;314;23596;ZEBDI-GHORAB Faouzia;F;ZEBDI-GHORAB;Faouzia;DIV;692
Législatives 2007 - 1er tour;Législatives;2007;1;7;7ème circonscription;63;RUEIL MALMAISON;92063;51481;18902;32579;337;32242;OLLIER Patrick;M;OLLIER;Patrick;UMP;18658
Législatives 2007 - 1er tour;Législatives;2007;1;7;7ème circonscription;63;RUEIL MALMAISON;92063;51481;18902;32579;337;32242;FARCIS Dominique;M;FARCIS;Dominique;DVD;82
Législatives 2007 - 1er tour;Législatives;2007;1;8;8ème circonscription;77;VILLE D'AVRAY;92077;7475;2429;5046;60;4986;BLANCHARD Luc;M;BLANCHARD;Luc;VEC;154
Législatives 2007 - 1er tour;Législatives;2007;1;1;1ère circonscription;78;VILLENEUVE LA GARENNE;92078;13038;7211;5827;131;5696;BEN M'BAREK Hassan;M;BEN M'BAREK;Hassan;DIV;72
Législatives 2007 - 1er tour;Législatives;2007;1;3;3ème circonscription;35;LA GARENNE COLOMBES;92035;16552;5947;10605;101;10504;DERAMBARSH Arash;M;DERAMBARSH;Arash;DVD;110
Législatives 2007 - 1er tour;Législatives;2007;1;3;3ème circonscription;35;LA GARENNE COLOMBES;92035;16552;5947;10605;101;10504;CHAGNON Louis;M;CHAGNON;Louis;MPF;117
Législatives 2007 - 1er tour;Législatives;2007;1;7;7ème circonscription;33;GARCHES;92033;12286;4601;7685;112;7573;CROS André;M;CROS;André;UDFD;791
Législatives 2007 - 1er tour;Législatives;2007;1;11;11ème circonscription;7;BAGNEUX;92007;20520;8538;11982;178;11804;AMIABLE Marie-Hélène;F;AMIABLE;Marie-Hélène;COM;4753
Législatives 2007 - 1er tour;Législatives;2007;1;11;11ème circonscription;7;BAGNEUX;92007;20520;8538;11982;178;11804;SAUVANAUD Juliette;F;SAUVANAUD;Juliette;EXG;68
Législatives 2007 - 1er tour;Législatives;2007;1;2;2ème circonscription;25;COLOMBES;92025;18336;7144;11192;207;10985;ECH-CHETOUANI Zouhairr;M;ECH-CHETOUANI;Zouhairr;DIV;32
Législatives 2007 - 1er tour;Législatives;2007;1;3;3ème circonscription;26;COURBEVOIE;92026;49151;19345;29806;541;29265;DORE Patricia;F;DORE;Patricia;ECO;258
Législatives 2007 - 1er tour;Législatives;2007;1;1;1ère circonscription;25;COLOMBES;92025;26192;12273;13919;366;13553;DENJEAN Jean-Marc;M;DENJEAN;Jean-Marc;VEC;337
Législatives 2007 - 1er tour;Législatives;2007;1;2;2ème circonscription;25;COLOMBES;92025;18336;7144;11192;207;10985;GOISET Philippe;M;GOISET;Philippe;EXG;46
Législatives 2007 - 1er tour;Législatives;2007;1;5;5ème circonscription;24;CLICHY;92024;28799;12380;16419;297;16122;DUTHEIL Daniel;M;DUTHEIL;Daniel;EXG;97
Législatives 2007 - 1er tour;Législatives;2007;1;1;1ère circonscription;36;GENNEVILLIERS;92036;20048;9522;10526;189;10337;POURDIEU Stéphanie;F;POURDIEU;Stéphanie;MAJ;22
Législatives 2007 - 1er tour;Législatives;2007;1;10;10ème circonscription;40;ISSY LES MOULINEAUX;92040;38520;14017;24503;359;24144;BINDER Sabrina;F;BINDER;Sabrina;DIV;121
Législatives 2007 - 1er tour;Législatives;2007;1;1;1ère circonscription;36;GENNEVILLIERS;92036;20048;9522;10526;189;10337;BEN M'BAREK Hassan;M;BEN M'BAREK;Hassan;DIV;247
Législatives 2007 - 1er tour;Législatives;2007;1;10;10ème circonscription;40;ISSY LES MOULINEAUX;92040;38520;14017;24503;359;24144;ARIPA Alain;M;ARIPA;Alain;MPF;218
Législatives 2007 - 1er tour;Législatives;2007;1;10;10ème circonscription;12;BOULOGNE BILLANCOURT;92012;5551;2367;3184;78;3106;VIGUIE Laurence;F;VIGUIE;Laurence;EXG;38
Présidentielles 2002 - 1er tour;Présidentielles;2002;1;;;2;ANTONY;92002;36989;11047;25942;517;25425;GLUCKSTEIN DANIEL;M;GLUCKSTEIN;DANIEL;;89
Présidentielles 2002 - 1er tour;Présidentielles;2002;1;;;4;ASNIERES SUR SEINE;92004;35702;11271;24431;515;23916;JOSPIN LIONEL;M;JOSPIN;LIONEL;;4015
Présidentielles 2002 - 1er tour;Présidentielles;2002;1;;;14;BOURG LA REINE;92014;12075;3519;8556;149;8407;BOUTIN CHRISTINE;F;BOUTIN;CHRISTINE;;164
Présidentielles 2002 - 1er tour;Présidentielles;2002;1;;;19;CHATENAY MALABRY;92019;15965;4483;11482;241;11241;BESANCENOT OLIVIER;M;BESANCENOT;OLIVIER;;431
Présidentielles 2002 - 1er tour;Présidentielles;2002;1;;;20;CHATILLON;92020;18067;5487;12580;295;12285;MEGRET BRUNO;M;MEGRET;BRUNO;;223
Présidentielles 2002 - 1er tour;Présidentielles;2002;1;;;24;CLICHY;92024;24491;8395;16096;399;15697;CHIRAC JACQUES;M;CHIRAC;JACQUES;;2710
Présidentielles 2002 - 1er tour;Présidentielles;2002;1;;;24;CLICHY;92024;24491;8395;16096;399;15697;BESANCENOT OLIVIER;M;BESANCENOT;OLIVIER;;593
Présidentielles 2002 - 1er tour;Présidentielles;2002;1;;;26;COURBEVOIE;92026;39941;11959;27982;520;27462;BAYROU FRANCOIS;M;BAYROU;FRANCOIS;;2592
Présidentielles 2002 - 1er tour;Présidentielles;2002;1;;;32;FONTENAY AUX ROSES;92032;14148;4309;9839;204;9635;MAMERE NOEL;M;MAMERE;NOEL;;573
Présidentielles 2002 - 1er tour;Présidentielles;2002;1;;;40;ISSY LES MOULINEAUX;92040;32059;9424;22635;510;22125;MEGRET BRUNO;M;MEGRET;BRUNO;;324
Présidentielles 2002 - 1er tour;Présidentielles;2002;1;;;40;ISSY LES MOULINEAUX;92040;32059;9424;22635;510;22125;JOSPIN LIONEL;M;JOSPIN;LIONEL;;4029
Présidentielles 2002 - 1er tour;Présidentielles;2002;1;;;47;MARNES LA COQUETTE;92047;997;272;725;7;718;SAINT-JOSSE JEAN;M;SAINT-JOSSE;JEAN;;7
Présidentielles 2002 - 1er tour;Présidentielles;2002;1;;;48;MEUDON;92048;28283;9341;18942;321;18621;JOSPIN LIONEL;M;JOSPIN;LIONEL;;3365
Présidentielles 2002 - 1er tour;Présidentielles;2002;1;;;49;MONTROUGE;92049;23382;8142;15240;301;14939;SAINT-JOSSE JEAN;M;SAINT-JOSSE;JEAN;;108
Présidentielles 2002 - 1er tour;Présidentielles;2002;1;;;51;NEUILLY SUR SEINE;92051;34066;10108;23958;309;23649;BESANCENOT OLIVIER;M;BESANCENOT;OLIVIER;;210
Présidentielles 2002 - 1er tour;Présidentielles;2002;1;;;60;LE PLESSIS ROBINSON;92060;14503;4736;9767;230;9537;SAINT-JOSSE JEAN;M;SAINT-JOSSE;JEAN;;97
Présidentielles 2002 - 1er tour;Présidentielles;2002;1;;;63;RUEIL MALMAISON;92063;48302;17158;31144;693;30451;BOUTIN CHRISTINE;F;BOUTIN;CHRISTINE;;521
Présidentielles 2002 - 1er tour;Présidentielles;2002;1;;;71;SCEAUX;92071;12917;3930;8987;154;8833;HUE ROBERT;M;HUE;ROBERT;;166
Présidentielles 2002 - 1er tour;Présidentielles;2002;1;;;72;SEVRES;92072;13367;4140;9227;153;9074;HUE ROBERT;M;HUE;ROBERT;;223
Présidentielles 2002 - 1er tour;Présidentielles;2002;1;;;75;VANVES;92075;15493;4648;10845;221;10624;BAYROU FRANCOIS;M;BAYROU;FRANCOIS;;1018
Présidentielles 2002 - 1er tour;Présidentielles;2002;1;;;76;VAUCRESSON;92076;5861;2048;3813;62;3751;SAINT-JOSSE JEAN;M;SAINT-JOSSE;JEAN;;32
Présidentielles 2002 - 1er tour;Présidentielles;2002;1;;;77;VILLE D'AVRAY;92077;7251;2486;4765;70;4695;BESANCENOT OLIVIER;M;BESANCENOT;OLIVIER;;75
Présidentielles 2007 - 1er tour;Présidentielles;2007;1;;;2;ANTONY;92002;39316;4695;34621;413;34208;de VILLIERS Philippe;M;de VILLIERS;Philippe;;524
Présidentielles 2007 - 1er tour;Présidentielles;2007;1;;;14;BOURG LA REINE;92014;13108;1436;11672;90;11582;SARKOZY Nicolas;M;SARKOZY;Nicolas;;4207
Présidentielles 2007 - 1er tour;Présidentielles;2007;1;;;23;CLAMART;92023;32539;3879;28660;293;28367;de VILLIERS Philippe;M;de VILLIERS;Philippe;;393
Présidentielles 2007 - 1er tour;Présidentielles;2007;1;;;23;CLAMART;92023;32539;3879;28660;293;28367;SARKOZY Nicolas;M;SARKOZY;Nicolas;;9483
Présidentielles 2007 - 1er tour;Présidentielles;2007;1;;;25;COLOMBES;92025;44025;7536;36489;501;35988;NIHOUS Frédéric;M;NIHOUS;Frédéric;;94
Présidentielles 2007 - 1er tour;Présidentielles;2007;1;;;35;LA GARENNE COLOMBES;92035;16350;1826;14524;117;14407;SCHIVARDI Gérard;M;SCHIVARDI;Gérard;;20
Présidentielles 2007 - 1er tour;Présidentielles;2007;1;;;36;GENNEVILLIERS;92036;19890;3536;16354;259;16095;BOVÉ José;M;BOVÉ;José;;266
Présidentielles 2007 - 1er tour;Présidentielles;2007;1;;;44;LEVALLOIS PERRET;92044;38708;4734;33974;296;33678;BAYROU François;M;BAYROU;François;;6863
Présidentielles 2007 - 1er tour;Présidentielles;2007;1;;;46;MALAKOFF;92046;18259;2640;15619;178;15441;BAYROU François;M;BAYROU;François;;2979
Présidentielles 2007 - 1er tour;Présidentielles;2007;1;;;49;MONTROUGE;92049;26299;3093;23206;219;22987;LAGUILLER Arlette;F;LAGUILLER;Arlette;;179
Présidentielles 2007 - 1er tour;Présidentielles;2007;1;;;50;NANTERRE;92050;42083;6117;35966;477;35489;VOYNET Dominique;F;VOYNET;Dominique;;498
Présidentielles 2007 - 1er tour;Présidentielles;2007;1;;;51;NEUILLY SUR SEINE;92051;37647;4032;33615;154;33461;BESANCENOT Olivier;M;BESANCENOT;Olivier;;158
Présidentielles 2007 - 1er tour;Présidentielles;2007;1;;;60;LE PLESSIS ROBINSON;92060;16571;1989;14582;159;14423;BESANCENOT Olivier;M;BESANCENOT;Olivier;;466
Présidentielles 2007 - 1er tour;Présidentielles;2007;1;;;62;PUTEAUX;92062;26761;3397;23364;263;23101;BUFFET Marie-George;F;BUFFET;Marie-George;;200
Présidentielles 2007 - 1er tour;Présidentielles;2007;1;;;73;SURESNES;92073;24255;2600;21655;272;21383;BUFFET Marie-George;F;BUFFET;Marie-George;;289
Présidentielles 2007 - 1er tour;Présidentielles;2007;1;;;77;VILLE D'AVRAY;92077;7253;672;6581;57;6524;BUFFET Marie-George;F;BUFFET;Marie-George;;37
Présidentielles 2007 - 1er tour;Présidentielles;2007;1;;;77;VILLE D'AVRAY;92077;7253;672;6581;57;6524;BOVÉ José;M;BOVÉ;José;;29
Présidentielles 2012 - 1er tour;Présidentielles;2012;1;;;7;BAGNEUX;92007;20608;4687;15921;281;15640;LE PEN Marine;F;LE PEN;Marine;;1682
Présidentielles 2012 - 1er tour;Présidentielles;2012;1;;;19;CHATENAY MALABRY;92019;17914;3466;14448;325;14123;CHEMINADE Jacques;M;CHEMINADE;Jacques;;40
Présidentielles 2012 - 1er tour;Présidentielles;2012;1;;;20;CHATILLON;92020;21656;4298;17358;265;17093;ARTHAUD Nathalie;F;ARTHAUD;Nathalie;;54
Présidentielles 2012 - 1er tour;Présidentielles;2012;1;;;23;CLAMART;92023;34131;6740;27391;417;26974;HOLLANDE François;M;HOLLANDE;François;;8672
Présidentielles 2012 - 1er tour;Présidentielles;2012;1;;;32;FONTENAY AUX ROSES;92032;15217;3289;11928;161;11767;POUTOU Philippe;M;POUTOU;Philippe;;113
Présidentielles 2012 - 1er tour;Présidentielles;2012;1;;;40;ISSY LES MOULINEAUX;92040;41994;9488;32506;521;31985;JOLY Eva;F;JOLY;Eva;;970
Présidentielles 2012 - 1er tour;Présidentielles;2012;1;;;49;MONTROUGE;92049;27851;5527;22324;289;22035;SARKOZY Nicolas;M;SARKOZY;Nicolas;;6023
Présidentielles 2012 - 1er tour;Présidentielles;2012;1;;;50;NANTERRE;92050;44307;10435;33872;654;33218;CHEMINADE Jacques;M;CHEMINADE;Jacques;;95
Présidentielles 2012 - 1er tour;Présidentielles;2012;1;;;76;VAUCRESSON;92076;6089;1241;4848;74;4774;ARTHAUD Nathalie;F;ARTHAUD;Nathalie;;4
Présidentielles 2012 - 1er tour;Présidentielles;2012;1;;;77;VILLE D'AVRAY;92077;7132;1060;6072;80;5992;MÉLENCHON Jean-Luc;M;MÉLENCHON;Jean-Luc;;301
Présidentielles 2012 - 1er tour;Présidentielles;2012;1;;;77;VILLE D'AVRAY;92077;7132;1060;6072;80;5992;DUPONT-AIGNAN Nicolas;M;DUPONT-AIGNAN;Nicolas;;77
Présidentielles 2012 - 1er tour;Présidentielles;2012;1;;;78;VILLENEUVE LA GARENNE;92078;12332;3328;9004;225;8779;LE PEN Marine;F;LE PEN;Marine;;1073
Présidentielles 1995 - 1er tour;Présidentielles;1995;1;;;22;CHAVILLE;92022;12177;2870;9307;170;9137;LAGUILLER ARLETTE;F;LAGUILLER;ARLETTE;;440
Présidentielles 1995 - 1er tour;Présidentielles;1995;1;;;23;CLAMART;92023;31229;8419;22810;457;22353;BALLADUR EDOUARD;M;BALLADUR;EDOUARD;;4177
Présidentielles 1995 - 1er tour;Présidentielles;1995;1;;;26;COURBEVOIE;92026;35812;8064;27748;468;27280;CHIRAC JACQUES;M;CHIRAC;JACQUES;;8003
Présidentielles 1995 - 1er tour;Présidentielles;1995;1;;;19;CHATENAY MALABRY;92019;18227;5121;13106;238;12868;HUE ROBERT;M;HUE;ROBERT;;1105
Présidentielles 1995 - 1er tour;Présidentielles;1995;1;;;12;BOULOGNE BILLANCOURT;92012;58255;14334;43921;656;43265;CHIRAC JACQUES;M;CHIRAC;JACQUES;;14300
Présidentielles 1995 - 1er tour;Présidentielles;1995;1;;;19;CHATENAY MALABRY;92019;18227;5121;13106;238;12868;JOSPIN LIONEL;M;JOSPIN;LIONEL;;3697
Présidentielles 1995 - 1er tour;Présidentielles;1995;1;;;12;BOULOGNE BILLANCOURT;92012;58255;14334;43921;656;43265;HUE ROBERT;M;HUE;ROBERT;;1863
Présidentielles 1995 - 1er tour;Présidentielles;1995;1;;;9;BOIS COLOMBES;92009;14922;3871;11051;199;10852;JOSPIN LIONEL;M;JOSPIN;LIONEL;;2355
Présidentielles 1995 - 1er tour;Présidentielles;1995;1;;;60;LE PLESSIS ROBINSON;92060;13056;3285;9771;199;9572;HUE ROBERT;M;HUE;ROBERT;;1141
Présidentielles 2012 - 2ème tour;Présidentielles;2012;2;;;7;BAGNEUX;92007;20577;4195;16382;728;15654;SARKOZY Nicolas;M;SARKOZY;Nicolas;;4496
Présidentielles 2012 - 2ème tour;Présidentielles;2012;2;;;51;NEUILLY SUR SEINE;92051;37057;4383;32674;657;32017;SARKOZY Nicolas;M;SARKOZY;Nicolas;;26959
Présidentielles 2007 - 2ème tour;Présidentielles;2007;2;;;36;GENNEVILLIERS;92036;19889;3693;16196;493;15703;SARKOZY Nicolas;M;SARKOZY;Nicolas;;4872
Présidentielles 2007 - 2ème tour;Présidentielles;2007;2;;;44;LEVALLOIS PERRET;92044;38751;5311;33440;1158;32282;ROYAL Ségolène;F;ROYAL;Ségolène;;10721
Présidentielles 2007 - 2ème tour;Présidentielles;2007;2;;;51;NEUILLY SUR SEINE;92051;37661;4241;33420;707;32713;ROYAL Ségolène;F;ROYAL;Ségolène;;4315
Présidentielles 2007 - 2ème tour;Présidentielles;2007;2;;;76;VAUCRESSON;92076;5902;815;5087;175;4912;SARKOZY Nicolas;M;SARKOZY;Nicolas;;3784
Législatives 2012 - 1er tour;Législatives;2012;1;8;8ème circonscription;22;CHAVILLE;92022;12808;4688;8120;75;8045;GUILLET Jean-Jacques;M;GUILLET;Jean-Jacques;UMP;2914
Législatives 2012 - 1er tour;Législatives;2012;1;5;5ème circonscription;24;CLICHY;92024;29276;13521;15755;274;15481;DUPONCHEL Pierre;M;DUPONCHEL;Pierre;DVD;74
Législatives 2012 - 1er tour;Législatives;2012;1;1;1ère circonscription;25;COLOMBES;92025;26337;13144;13193;209;12984;BOURDU Anne;F;BOURDU;Anne;DVD;97
Législatives 2012 - 1er tour;Législatives;2012;1;2;2ème circonscription;25;COLOMBES;92025;18458;7115;11343;114;11229;MALEYRE Alix;F;MALEYRE;Alix;DVD;76
Législatives 2012 - 1er tour;Législatives;2012;1;3;3ème circonscription;35;LA GARENNE COLOMBES;92035;17314;7036;10278;79;10199;LE GUENNIOU Anne;F;LE GUENNIOU;Anne;VEC;378
Législatives 2012 - 1er tour;Législatives;2012;1;1;1ère circonscription;36;GENNEVILLIERS;92036;20795;10523;10272;192;10080;AZIZOUDINE Yasmine;F;AZIZOUDINE;Yasmine;AUT;30
Législatives 2012 - 1er tour;Législatives;2012;1;10;10ème circonscription;40;ISSY LES MOULINEAUX;92040;42014;16484;25530;277;25253;LACOMBE Maxime;M;LACOMBE;Maxime;ECO;208
Législatives 2012 - 1er tour;Législatives;2012;1;5;5ème circonscription;44;LEVALLOIS PERRET;92044;39546;14667;24879;238;24641;LACOUR Dominique;F;LACOUR;Dominique;ECO;73
Législatives 2012 - 1er tour;Législatives;2012;1;5;5ème circonscription;44;LEVALLOIS PERRET;92044;39546;14667;24879;238;24641;MOUTONGO-BLACK Alvine;F;MOUTONGO-BLACK;Alvine;CEN;472
Législatives 2012 - 1er tour;Législatives;2012;1;11;11ème circonscription;46;MALAKOFF;92046;18858;7608;11250;119;11131;AMIABLE Marie-Hélène;F;AMIABLE;Marie-Hélène;FG;4481
Législatives 2012 - 1er tour;Législatives;2012;1;8;8ème circonscription;47;MARNES LA COQUETTE;92047;1085;330;755;2;753;MORDELET-CARRIERE Nadia;F;MORDELET-CARRIERE;Nadia;CEN;21
Législatives 2012 - 1er tour;Législatives;2012;1;8;8ème circonscription;47;MARNES LA COQUETTE;92047;1085;330;755;2;753;CHETAILLE Romain;M;CHETAILLE;Romain;DVD;74
Législatives 2012 - 1er tour;Législatives;2012;1;13;13ème circonscription;71;SCEAUX;92071;14395;5253;9142;70;9072;ROLLOT Franck;M;ROLLOT;Franck;EXG;15
Législatives 2012 - 1er tour;Législatives;2012;1;13;13ème circonscription;71;SCEAUX;92071;14395;5253;9142;70;9072;CADORET Mannone;M;CADORET;Mannone;AUT;25
Législatives 2012 - 1er tour;Législatives;2012;1;8;8ème circonscription;72;SEVRES;92072;14861;5785;9076;101;8975;BECQ Michel;M;BECQ;Michel;DVD;92
Législatives 2012 - 1er tour;Législatives;2012;1;8;8ème circonscription;72;SEVRES;92072;14861;5785;9076;101;8975;BENIERE Louise;F;BENIERE;Louise;DVD;29
Législatives 2012 - 1er tour;Législatives;2012;1;4;4ème circonscription;73;SURESNES;92073;26492;10723;15769;302;15467;SALLES Laurent;M;SALLES;Laurent;FN;1131
Législatives 2012 - 1er tour;Législatives;2012;1;8;8ème circonscription;77;VILLE D'AVRAY;92077;7169;2468;4701;48;4653;MOGHIR Naïma;F;MOGHIR;Naïma;ECO;26
Législatives 2012 - 2ème tour;Législatives;2012;2;11;11ème circonscription;7;BAGNEUX;92007;20609;10213;10396;467;9929;METTON Jean-Loup;M;METTON;Jean-Loup;NCE;2753
Législatives 2012 - 2ème tour;Législatives;2012;2;10;10ème circonscription;40;ISSY LES MOULINEAUX;92040;42014;17430;24584;568;24016;SANTINI André;M;SANTINI;André;NCE;13936
Législatives 2012 - 2ème tour;Législatives;2012;2;7;7ème circonscription;63;RUEIL MALMAISON;92063;52518;22887;29631;760;28871;ROCHERON Bertrand;M;ROCHERON;Bertrand;SOC;11662
Législatives 2012 - 2ème tour;Législatives;2012;2;7;7ème circonscription;63;RUEIL MALMAISON;92063;52518;22887;29631;760;28871;OLLIER Patrick;M;OLLIER;Patrick;UMP;17209
Législatives 2012 - 2ème tour;Législatives;2012;2;13;13ème circonscription;71;SCEAUX;92071;14395;5370;9025;208;8817;DEVEDJIAN Patrick;M;DEVEDJIAN;Patrick;UMP;4633
Législatives 2012 - 2ème tour;Législatives;2012;2;4;4ème circonscription;73;SURESNES;92073;26492;11179;15313;554;14759;DUPUY Christian;M;DUPUY;Christian;UMP;8550
Législatives 2012 - 1er tour;Législatives;2012;1;13;13ème circonscription;2;ANTONY;92002;40941;15088;25853;361;25492;DEBISSCHOP Magalie;F;DEBISSCHOP;Magalie;EXG;56
Législatives 2012 - 1er tour;Législatives;2012;1;13;13ème circonscription;2;ANTONY;92002;40941;15088;25853;361;25492;THIRIEZ Duncan;M;THIRIEZ;Duncan;AUT;152
Législatives 2012 - 1er tour;Législatives;2012;1;2;2ème circonscription;4;ASNIERES SUR SEINE;92004;45114;18545;26569;310;26259;GOISET Philippe;M;GOISET;Philippe;EXG;75
Législatives 2012 - 1er tour;Législatives;2012;1;2;2ème circonscription;4;ASNIERES SUR SEINE;92004;45114;18545;26569;310;26259;PIETRASANTA Sébastien;M;PIETRASANTA;Sébastien;SOC;10236
Législatives 2012 - 1er tour;Législatives;2012;1;12;12ème circonscription;20;CHATILLON;92020;21681;8265;13416;122;13294;LARCHER Robert;M;LARCHER;Robert;EXG;43
Législatives 1993 - 1er tour;Législatives;1993;1;12;12ème circonscription;32;FONTENAY AUX ROSES;92032;15091;4963;10128;341;9787;MOURIER J.PIERRE;M;MOURIER;J.PIERRE;DIV;131
Législatives 1993 - 1er tour;Législatives;1993;1;10;10ème circonscription;40;ISSY LES MOULINEAUX;92040;29377;9425;19952;648;19304;DENIAU RAYMOND;M;DENIAU;RAYMOND;EXG;297
Législatives 1993 - 1er tour;Législatives;1993;1;10;10ème circonscription;40;ISSY LES MOULINEAUX;92040;29377;9425;19952;648;19304;HERVO DIDIER;M;HERVO;DIDIER;VEC;1630
Législatives 1993 - 1er tour;Législatives;1993;1;3;3ème circonscription;35;LA GARENNE COLOMBES;92035;13664;4290;9374;347;9027;COUSIN GUY;M;COUSIN;GUY;DIV;133
Législatives 1993 - 1er tour;Législatives;1993;1;7;7ème circonscription;64;SAINT CLOUD;92064;19166;6250;12916;429;12487;PACOURET J.RAYMOND;M;PACOURET;J.RAYMOND;COM;274
Législatives 1993 - 1er tour;Législatives;1993;1;8;8ème circonscription;76;VAUCRESSON;92076;5515;1574;3941;93;3848;GUILLET J.JACQUES;M;GUILLET;J.JACQUES;RPR;1577
Législatives 1993 - 1er tour;Législatives;1993;1;10;10ème circonscription;75;VANVES;92075;15286;4324;10962;394;10568;WALLE JOCELYNE;F;WALLE;JOCELYNE;DIV;154
Législatives 2002 - 1er tour;Législatives;2002;1;3;3ème circonscription;9;BOIS COLOMBES;92009;16245;6561;9684;288;9396;ROYON Francine;F;ROYON;Francine;EXG;164
Législatives 2002 - 1er tour;Législatives;2002;1;9;9ème circonscription;12;BOULOGNE BILLANCOURT;92012;60773;22422;38351;535;37816;GABORIT Pierre;M;GABORIT;Pierre;SOC;6873
Législatives 2002 - 1er tour;Législatives;2002;1;13;13ème circonscription;14;BOURG LA REINE;92014;13381;4391;8990;78;8912;FONTAN Huguette;F;FONTAN;Huguette;DIV;0
Législatives 2002 - 1er tour;Législatives;2002;1;12;12ème circonscription;20;CHATILLON;92020;20661;7083;13578;137;13441;PEMEZEC Philippe;M;PEMEZEC;Philippe;UMP;6111
Législatives 2002 - 1er tour;Législatives;2002;1;5;5ème circonscription;24;CLICHY;92024;28799;12380;16419;297;16122;DUTHEIL Daniel;M;DUTHEIL;Daniel;EXG;97
Législatives 2002 - 1er tour;Législatives;2002;1;12;12ème circonscription;32;FONTENAY AUX ROSES;92032;15468;5605;9863;84;9779;ZANOLIN Ludovic;F;ZANOLIN;Ludovic;COM;417
Législatives 2002 - 1er tour;Législatives;2002;1;1;1ère circonscription;36;GENNEVILLIERS;92036;20048;9522;10526;189;10337;GUICHARD Isabelle;F;GUICHARD;Isabelle;EXG;203
Législatives 2002 - 1er tour;Législatives;2002;1;10;10ème circonscription;40;ISSY LES MOULINEAUX;92040;38520;14017;24503;359;24144;SCHMID Lucille;F;SCHMID;Lucille;SOC;5654
Législatives 2002 - 1er tour;Législatives;2002;1;8;8ème circonscription;47;MARNES LA COQUETTE;92047;1074;316;758;5;753;CYROULNIK Marie-France;F;CYROULNIK;Marie-France;EXG;2
Législatives 2002 - 1er tour;Législatives;2002;1;8;8ème circonscription;47;MARNES LA COQUETTE;92047;1074;316;758;5;753;FILLOUX Delphine;F;FILLOUX;Delphine;DIV;5
Législatives 2002 - 1er tour;Législatives;2002;1;8;8ème circonscription;48;MEUDON;92048;25427;9683;15744;202;15542;FILLOUX Delphine;F;FILLOUX;Delphine;DIV;273
Législatives 2002 - 1er tour;Législatives;2002;1;8;8ème circonscription;48;MEUDON;92048;25427;9683;15744;202;15542;LEGRAND Pauline;F;LEGRAND;Pauline;EXD;102
Législatives 2002 - 1er tour;Législatives;2002;1;11;11ème circonscription;49;MONTROUGE;92049;26595;9698;16897;213;16684;BARBEROUSSE Olivier;M;BARBEROUSSE;Olivier;EXG;464
Législatives 2002 - 1er tour;Législatives;2002;1;4;4ème circonscription;50;NANTERRE;92050;42631;18721;23910;314;23596;BAUDELET Ginette;F;BAUDELET;Ginette;DIV;0
Législatives 2002 - 1er tour;Législatives;2002;1;6;6ème circonscription;62;PUTEAUX;92062;26791;8829;17962;396;17566;CORTI Martine;F;CORTI;Martine;ECO;162
Législatives 2002 - 1er tour;Législatives;2002;1;6;6ème circonscription;62;PUTEAUX;92062;26791;8829;17962;396;17566;LEPIDI Bernard;M;LEPIDI;Bernard;DVD;657
Législatives 2002 - 1er tour;Législatives;2002;1;7;7ème circonscription;63;RUEIL MALMAISON;92063;51481;18902;32579;337;32242;CHOLLOU Sylvia;F;CHOLLOU;Sylvia;DIV;0
Législatives 2002 - 1er tour;Législatives;2002;1;7;7ème circonscription;64;SAINT CLOUD;92064;19115;6812;12303;93;12210;BARRE Camille;F;BARRE;Camille;COM;76
Législatives 2002 - 1er tour;Législatives;2002;1;8;8ème circonscription;72;SEVRES;92072;14460;5279;9181;151;9030;LUCET Francis;M;LUCET;Francis;EXG;47
Législatives 2002 - 1er tour;Législatives;2002;1;8;8ème circonscription;72;SEVRES;92072;14460;5279;9181;151;9030;RUSSO Annick;F;RUSSO;Annick;DIV;9
Législatives 2002 - 1er tour;Législatives;2002;1;8;8ème circonscription;72;SEVRES;92072;14460;5279;9181;151;9030;LEGRAND Pauline;F;LEGRAND;Pauline;EXD;47
Législatives 2002 - 1er tour;Législatives;2002;1;4;4ème circonscription;73;SURESNES;92073;24666;8949;15717;206;15511;BAUDELET Ginette;F;BAUDELET;Ginette;DIV;11
Législatives 2002 - 1er tour;Législatives;2002;1;1;1ère circonscription;78;VILLENEUVE LA GARENNE;92078;13038;7211;5827;131;5696;RABIER Marie-Cécile;F;RABIER;Marie-Cécile;FN;264
Législatives 2002 - 2ème tour;Législatives;2002;2;2;2ème circonscription;4;ASNIERES SUR SEINE;92004;35993;14675;21318;733;20585;RIERA DOMINIQUE;M;RIERA;DOMINIQUE;SOC;7088
Législatives 2002 - 2ème tour;Législatives;2002;2;13;13ème circonscription;14;BOURG LA REINE;92014;12244;4159;8085;226;7859;LE NEOUANNIC PASCALE;F;LE NEOUANNIC;PASCALE;SOC;3225
Législatives 1997 - 2ème tour;Législatives;1997;2;3;3ème circonscription;26;COURBEVOIE;92026;35738;10796;24942;758;24184;KOSSOWSKI JACQUES;M;KOSSOWSKI;JACQUES;DVD;10046
Législatives 1997 - 2ème tour;Législatives;1997;2;11;11ème circonscription;46;MALAKOFF;92046;19124;7011;12113;528;11585;METTON J.LOUP;M;METTON;J.LOUP;UDF;3984
Législatives 1997 - 2ème tour;Législatives;1997;2;10;10ème circonscription;75;VANVES;92075;15446;4123;11323;419;10904;JANVIER GUY;M;JANVIER;GUY;SOC;4977
Législatives 1997 - 1er tour;Législatives;1997;1;1;1ère circonscription;78;VILLENEUVE LA GARENNE;92078;11471;4645;6826;211;6615;LE GALLOU J.YVES;M;LE GALLOU;J.YVES;FRN;1790
Législatives 1997 - 1er tour;Législatives;1997;1;8;8ème circonscription;76;VAUCRESSON;92076;5546;1861;3685;139;3546;MARKOVITCH ISABELLE;F;MARKOVITCH;ISABELLE;DVD;13
Législatives 1997 - 1er tour;Législatives;1997;1;1;1ère circonscription;78;VILLENEUVE LA GARENNE;92078;11471;4645;6826;211;6615;ROUAT ALAIN;M;ROUAT;ALAIN;ECO;295
Législatives 1997 - 1er tour;Législatives;1997;1;8;8ème circonscription;76;VAUCRESSON;92076;5546;1861;3685;139;3546;GUILLET J.JACQUES;M;GUILLET;J.JACQUES;RPR;1928
Législatives 1993 - 2ème tour;Législatives;1993;2;13;13ème circonscription;19;CHATENAY MALABRY;92019;17809;6289;11520;705;10815;DEVEDJIAN PATRICK;M;DEVEDJIAN;PATRICK;RPR;5594
Législatives 1993 - 2ème tour;Législatives;1993;2;1;1ère circonscription;36;GENNEVILLIERS;92036;19185;6903;12282;598;11684;BRUNHES JACQUES;M;BRUNHES;JACQUES;COM;7566
Législatives 1993 - 2ème tour;Législatives;1993;2;10;10ème circonscription;75;VANVES;92075;15286;4712;10574;664;9910;BITON MARLENE;F;BITON;MARLENE;SOC;4002
Législatives 1997 - 1er tour;Législatives;1997;1;6;6ème circonscription;62;PUTEAUX;92062;24329;8862;15467;635;14832;RIBES GILBERT;M;RIBES;GILBERT;DVD;27
Législatives 1997 - 1er tour;Législatives;1997;1;13;13ème circonscription;71;SCEAUX;92071;13168;3887;9281;266;9015;ORHAN LOUIS;M;ORHAN;LOUIS;EXG;194
Législatives 1997 - 1er tour;Législatives;1997;1;8;8ème circonscription;72;SEVRES;92072;13776;4413;9363;352;9011;JASSERAND BERNARD;M;JASSERAND;BERNARD;COM;716
Législatives 1993 - 1er tour;Législatives;1993;1;13;13ème circonscription;19;CHATENAY MALABRY;92019;17809;6223;11586;435;11151;MERLE J.FRANCOIS;M;MERLE;J.FRANCOIS;SOC;2920
Législatives 1993 - 1er tour;Législatives;1993;1;10;10ème circonscription;12;BOULOGNE BILLANCOURT;92012;4523;1581;2942;133;2809;DORLIN MICHEL;M;DORLIN;MICHEL;FRN;395
Législatives 1993 - 1er tour;Législatives;1993;1;3;3ème circonscription;9;BOIS COLOMBES;92009;14392;4251;10141;422;9719;MASSOU GABRIEL;M;MASSOU;GABRIEL;COM;508
Législatives 1993 - 1er tour;Législatives;1993;1;11;11ème circonscription;7;BAGNEUX;92007;21150;7754;13396;474;12922;PIROIS LOUIS;M;PIROIS;LOUIS;EXG;189
Législatives 1993 - 1er tour;Législatives;1993;1;2;2ème circonscription;25;COLOMBES;92025;18324;5870;12454;434;12020;TRANCHANT GEORGES;M;TRANCHANT;GEORGES;RPR;3902
Législatives 1993 - 1er tour;Législatives;1993;1;1;1ère circonscription;25;COLOMBES;92025;26594;9512;17082;693;16389;MUSSAT PHILIPPE;M;MUSSAT;PHILIPPE;EXG;87
Législatives 1993 - 1er tour;Législatives;1993;1;5;5ème circonscription;24;CLICHY;92024;25172;9290;15882;514;15368;DUPREZ PAUL;M;DUPREZ;PAUL;GEC;1002
Législatives 1993 - 1er tour;Législatives;1993;1;2;2ème circonscription;25;COLOMBES;92025;18324;5870;12454;434;12020;VIDAL VINCENT;M;VIDAL;VINCENT;DVD;141
Législatives 1997 - 1er tour;Législatives;1997;1;12;12ème circonscription;20;CHATILLON;92020;16406;5234;11172;367;10805;MORILLERE DENIS;M;MORILLERE;DENIS;DIV;25
Législatives 1997 - 1er tour;Législatives;1997;1;11;11ème circonscription;49;MONTROUGE;92049;21975;7943;14032;388;13644;GARO MICHELE;F;GARO;MICHELE;EXG;99
Législatives 1997 - 1er tour;Législatives;1997;1;11;11ème circonscription;49;MONTROUGE;92049;21975;7943;14032;388;13644;RAGOT ROGER;M;RAGOT;ROGER;DVD;375
Législatives 1997 - 1er tour;Législatives;1997;1;12;12ème circonscription;23;CLAMART;92023;30471;10310;20161;590;19571;MORILLERE DENIS;M;MORILLERE;DENIS;DIV;0
Législatives 1997 - 1er tour;Législatives;1997;1;11;11ème circonscription;46;MALAKOFF;92046;19124;7233;11891;338;11553;RAGOT ROGER;M;RAGOT;ROGER;DVD;284
Législatives 1997 - 1er tour;Législatives;1997;1;4;4ème circonscription;50;NANTERRE;92050;38533;13799;24734;766;23968;THIBAULT FRANCOIS;M;THIBAULT;FRANCOIS;DVG;62
Législatives 1997 - 1er tour;Législatives;1997;1;4;4ème circonscription;50;NANTERRE;92050;38533;13799;24734;766;23968;DELUME FLAVIEN;M;DELUME;FLAVIEN;DIV;0
Législatives 1997 - 1er tour;Législatives;1997;1;10;10ème circonscription;40;ISSY LES MOULINEAUX;92040;30164;10899;19265;543;18722;CRETET PHILIPPE;M;CRETET;PHILIPPE;EXG;88
Législatives 1997 - 1er tour;Législatives;1997;1;3;3ème circonscription;9;BOIS COLOMBES;92009;14757;5447;9310;293;9017;MERRHEIM J.CHRISTOPHE;M;MERRHEIM;J.CHRISTOPHE;DIV;0
Législatives 1997 - 1er tour;Législatives;1997;1;2;2ème circonscription;4;ASNIERES SUR SEINE;92004;37154;13729;23425;737;22688;PONS GUILLAUME;M;PONS;GUILLAUME;DVD;300
Législatives 1997 - 1er tour;Législatives;1997;1;11;11ème circonscription;7;BAGNEUX;92007;20284;7388;12896;374;12522;SABATIE FRANCOISE;F;SABATIE;FRANCOISE;DVG;13
Législatives 1997 - 1er tour;Législatives;1997;1;13;13ème circonscription;2;ANTONY;92002;37772;12082;25690;861;24829;SEXER YVES;M;SEXER;YVES;DVD;422
Législatives 2017 - 1er tour;Législatives;2017;1;1;1ère circonscription;36;GENNEVILLIERS;92036;22174;13223;8951;243;8708;ANOU Tommy;M;ANOU;Tommy;FN;607
Législatives 2017 - 1er tour;Législatives;2017;1;11;11ème circonscription;49;MONTROUGE;92049;28914;12071;16843;175;16668;TAUTHUI Stéphane;M;TAUTHUI;Stéphane;DVD;17
Législatives 2017 - 1er tour;Législatives;2017;1;12;12ème circonscription;20;CHATILLON;92020;22311;9527;12784;186;12598;CANTAT Julien;M;CANTAT;Julien;DIV;94
Législatives 2017 - 1er tour;Législatives;2017;1;12;12ème circonscription;20;CHATILLON;92020;22311;9527;12784;186;12598;PEMEZEC Philippe;M;PEMEZEC;Philippe;LR;2518
Législatives 2017 - 1er tour;Législatives;2017;1;13;13ème circonscription;2;ANTONY;92002;41542;17216;24326;446;23880;DUMAS Frédérique;F;DUMAS;Frédérique;REM;11044
Législatives 2017 - 1er tour;Législatives;2017;1;13;13ème circonscription;14;BOURG LA REINE;92014;13736;5356;8380;81;8299;SIFFREDI Georges;M;SIFFREDI;Georges;LR;1733
Législatives 2017 - 1er tour;Législatives;2017;1;13;13ème circonscription;71;SCEAUX;92071;15078;6395;8683;84;8599;LAFFITE Agnès;F;LAFFITE;Agnès;FN;266
Législatives 2017 - 1er tour;Législatives;2017;1;5;5ème circonscription;24;CLICHY;92024;28620;14628;13992;265;13727;TERCHI Aïssa;M;TERCHI;Aïssa;FI;2289
Législatives 2017 - 1er tour;Législatives;2017;1;5;5ème circonscription;24;CLICHY;92024;28620;14628;13992;265;13727;DAD Hicham;M;DAD;Hicham;COM;271
Législatives 2017 - 1er tour;Législatives;2017;1;11;11ème circonscription;7;BAGNEUX;92007;21911;12424;9487;167;9320;PARAIN Philippe;M;PARAIN;Philippe;UDI;634
Législatives 2017 - 1er tour;Législatives;2017;1;9;9ème circonscription;12;BOULOGNE BILLANCOURT;92012;64984;30321;34663;987;33676;RAMARÉ Charles;M;RAMARÉ;Charles;DIV;205
Législatives 2017 - 1er tour;Législatives;2017;1;8;8ème circonscription;77;VILLE D'AVRAY;92077;7440;2857;4583;44;4539;PASQUELIN Nelly;F;PASQUELIN;Nelly;FI;201
Législatives 2017 - 1er tour;Législatives;2017;1;3;3ème circonscription;35;LA GARENNE COLOMBES;92035;18829;8238;10591;114;10477;DUMONT Eugénie;F;DUMONT;Eugénie;DIV;85
Législatives 2017 - 1er tour;Législatives;2017;1;4;4ème circonscription;50;NANTERRE;92050;47651;26455;21196;432;20764;ROBIN Joey;M;ROBIN;Joey;DIV;77
Législatives 2017 - 1er tour;Législatives;2017;1;6;6ème circonscription;26;COURBEVOIE;92026;8107;4228;3879;107;3772;ZAMECZKOWSKI Laurent;M;ZAMECZKOWSKI;Laurent;REM;1832
Législatives 2017 - 1er tour;Législatives;2017;1;5;5ème circonscription;24;CLICHY;92024;28620;14628;13992;265;13727;CALVEZ Céline;F;CALVEZ;Céline;REM;5231
Législatives 2017 - 1er tour;Législatives;2017;1;8;8ème circonscription;47;MARNES LA COQUETTE;92047;1215;451;764;4;760;PASQUELIN Nelly;F;PASQUELIN;Nelly;FI;16
Législatives 2017 - 1er tour;Législatives;2017;1;8;8ème circonscription;76;VAUCRESSON;92076;6187;2474;3713;42;3671;HÉNIQUE Philippe;M;HÉNIQUE;Philippe;EXG;11
Législatives 2017 - 1er tour;Législatives;2017;1;6;6ème circonscription;62;PUTEAUX;92062;28983;11794;17189;436;16753;LANDOWSKI Sophie;F;LANDOWSKI;Sophie;DIV;302
Législatives 2017 - 1er tour;Législatives;2017;1;6;6ème circonscription;62;PUTEAUX;92062;28983;11794;17189;436;16753;LINE Michelle;F;LINE;Michelle;ECO;148
Législatives 2017 - 1er tour;Législatives;2017;1;10;10ème circonscription;12;BOULOGNE BILLANCOURT;92012;9082;4562;4520;114;4406;VIGNON Anne-Violaine;F;VIGNON;Anne-Violaine;DVD;25
Législatives 2017 - 1er tour;Législatives;2017;1;10;10ème circonscription;40;ISSY LES MOULINEAUX;92040;45375;19009;26366;517;25849;VIGUIÉ Laurence;F;VIGUIÉ;Laurence;EXG;96
Législatives 2017 - 1er tour;Législatives;2017;1;10;10ème circonscription;48;MEUDON;92048;6009;2545;3464;38;3426;DRELON Marie-Thérèse;F;DRELON;Marie-Thérèse;DIV;40
Présidentielles 1995 - 1er tour;Présidentielles;1995;1;;;2;ANTONY;92002;37894;9274;28620;590;28030;BALLADUR EDOUARD;M;BALLADUR;EDOUARD;;5156
Présidentielles 1995 - 2ème tour;Présidentielles;1995;2;;;44;LEVALLOIS PERRET;92044;29477;5994;23483;907;22576;JOSPIN LIONEL;M;JOSPIN;LIONEL;;7948
Présidentielles 1995 - 2ème tour;Présidentielles;1995;2;;;62;PUTEAUX;92062;24192;5631;18561;941;17620;CHIRAC JACQUES;M;CHIRAC;JACQUES;;10705
Présidentielles 1995 - 1er tour;Présidentielles;1995;1;;;44;LEVALLOIS PERRET;92044;29477;6881;22596;402;22194;BALLADUR EDOUARD;M;BALLADUR;EDOUARD;;4615
Présidentielles 1995 - 1er tour;Présidentielles;1995;1;;;46;MALAKOFF;92046;19489;5677;13812;258;13554;CHEMINADE JACQUES;M;CHEMINADE;JACQUES;;18
Présidentielles 1995 - 1er tour;Présidentielles;1995;1;;;32;FONTENAY AUX ROSES;92032;14917;3559;11358;196;11162;LE PEN J.MARIE;M;LE PEN;J.MARIE;;1157
Présidentielles 1995 - 1er tour;Présidentielles;1995;1;;;24;CLICHY;92024;24688;6820;17868;364;17504;BALLADUR EDOUARD;M;BALLADUR;EDOUARD;;2340
Présidentielles 1995 - 1er tour;Présidentielles;1995;1;;;33;GARCHES;92033;11689;2941;8748;172;8576;LE PEN J.MARIE;M;LE PEN;J.MARIE;;915
Présidentielles 1995 - 1er tour;Présidentielles;1995;1;;;60;LE PLESSIS ROBINSON;92060;13056;3285;9771;199;9572;BALLADUR EDOUARD;M;BALLADUR;EDOUARD;;1426
Présidentielles 1995 - 1er tour;Présidentielles;1995;1;;;71;SCEAUX;92071;13371;3073;10298;170;10128;VILLIERS DE PHILIPPE;M;VILLIERS DE;PHILIPPE;;404
Présidentielles 1995 - 1er tour;Présidentielles;1995;1;;;19;CHATENAY MALABRY;92019;18227;5121;13106;238;12868;LE PEN J.MARIE;M;LE PEN;J.MARIE;;1379
Présidentielles 1995 - 1er tour;Présidentielles;1995;1;;;73;SURESNES;92073;21968;5851;16117;341;15776;BALLADUR EDOUARD;M;BALLADUR;EDOUARD;;2901
Présidentielles 1995 - 1er tour;Présidentielles;1995;1;;;77;VILLE D'AVRAY;92077;7139;1490;5649;74;5575;HUE ROBERT;M;HUE;ROBERT;;113
Présidentielles 2007 - 1er tour;Présidentielles;2007;1;;;4;ASNIERES SUR SEINE;92004;43605;5665;37940;436;37504;BESANCENOT Olivier;M;BESANCENOT;Olivier;;953
Présidentielles 2007 - 1er tour;Présidentielles;2007;1;;;4;ASNIERES SUR SEINE;92004;43605;5665;37940;436;37504;BOVÉ José;M;BOVÉ;José;;325
Présidentielles 2007 - 1er tour;Présidentielles;2007;1;;;4;ASNIERES SUR SEINE;92004;43605;5665;37940;436;37504;VOYNET Dominique;F;VOYNET;Dominique;;514
Présidentielles 2007 - 1er tour;Présidentielles;2007;1;;;4;ASNIERES SUR SEINE;92004;43605;5665;37940;436;37504;NIHOUS Frédéric;M;NIHOUS;Frédéric;;124
Présidentielles 2007 - 1er tour;Présidentielles;2007;1;;;7;BAGNEUX;92007;20438;2809;17629;261;17368;LAGUILLER Arlette;F;LAGUILLER;Arlette;;193
Présidentielles 2007 - 1er tour;Présidentielles;2007;1;;;14;BOURG LA REINE;92014;13108;1436;11672;90;11582;NIHOUS Frédéric;M;NIHOUS;Frédéric;;28
Présidentielles 2007 - 1er tour;Présidentielles;2007;1;;;19;CHATENAY MALABRY;92019;17598;2318;15280;229;15051;LE PEN Jean-Marie;M;LE PEN;Jean-Marie;;824
Présidentielles 2007 - 1er tour;Présidentielles;2007;1;;;22;CHAVILLE;92022;12743;1700;11043;119;10924;ROYAL Ségolène;F;ROYAL;Ségolène;;2811
Présidentielles 2007 - 1er tour;Présidentielles;2007;1;;;23;CLAMART;92023;32539;3879;28660;293;28367;BAYROU François;M;BAYROU;François;;6589
Présidentielles 2007 - 1er tour;Présidentielles;2007;1;;;25;COLOMBES;92025;44025;7536;36489;501;35988;BESANCENOT Olivier;M;BESANCENOT;Olivier;;1152
Présidentielles 2007 - 1er tour;Présidentielles;2007;1;;;25;COLOMBES;92025;44025;7536;36489;501;35988;VOYNET Dominique;F;VOYNET;Dominique;;500
Présidentielles 2007 - 1er tour;Présidentielles;2007;1;;;26;COURBEVOIE;92026;48308;7118;41190;456;40734;de VILLIERS Philippe;M;de VILLIERS;Philippe;;466
Présidentielles 2007 - 1er tour;Présidentielles;2007;1;;;33;GARCHES;92033;11957;1346;10611;106;10505;SARKOZY Nicolas;M;SARKOZY;Nicolas;;5230
Présidentielles 2007 - 1er tour;Présidentielles;2007;1;;;36;GENNEVILLIERS;92036;19890;3536;16354;259;16095;SARKOZY Nicolas;M;SARKOZY;Nicolas;;3038
Présidentielles 2007 - 1er tour;Présidentielles;2007;1;;;40;ISSY LES MOULINEAUX;92040;37966;4920;33046;365;32681;VOYNET Dominique;F;VOYNET;Dominique;;498
Présidentielles 2007 - 1er tour;Présidentielles;2007;1;;;46;MALAKOFF;92046;18259;2640;15619;178;15441;BESANCENOT Olivier;M;BESANCENOT;Olivier;;648
Présidentielles 2007 - 1er tour;Présidentielles;2007;1;;;48;MEUDON;92048;29936;4129;25807;223;25584;ROYAL Ségolène;F;ROYAL;Ségolène;;6618
Présidentielles 2007 - 1er tour;Présidentielles;2007;1;;;49;MONTROUGE;92049;26299;3093;23206;219;22987;SCHIVARDI Gérard;M;SCHIVARDI;Gérard;;57
Présidentielles 2007 - 1er tour;Présidentielles;2007;1;;;63;RUEIL MALMAISON;92063;50540;5920;44620;393;44227;ROYAL Ségolène;F;ROYAL;Ségolène;;9552
Présidentielles 2007 - 1er tour;Présidentielles;2007;1;;;77;VILLE D'AVRAY;92077;7253;672;6581;57;6524;LE PEN Jean-Marie;M;LE PEN;Jean-Marie;;237
Présidentielles 2017 - 1er tour;Présidentielles;2017;1;;;2;ANTONY;92002;41488;6486;35002;776;34226;ARTHAUD Nathalie;F;ARTHAUD;Nathalie;;119
Présidentielles 2017 - 1er tour;Présidentielles;2017;1;;;4;ASNIERES SUR SEINE;92004;48227;8578;39649;807;38842;ASSELINEAU François;M;ASSELINEAU;François;;405
Présidentielles 2017 - 1er tour;Présidentielles;2017;1;;;7;BAGNEUX;92007;21873;5369;16504;428;16076;FILLON François;M;FILLON;François;;1843
Présidentielles 2017 - 1er tour;Présidentielles;2017;1;;;9;BOIS COLOMBES;92009;17896;3242;14654;318;14336;MÉLENCHON Jean-Luc;M;MÉLENCHON;Jean-Luc;;2257
Présidentielles 2017 - 1er tour;Présidentielles;2017;1;;;12;BOULOGNE BILLANCOURT;92012;77303;15227;62076;919;61157;ARTHAUD Nathalie;F;ARTHAUD;Nathalie;;90
Présidentielles 2017 - 1er tour;Présidentielles;2017;1;;;22;CHAVILLE;92022;13493;2042;11451;183;11267;CHEMINADE Jacques;M;CHEMINADE;Jacques;;8
Présidentielles 2017 - 1er tour;Présidentielles;2017;1;;;25;COLOMBES;92025;47454;9714;37740;907;36833;LE PEN Marine;F;LE PEN;Marine;;3438
Présidentielles 2017 - 1er tour;Présidentielles;2017;1;;;35;LA GARENNE COLOMBES;92035;18828;3121;15707;289;15418;CHEMINADE Jacques;M;CHEMINADE;Jacques;;29
Présidentielles 2017 - 1er tour;Présidentielles;2017;1;;;36;GENNEVILLIERS;92036;22149;5526;16623;490;16133;CHEMINADE Jacques;M;CHEMINADE;Jacques;;21
Présidentielles 2017 - 1er tour;Présidentielles;2017;1;;;44;LEVALLOIS PERRET;92044;41716;6107;35609;511;35098;ASSELINEAU François;M;ASSELINEAU;François;;261
Présidentielles 2017 - 1er tour;Présidentielles;2017;1;;;44;LEVALLOIS PERRET;92044;41716;6107;35609;511;35098;CHEMINADE Jacques;M;CHEMINADE;Jacques;;49
Présidentielles 2017 - 1er tour;Présidentielles;2017;1;;;46;MALAKOFF;92046;18434;3186;15248;268;14979;MACRON Emmanuel;M;MACRON;Emmanuel;;4348
Présidentielles 2017 - 1er tour;Présidentielles;2017;1;;;48;MEUDON;92048;31280;5715;25565;405;25160;ASSELINEAU François;M;ASSELINEAU;François;;281
Présidentielles 2017 - 1er tour;Présidentielles;2017;1;;;49;MONTROUGE;92049;28899;4312;24587;429;24158;HAMON Benoît;M;HAMON;Benoît;;2574
Présidentielles 2017 - 1er tour;Présidentielles;2017;1;;;51;NEUILLY SUR SEINE;92051;37184;4180;33004;212;32792;FILLON François;M;FILLON;François;;21287
Présidentielles 2017 - 1er tour;Présidentielles;2017;1;;;60;LE PLESSIS ROBINSON;92060;19141;2947;16194;344;15850;ARTHAUD Nathalie;F;ARTHAUD;Nathalie;;57
Présidentielles 2017 - 1er tour;Présidentielles;2017;1;;;62;PUTEAUX;92062;28950;4530;24420;549;23871;DUPONT-AIGNAN Nicolas;M;DUPONT-AIGNAN;Nicolas;;731
Présidentielles 2017 - 1er tour;Présidentielles;2017;1;;;73;SURESNES;92073;28497;4342;24155;520;23635;POUTOU Philippe;M;POUTOU;Philippe;;124
Présidentielles 2017 - 1er tour;Présidentielles;2017;1;;;78;VILLENEUVE LA GARENNE;92078;12429;3872;8557;315;8242;HAMON Benoît;M;HAMON;Benoît;;662
Présidentielles 2017 - 1er tour;Présidentielles;2017;1;;;78;VILLENEUVE LA GARENNE;92078;12429;3872;8557;315;8242;LASSALLE Jean;M;LASSALLE;Jean;;51
Présidentielles 2012 - 1er tour;Présidentielles;2012;1;;;4;ASNIERES SUR SEINE;92004;45042;9279;35763;516;35247;POUTOU Philippe;M;POUTOU;Philippe;;244
Présidentielles 2012 - 1er tour;Présidentielles;2012;1;;;7;BAGNEUX;92007;20608;4687;15921;281;15640;SARKOZY Nicolas;M;SARKOZY;Nicolas;;2513
Présidentielles 2012 - 1er tour;Présidentielles;2012;1;;;7;BAGNEUX;92007;20608;4687;15921;281;15640;BAYROU François;M;BAYROU;François;;1069
Présidentielles 2012 - 1er tour;Présidentielles;2012;1;;;12;BOULOGNE BILLANCOURT;92012;67579;13310;54269;818;53451;LE PEN Marine;F;LE PEN;Marine;;3469
Présidentielles 2012 - 1er tour;Présidentielles;2012;1;;;14;BOURG LA REINE;92014;13300;2381;10919;132;10787;BAYROU François;M;BAYROU;François;;1424
Présidentielles 2012 - 1er tour;Présidentielles;2012;1;;;14;BOURG LA REINE;92014;13300;2381;10919;132;10787;DUPONT-AIGNAN Nicolas;M;DUPONT-AIGNAN;Nicolas;;169
Présidentielles 2012 - 1er tour;Présidentielles;2012;1;;;23;CLAMART;92023;34131;6740;27391;417;26974;ARTHAUD Nathalie;F;ARTHAUD;Nathalie;;78
Présidentielles 2012 - 1er tour;Présidentielles;2012;1;;;25;COLOMBES;92025;44741;10181;34560;526;34034;ARTHAUD Nathalie;F;ARTHAUD;Nathalie;;139
Présidentielles 2012 - 1er tour;Présidentielles;2012;1;;;32;FONTENAY AUX ROSES;92032;15217;3289;11928;161;11767;ARTHAUD Nathalie;F;ARTHAUD;Nathalie;;48
Présidentielles 2012 - 1er tour;Présidentielles;2012;1;;;32;FONTENAY AUX ROSES;92032;15217;3289;11928;161;11767;CHEMINADE Jacques;M;CHEMINADE;Jacques;;40
Présidentielles 2012 - 1er tour;Présidentielles;2012;1;;;40;ISSY LES MOULINEAUX;92040;41994;9488;32506;521;31985;MÉLENCHON Jean-Luc;M;MÉLENCHON;Jean-Luc;;2990
Présidentielles 2012 - 1er tour;Présidentielles;2012;1;;;44;LEVALLOIS PERRET;92044;39497;7296;32201;438;31763;JOLY Eva;F;JOLY;Eva;;709
Présidentielles 2012 - 1er tour;Présidentielles;2012;1;;;44;LEVALLOIS PERRET;92044;39497;7296;32201;438;31763;POUTOU Philippe;M;POUTOU;Philippe;;193
Présidentielles 2012 - 1er tour;Présidentielles;2012;1;;;48;MEUDON;92048;30572;6341;24231;318;23913;SARKOZY Nicolas;M;SARKOZY;Nicolas;;8217
Présidentielles 2012 - 1er tour;Présidentielles;2012;1;;;51;NEUILLY SUR SEINE;92051;37003;5964;31039;257;30782;DUPONT-AIGNAN Nicolas;M;DUPONT-AIGNAN;Nicolas;;255
Présidentielles 2012 - 1er tour;Présidentielles;2012;1;;;63;RUEIL MALMAISON;92063;52385;10540;41845;580;41265;HOLLANDE François;M;HOLLANDE;François;;11130
Présidentielles 2012 - 1er tour;Présidentielles;2012;1;;;71;SCEAUX;92071;14355;2941;11414;118;11296;JOLY Eva;F;JOLY;Eva;;349
Présidentielles 2012 - 1er tour;Présidentielles;2012;1;;;72;SEVRES;92072;14837;2876;11961;219;11742;LE PEN Marine;F;LE PEN;Marine;;830
Présidentielles 2012 - 1er tour;Présidentielles;2012;1;;;72;SEVRES;92072;14837;2876;11961;219;11742;CHEMINADE Jacques;M;CHEMINADE;Jacques;;46
Présidentielles 2012 - 1er tour;Présidentielles;2012;1;;;73;SURESNES;92073;26458;5110;21348;425;20923;LE PEN Marine;F;LE PEN;Marine;;1823
Présidentielles 2012 - 1er tour;Présidentielles;2012;1;;;73;SURESNES;92073;26458;5110;21348;425;20923;MÉLENCHON Jean-Luc;M;MÉLENCHON;Jean-Luc;;1898
Présidentielles 2002 - 1er tour;Présidentielles;2002;1;;;48;MEUDON;92048;28283;9341;18942;321;18621;SAINT-JOSSE JEAN;M;SAINT-JOSSE;JEAN;;120
Présidentielles 2002 - 1er tour;Présidentielles;2002;1;;;60;LE PLESSIS ROBINSON;92060;14503;4736;9767;230;9537;BAYROU FRANCOIS;M;BAYROU;FRANCOIS;;707
Présidentielles 2002 - 1er tour;Présidentielles;2002;1;;;62;PUTEAUX;92062;23861;6804;17057;487;16570;CHIRAC JACQUES;M;CHIRAC;JACQUES;;4065
Présidentielles 2002 - 1er tour;Présidentielles;2002;1;;;62;PUTEAUX;92062;23861;6804;17057;487;16570;BOUTIN CHRISTINE;F;BOUTIN;CHRISTINE;;178
Présidentielles 2002 - 1er tour;Présidentielles;2002;1;;;64;SAINT CLOUD;92064;17818;6028;11790;141;11649;HUE ROBERT;M;HUE;ROBERT;;78
Présidentielles 2002 - 1er tour;Présidentielles;2002;1;;;73;SURESNES;92073;22099;7156;14943;329;14614;MEGRET BRUNO;M;MEGRET;BRUNO;;223
Présidentielles 2002 - 1er tour;Présidentielles;2002;1;;;77;VILLE D'AVRAY;92077;7251;2486;4765;70;4695;MEGRET BRUNO;M;MEGRET;BRUNO;;66
Présidentielles 2002 - 1er tour;Présidentielles;2002;1;;;77;VILLE D'AVRAY;92077;7251;2486;4765;70;4695;BAYROU FRANCOIS;M;BAYROU;FRANCOIS;;757
Présidentielles 2002 - 1er tour;Présidentielles;2002;1;;;77;VILLE D'AVRAY;92077;7251;2486;4765;70;4695;LE PEN JEAN-MARIE;M;LE PEN;JEAN-MARIE;;366
Présidentielles 2002 - 1er tour;Présidentielles;2002;1;;;78;VILLENEUVE LA GARENNE;92078;11406;4746;6660;180;6480;GLUCKSTEIN DANIEL;M;GLUCKSTEIN;DANIEL;;25
Présidentielles 2002 - 1er tour;Présidentielles;2002;1;;;78;VILLENEUVE LA GARENNE;92078;11406;4746;6660;180;6480;TAUBIRA CHRISTIANE;F;TAUBIRA;CHRISTIANE;;443
Présidentielles 2002 - 1er tour;Présidentielles;2002;1;;;2;ANTONY;92002;36989;11047;25942;517;25425;CHIRAC JACQUES;M;CHIRAC;JACQUES;;5888
Présidentielles 2002 - 1er tour;Présidentielles;2002;1;;;4;ASNIERES SUR SEINE;92004;35702;11271;24431;515;23916;CHEVENEMENT JEAN-PIERRE;M;CHEVENEMENT;JEAN-PIERRE;;1617
Présidentielles 2002 - 1er tour;Présidentielles;2002;1;;;12;BOULOGNE BILLANCOURT;92012;57382;17570;39812;645;39167;BOUTIN CHRISTINE;F;BOUTIN;CHRISTINE;;754
Présidentielles 2002 - 1er tour;Présidentielles;2002;1;;;14;BOURG LA REINE;92014;12075;3519;8556;149;8407;LAGUILLER ARLETTE;F;LAGUILLER;ARLETTE;;230
Présidentielles 2002 - 1er tour;Présidentielles;2002;1;;;19;CHATENAY MALABRY;92019;15965;4483;11482;241;11241;TAUBIRA CHRISTIANE;F;TAUBIRA;CHRISTIANE;;572
Législatives 2017 - 1er tour;Législatives;2017;1;1;1ère circonscription;36;GENNEVILLIERS;92036;22174;13223;8951;243;8708;PIJOAN David;M;PIJOAN;David;EXG;36
Législatives 2017 - 1er tour;Législatives;2017;1;1;1ère circonscription;25;COLOMBES;92025;27867;16420;11447;405;11042;JAN Corinne;F;JAN;Corinne;EXG;12
Législatives 2017 - 1er tour;Législatives;2017;1;1;1ère circonscription;78;VILLENEUVE LA GARENNE;92078;12445;8430;4015;143;3872;BONNEFOND Olivier;M;BONNEFOND;Olivier;DVD;25
Législatives 2017 - 1er tour;Législatives;2017;1;1;1ère circonscription;78;VILLENEUVE LA GARENNE;92078;12445;8430;4015;143;3872;ARIAS Jacques;M;ARIAS;Jacques;ECO;14
Législatives 2017 - 1er tour;Législatives;2017;1;5;5ème circonscription;24;CLICHY;92024;28620;14628;13992;265;13727;DUTHEIL Daniel;M;DUTHEIL;Daniel;EXG;60
Législatives 2017 - 1er tour;Législatives;2017;1;5;5ème circonscription;24;CLICHY;92024;28620;14628;13992;265;13727;ZEGHLACHE Derradji;M;ZEGHLACHE;Derradji;ECO;26
Législatives 2017 - 1er tour;Législatives;2017;1;5;5ème circonscription;44;LEVALLOIS PERRET;92044;41751;17632;24119;255;23864;MESSATFA Lies;M;MESSATFA;Lies;SOC;1157
Législatives 2017 - 1er tour;Législatives;2017;1;6;6ème circonscription;62;PUTEAUX;92062;28983;11794;17189;436;16753;FLORIN Samuel;M;FLORIN;Samuel;FI;1384
Législatives 2017 - 1er tour;Législatives;2017;1;7;7ème circonscription;63;RUEIL MALMAISON;92063;54498;24335;30163;377;29786;ABAD Cécile;F;ABAD;Cécile;EXG;137
Législatives 2017 - 1er tour;Législatives;2017;1;8;8ème circonscription;47;MARNES LA COQUETTE;92047;1215;451;764;4;760;MAIRE Jacques;M;MAIRE;Jacques;REM;327
Législatives 2017 - 1er tour;Législatives;2017;1;8;8ème circonscription;48;MEUDON;92048;25240;11059;14181;174;14007;DUBOIS Renaud;M;DUBOIS;Renaud;ECO;790
Législatives 2017 - 1er tour;Législatives;2017;1;8;8ème circonscription;76;VAUCRESSON;92076;6187;2474;3713;42;3671;BOYER Gilles;M;BOYER;Gilles;LR;1172
Législatives 2017 - 1er tour;Législatives;2017;1;8;8ème circonscription;77;VILLE D'AVRAY;92077;7440;2857;4583;44;4539;THOMAS Marc;M;THOMAS;Marc;FN;138
Législatives 2017 - 1er tour;Législatives;2017;1;9;9ème circonscription;12;BOULOGNE BILLANCOURT;92012;64984;30321;34663;987;33676;RICARD Bruno;M;RICARD;Bruno;ECO;479
Législatives 2017 - 1er tour;Législatives;2017;1;10;10ème circonscription;40;ISSY LES MOULINEAUX;92040;45375;19009;26366;517;25849;CROS Stéphane;M;CROS;Stéphane;DIV;139
Législatives 2017 - 1er tour;Législatives;2017;1;10;10ème circonscription;48;MEUDON;92048;6009;2545;3464;38;3426;PUIJALON Thomas;M;PUIJALON;Thomas;SOC;161
Législatives 2017 - 1er tour;Législatives;2017;1;10;10ème circonscription;48;MEUDON;92048;6009;2545;3464;38;3426;SOUBELET Bertrand;M;SOUBELET;Bertrand;DIV;124
Législatives 2017 - 1er tour;Législatives;2017;1;11;11ème circonscription;7;BAGNEUX;92007;21911;12424;9487;167;9320;SOMMARUGA Julie;F;SOMMARUGA;Julie;SOC;1141
Législatives 2017 - 1er tour;Législatives;2017;1;11;11ème circonscription;49;MONTROUGE;92049;28914;12071;16843;175;16668;MARTIN Agathe;F;MARTIN;Agathe;EXG;76
Législatives 2017 - 1er tour;Législatives;2017;1;11;11ème circonscription;49;MONTROUGE;92049;28914;12071;16843;175;16668;RAMONET Pascal;M;RAMONET;Pascal;DIV;3
Législatives 2017 - 1er tour;Législatives;2017;1;12;12ème circonscription;20;CHATILLON;92020;22311;9527;12784;186;12598;GERMAIN Jean-Marc;M;GERMAIN;Jean-Marc;SOC;1219
Législatives 2017 - 1er tour;Législatives;2017;1;13;13ème circonscription;2;ANTONY;92002;41542;17216;24326;446;23880;SIFFREDI Georges;M;SIFFREDI;Georges;LR;5643
Législatives 2017 - 2ème tour;Législatives;2017;2;10;10ème circonscription;12;BOULOGNE BILLANCOURT;92012;9082;5325;3757;423;3334;COSTE Jeremy;M;COSTE;Jeremy;UDI;1045
Législatives 2017 - 2ème tour;Législatives;2017;2;13;13ème circonscription;2;ANTONY;92002;41542;20515;21027;2006;19021;DUMAS Frédérique;F;DUMAS;Frédérique;REM;11967
Législatives 2017 - 1er tour;Législatives;2017;1;3;3ème circonscription;26;COURBEVOIE;92026;44322;19890;24432;415;24017;PARIS Joëlle;F;PARIS;Joëlle;ECO;825
Législatives 2017 - 1er tour;Législatives;2017;1;3;3ème circonscription;35;LA GARENNE COLOMBES;92035;18829;8238;10591;114;10477;HENNION Christine;F;HENNION;Christine;REM;4819
Présidentielles 2017 - 1er tour;Présidentielles;2017;1;;;4;ASNIERES SUR SEINE;92004;48227;8578;39649;807;38842;MACRON Emmanuel;M;MACRON;Emmanuel;;13116
Présidentielles 2017 - 1er tour;Présidentielles;2017;1;;;12;BOULOGNE BILLANCOURT;92012;77303;15227;62076;919;61157;CHEMINADE Jacques;M;CHEMINADE;Jacques;;78
Présidentielles 2017 - 1er tour;Présidentielles;2017;1;;;12;BOULOGNE BILLANCOURT;92012;77303;15227;62076;919;61157;FILLON François;M;FILLON;François;;25592
Présidentielles 2017 - 1er tour;Présidentielles;2017;1;;;25;COLOMBES;92025;47454;9714;37740;907;36833;LASSALLE Jean;M;LASSALLE;Jean;;232
Présidentielles 2017 - 1er tour;Présidentielles;2017;1;;;26;COURBEVOIE;92026;52391;9609;42782;817;41965;LASSALLE Jean;M;LASSALLE;Jean;;216
Présidentielles 2017 - 1er tour;Présidentielles;2017;1;;;32;FONTENAY AUX ROSES;92032;16036;3739;12297;218;12078;LE PEN Marine;F;LE PEN;Marine;;980
Présidentielles 2017 - 1er tour;Présidentielles;2017;1;;;33;GARCHES;92033;12767;1975;10792;194;10598;HAMON Benoît;M;HAMON;Benoît;;525
Présidentielles 2017 - 1er tour;Présidentielles;2017;1;;;35;LA GARENNE COLOMBES;92035;18828;3121;15707;289;15418;POUTOU Philippe;M;POUTOU;Philippe;;88
Présidentielles 2017 - 1er tour;Présidentielles;2017;1;;;44;LEVALLOIS PERRET;92044;41716;6107;35609;511;35098;FILLON François;M;FILLON;François;;14280
Présidentielles 2017 - 1er tour;Présidentielles;2017;1;;;44;LEVALLOIS PERRET;92044;41716;6107;35609;511;35098;LASSALLE Jean;M;LASSALLE;Jean;;192
Présidentielles 2017 - 1er tour;Présidentielles;2017;1;;;47;MARNES LA COQUETTE;92047;1215;171;1044;5;1039;MACRON Emmanuel;M;MACRON;Emmanuel;;291
Présidentielles 2017 - 1er tour;Présidentielles;2017;1;;;48;MEUDON;92048;31280;5715;25565;405;25160;POUTOU Philippe;M;POUTOU;Philippe;;193
Présidentielles 2017 - 1er tour;Présidentielles;2017;1;;;60;LE PLESSIS ROBINSON;92060;19141;2947;16194;344;15850;LE PEN Marine;F;LE PEN;Marine;;1997
Présidentielles 2017 - 1er tour;Présidentielles;2017;1;;;62;PUTEAUX;92062;28950;4530;24420;549;23871;MACRON Emmanuel;M;MACRON;Emmanuel;;7788
Présidentielles 2017 - 1er tour;Présidentielles;2017;1;;;71;SCEAUX;92071;15052;2914;12138;145;11993;ASSELINEAU François;M;ASSELINEAU;François;;101
Présidentielles 2012 - 1er tour;Présidentielles;2012;1;;;9;BOIS COLOMBES;92009;16746;3612;13134;231;12903;BAYROU François;M;BAYROU;François;;1478
Présidentielles 2012 - 1er tour;Présidentielles;2012;1;;;12;BOULOGNE BILLANCOURT;92012;67579;13310;54269;818;53451;POUTOU Philippe;M;POUTOU;Philippe;;226
Présidentielles 2012 - 1er tour;Présidentielles;2012;1;;;14;BOURG LA REINE;92014;13300;2381;10919;132;10787;MÉLENCHON Jean-Luc;M;MÉLENCHON;Jean-Luc;;1010
Présidentielles 2012 - 1er tour;Présidentielles;2012;1;;;22;CHAVILLE;92022;12768;2527;10241;147;10094;LE PEN Marine;F;LE PEN;Marine;;881
Présidentielles 2012 - 1er tour;Présidentielles;2012;1;;;22;CHAVILLE;92022;12768;2527;10241;147;10094;CHEMINADE Jacques;M;CHEMINADE;Jacques;;30
Présidentielles 2012 - 1er tour;Présidentielles;2012;1;;;23;CLAMART;92023;34131;6740;27391;417;26974;JOLY Eva;F;JOLY;Eva;;842
Présidentielles 2012 - 1er tour;Présidentielles;2012;1;;;23;CLAMART;92023;34131;6740;27391;417;26974;DUPONT-AIGNAN Nicolas;M;DUPONT-AIGNAN;Nicolas;;421
Présidentielles 2012 - 1er tour;Présidentielles;2012;1;;;24;CLICHY;92024;29226;6786;22440;374;22066;JOLY Eva;F;JOLY;Eva;;751
Présidentielles 2012 - 1er tour;Présidentielles;2012;1;;;33;GARCHES;92033;12388;2501;9887;167;9720;MÉLENCHON Jean-Luc;M;MÉLENCHON;Jean-Luc;;531
Présidentielles 2012 - 1er tour;Présidentielles;2012;1;;;35;LA GARENNE COLOMBES;92035;17300;3509;13791;212;13579;LE PEN Marine;F;LE PEN;Marine;;1218
Présidentielles 2012 - 1er tour;Présidentielles;2012;1;;;44;LEVALLOIS PERRET;92044;39497;7296;32201;438;31763;LE PEN Marine;F;LE PEN;Marine;;2445
Présidentielles 2012 - 1er tour;Présidentielles;2012;1;;;49;MONTROUGE;92049;27851;5527;22324;289;22035;DUPONT-AIGNAN Nicolas;M;DUPONT-AIGNAN;Nicolas;;304
Présidentielles 2012 - 1er tour;Présidentielles;2012;1;;;51;NEUILLY SUR SEINE;92051;37003;5964;31039;257;30782;SARKOZY Nicolas;M;SARKOZY;Nicolas;;22360
Présidentielles 2012 - 1er tour;Présidentielles;2012;1;;;51;NEUILLY SUR SEINE;92051;37003;5964;31039;257;30782;POUTOU Philippe;M;POUTOU;Philippe;;67
Présidentielles 2012 - 1er tour;Présidentielles;2012;1;;;60;LE PLESSIS ROBINSON;92060;18767;3621;15146;260;14886;LE PEN Marine;F;LE PEN;Marine;;1752
Présidentielles 2012 - 1er tour;Présidentielles;2012;1;;;60;LE PLESSIS ROBINSON;92060;18767;3621;15146;260;14886;BAYROU François;M;BAYROU;François;;1648
Présidentielles 2012 - 1er tour;Présidentielles;2012;1;;;62;PUTEAUX;92062;28189;5597;22592;470;22122;MÉLENCHON Jean-Luc;M;MÉLENCHON;Jean-Luc;;1997
Présidentielles 2012 - 1er tour;Présidentielles;2012;1;;;62;PUTEAUX;92062;28189;5597;22592;470;22122;HOLLANDE François;M;HOLLANDE;François;;6204
Présidentielles 2012 - 1er tour;Présidentielles;2012;1;;;72;SEVRES;92072;14837;2876;11961;219;11742;DUPONT-AIGNAN Nicolas;M;DUPONT-AIGNAN;Nicolas;;166
Présidentielles 2012 - 1er tour;Présidentielles;2012;1;;;77;VILLE D'AVRAY;92077;7132;1060;6072;80;5992;POUTOU Philippe;M;POUTOU;Philippe;;28
Présidentielles 2012 - 2ème tour;Présidentielles;2012;2;;;2;ANTONY;92002;40240;6143;34097;1586;32511;SARKOZY Nicolas;M;SARKOZY;Nicolas;;15522
Présidentielles 2012 - 2ème tour;Présidentielles;2012;2;;;22;CHAVILLE;92022;12785;2053;10732;455;10277;SARKOZY Nicolas;M;SARKOZY;Nicolas;;5192
Présidentielles 2012 - 2ème tour;Présidentielles;2012;2;;;40;ISSY LES MOULINEAUX;92040;41994;8151;33843;1548;32295;HOLLANDE François;M;HOLLANDE;François;;16686
Présidentielles 2012 - 2ème tour;Présidentielles;2012;2;;;49;MONTROUGE;92049;27879;4753;23126;868;22258;HOLLANDE François;M;HOLLANDE;François;;12961
Présidentielles 2012 - 2ème tour;Présidentielles;2012;2;;;49;MONTROUGE;92049;27879;4753;23126;868;22258;SARKOZY Nicolas;M;SARKOZY;Nicolas;;9297
Présidentielles 2017 - 2ème tour;Présidentielles;2017;2;;;20;CHATILLON;92020;22292;4814;17478;1509;15969;MACRON Emmanuel;M;MACRON;Emmanuel;;13483
Présidentielles 2017 - 2ème tour;Présidentielles;2017;2;;;25;COLOMBES;92025;47455;11924;35531;3380;32151;LE PEN Marine;F;LE PEN;Marine;;5021
Présidentielles 2017 - 2ème tour;Présidentielles;2017;2;;;35;LA GARENNE COLOMBES;92035;18826;4037;14789;1357;13432;MACRON Emmanuel;M;MACRON;Emmanuel;;11460
Présidentielles 2017 - 2ème tour;Présidentielles;2017;2;;;63;RUEIL MALMAISON;92063;54428;12066;42362;3578;38784;MACRON Emmanuel;M;MACRON;Emmanuel;;33153
Présidentielles 2017 - 2ème tour;Présidentielles;2017;2;;;73;SURESNES;92073;28496;5924;22572;2053;20519;LE PEN Marine;F;LE PEN;Marine;;2956
Législatives 2007 - 1er tour;Législatives;2007;1;11;11ème circonscription;7;BAGNEUX;92007;20520;8538;11982;178;11804;BARBEROUSSE Olivier;M;BARBEROUSSE;Olivier;EXG;327
Législatives 2007 - 1er tour;Législatives;2007;1;3;3ème circonscription;35;LA GARENNE COLOMBES;92035;16552;5947;10605;101;10504;PELISSIER Hélène;F;PELISSIER;Hélène;DIV;69
Législatives 2007 - 1er tour;Législatives;2007;1;5;5ème circonscription;24;CLICHY;92024;28799;12380;16419;297;16122;FOURNIER Alain;M;FOURNIER;Alain;VEC;781
Législatives 2007 - 1er tour;Législatives;2007;1;8;8ème circonscription;47;MARNES LA COQUETTE;92047;1074;316;758;5;753;LEGRAND Pauline;F;LEGRAND;Pauline;EXD;3
Législatives 2007 - 1er tour;Législatives;2007;1;5;5ème circonscription;44;LEVALLOIS PERRET;92044;39466;14724;24742;404;24338;CUCULIERE Roger;M;CUCULIERE;Roger;EXD;79
Législatives 2007 - 1er tour;Législatives;2007;1;8;8ème circonscription;48;MEUDON;92048;25427;9683;15744;202;15542;RUSSO Annick;F;RUSSO;Annick;DIV;1
Législatives 2007 - 1er tour;Législatives;2007;1;12;12ème circonscription;20;CHATILLON;92020;20661;7083;13578;137;13441;ANTZENBERGER Philippe;M;ANTZENBERGER;Philippe;EXG;308
Législatives 2007 - 1er tour;Législatives;2007;1;12;12ème circonscription;23;CLAMART;92023;32916;11487;21429;154;21275;CHABRAN Isabelle;F;CHABRAN;Isabelle;VEC;962
Législatives 2007 - 1er tour;Législatives;2007;1;5;5ème circonscription;24;CLICHY;92024;28799;12380;16419;297;16122;LAMBERT Mireille;F;LAMBERT;Mireille;EXG;148
Législatives 2007 - 1er tour;Législatives;2007;1;8;8ème circonscription;22;CHAVILLE;92022;12928;4682;8246;120;8126;BLANCHARD Luc;M;BLANCHARD;Luc;VEC;332
Législatives 2007 - 1er tour;Législatives;2007;1;11;11ème circonscription;49;MONTROUGE;92049;26595;9698;16897;213;16684;MORILLERE Denis;M;MORILLERE;Denis;DIV;0
Législatives 2007 - 1er tour;Législatives;2007;1;13;13ème circonscription;71;SCEAUX;92071;14129;4679;9450;74;9376;IORIO Catherine;F;IORIO;Catherine;FN;181
Législatives 2007 - 1er tour;Législatives;2007;1;8;8ème circonscription;72;SEVRES;92072;14460;5279;9181;151;9030;LEGRAND Pauline;F;LEGRAND;Pauline;EXD;47
Législatives 2007 - 1er tour;Législatives;2007;1;10;10ème circonscription;12;BOULOGNE BILLANCOURT;92012;5551;2367;3184;78;3106;SCHMID Lucille;F;SCHMID;Lucille;SOC;857
Législatives 2007 - 1er tour;Législatives;2007;1;3;3ème circonscription;9;BOIS COLOMBES;92009;16245;6561;9684;288;9396;RAGOT Jean-Louis;M;RAGOT;Jean-Louis;UDFD;1144
Législatives 2007 - 1er tour;Législatives;2007;1;11;11ème circonscription;7;BAGNEUX;92007;20520;8538;11982;178;11804;METTON Jean-Loup;M;METTON;Jean-Loup;MAJ;3539
Législatives 2007 - 1er tour;Législatives;2007;1;6;6ème circonscription;51;NEUILLY SUR SEINE;92051;39134;14738;24396;185;24211;MINARDI Gaëtan;M;MINARDI;Gaëtan;EXG;27
Législatives 2007 - 1er tour;Législatives;2007;1;12;12ème circonscription;20;CHATILLON;92020;20661;7083;13578;137;13441;BENARD Paul;M;BENARD;Paul;EXG;43
Législatives 2007 - 1er tour;Législatives;2007;1;1;1ère circonscription;78;VILLENEUVE LA GARENNE;92078;13038;7211;5827;131;5696;MUZEAU Roland;M;MUZEAU;Roland;COM;815
Législatives 2007 - 1er tour;Législatives;2007;1;8;8ème circonscription;77;VILLE D'AVRAY;92077;7475;2429;5046;60;4986;LUCET Francis;M;LUCET;Francis;EXG;7
Législatives 2007 - 1er tour;Législatives;2007;1;8;8ème circonscription;77;VILLE D'AVRAY;92077;7475;2429;5046;60;4986;RUSSO Annick;F;RUSSO;Annick;DIV;1
Législatives 2007 - 2ème tour;Législatives;2007;2;13;13ème circonscription;19;CHATENAY MALABRY;92019;17835;7350;10485;421;10064;CANET Michèle;F;CANET;Michèle;SOC;4835
Législatives 2007 - 2ème tour;Législatives;2007;2;13;13ème circonscription;71;SCEAUX;92071;14132;5771;8361;287;8074;CANET Michèle;F;CANET;Michèle;SOC;3389
Législatives 2007 - 2ème tour;Législatives;2007;2;1;1ère circonscription;78;VILLENEUVE LA GARENNE;92078;13038;7480;5558;140;5418;VIGNON Véronique;F;VIGNON;Véronique;UMP;2532
Législatives 2007 - 2ème tour;Législatives;2007;2;13;13ème circonscription;71;SCEAUX;92071;14132;5771;8361;287;8074;DEVEDJIAN Patrick;M;DEVEDJIAN;Patrick;UMP;4685
Présidentielles 2002 - 1er tour;Présidentielles;2002;1;;;7;BAGNEUX;92007;18489;5873;12616;519;12097;JOSPIN LIONEL;M;JOSPIN;LIONEL;;2317
Présidentielles 2002 - 1er tour;Présidentielles;2002;1;;;9;BOIS COLOMBES;92009;13996;4554;9442;200;9242;GLUCKSTEIN DANIEL;M;GLUCKSTEIN;DANIEL;;23
Présidentielles 2002 - 1er tour;Présidentielles;2002;1;;;12;BOULOGNE BILLANCOURT;92012;57382;17570;39812;645;39167;SAINT-JOSSE JEAN;M;SAINT-JOSSE;JEAN;;284
Présidentielles 2002 - 1er tour;Présidentielles;2002;1;;;12;BOULOGNE BILLANCOURT;92012;57382;17570;39812;645;39167;BESANCENOT OLIVIER;M;BESANCENOT;OLIVIER;;716
Présidentielles 2002 - 1er tour;Présidentielles;2002;1;;;20;CHATILLON;92020;18067;5487;12580;295;12285;MADELIN ALAIN;M;MADELIN;ALAIN;;554
Présidentielles 2002 - 1er tour;Présidentielles;2002;1;;;23;CLAMART;92023;31130;10977;20153;427;19726;LEPAGE CORINNE;F;LEPAGE;CORINNE;;526
Présidentielles 2002 - 1er tour;Présidentielles;2002;1;;;24;CLICHY;92024;24491;8395;16096;399;15697;BAYROU FRANCOIS;M;BAYROU;FRANCOIS;;883
Présidentielles 2002 - 1er tour;Présidentielles;2002;1;;;26;COURBEVOIE;92026;39941;11959;27982;520;27462;MADELIN ALAIN;M;MADELIN;ALAIN;;1878
Présidentielles 2002 - 1er tour;Présidentielles;2002;1;;;32;FONTENAY AUX ROSES;92032;14148;4309;9839;204;9635;HUE ROBERT;M;HUE;ROBERT;;336
Présidentielles 2002 - 1er tour;Présidentielles;2002;1;;;33;GARCHES;92033;11708;3920;7788;137;7651;BOUTIN CHRISTINE;F;BOUTIN;CHRISTINE;;153
Présidentielles 2002 - 1er tour;Présidentielles;2002;1;;;33;GARCHES;92033;11708;3920;7788;137;7651;CHEVENEMENT JEAN-PIERRE;M;CHEVENEMENT;JEAN-PIERRE;;387
Présidentielles 2002 - 1er tour;Présidentielles;2002;1;;;33;GARCHES;92033;11708;3920;7788;137;7651;LAGUILLER ARLETTE;F;LAGUILLER;ARLETTE;;187
Présidentielles 2002 - 1er tour;Présidentielles;2002;1;;;36;GENNEVILLIERS;92036;18213;6933;11280;303;10977;LE PEN JEAN-MARIE;M;LE PEN;JEAN-MARIE;;1526
Présidentielles 2002 - 1er tour;Présidentielles;2002;1;;;36;GENNEVILLIERS;92036;18213;6933;11280;303;10977;SAINT-JOSSE JEAN;M;SAINT-JOSSE;JEAN;;71
Présidentielles 2002 - 1er tour;Présidentielles;2002;1;;;46;MALAKOFF;92046;17268;6020;11248;271;10977;CHIRAC JACQUES;M;CHIRAC;JACQUES;;1581
Présidentielles 2002 - 1er tour;Présidentielles;2002;1;;;49;MONTROUGE;92049;23382;8142;15240;301;14939;GLUCKSTEIN DANIEL;M;GLUCKSTEIN;DANIEL;;68
Présidentielles 2002 - 1er tour;Présidentielles;2002;1;;;64;SAINT CLOUD;92064;17818;6028;11790;141;11649;TAUBIRA CHRISTIANE;F;TAUBIRA;CHRISTIANE;;215
Présidentielles 2002 - 1er tour;Présidentielles;2002;1;;;72;SEVRES;92072;13367;4140;9227;153;9074;BAYROU FRANCOIS;M;BAYROU;FRANCOIS;;933
Présidentielles 2002 - 1er tour;Présidentielles;2002;1;;;75;VANVES;92075;15493;4648;10845;221;10624;CHIRAC JACQUES;M;CHIRAC;JACQUES;;2269
Présidentielles 2007 - 1er tour;Présidentielles;2007;1;;;4;ASNIERES SUR SEINE;92004;43605;5665;37940;436;37504;LAGUILLER Arlette;F;LAGUILLER;Arlette;;269
Présidentielles 2007 - 1er tour;Présidentielles;2007;1;;;14;BOURG LA REINE;92014;13108;1436;11672;90;11582;de VILLIERS Philippe;M;de VILLIERS;Philippe;;178
Présidentielles 2007 - 1er tour;Présidentielles;2007;1;;;40;ISSY LES MOULINEAUX;92040;37966;4920;33046;365;32681;LAGUILLER Arlette;F;LAGUILLER;Arlette;;194
Présidentielles 2007 - 1er tour;Présidentielles;2007;1;;;51;NEUILLY SUR SEINE;92051;37647;4032;33615;154;33461;LE PEN Jean-Marie;M;LE PEN;Jean-Marie;;1278
Présidentielles 2007 - 1er tour;Présidentielles;2007;1;;;51;NEUILLY SUR SEINE;92051;37647;4032;33615;154;33461;SARKOZY Nicolas;M;SARKOZY;Nicolas;;24298
Présidentielles 2007 - 1er tour;Présidentielles;2007;1;;;60;LE PLESSIS ROBINSON;92060;16571;1989;14582;159;14423;BUFFET Marie-George;F;BUFFET;Marie-George;;367
Présidentielles 2007 - 1er tour;Présidentielles;2007;1;;;71;SCEAUX;92071;13824;1539;12285;86;12199;LAGUILLER Arlette;F;LAGUILLER;Arlette;;57
Présidentielles 1995 - 1er tour;Présidentielles;1995;1;;;49;MONTROUGE;92049;22293;5924;16369;314;16055;BALLADUR EDOUARD;M;BALLADUR;EDOUARD;;2708
Présidentielles 1995 - 1er tour;Présidentielles;1995;1;;;62;PUTEAUX;92062;24192;6165;18027;379;17648;VOYNET DOMINIQUE;F;VOYNET;DOMINIQUE;;516
Présidentielles 1995 - 1er tour;Présidentielles;1995;1;;;64;SAINT CLOUD;92064;18989;5119;13870;179;13691;JOSPIN LIONEL;M;JOSPIN;LIONEL;;2360
Présidentielles 1995 - 1er tour;Présidentielles;1995;1;;;71;SCEAUX;92071;13371;3073;10298;170;10128;CHEMINADE JACQUES;M;CHEMINADE;JACQUES;;30
Présidentielles 1995 - 1er tour;Présidentielles;1995;1;;;9;BOIS COLOMBES;92009;14922;3871;11051;199;10852;VILLIERS DE PHILIPPE;M;VILLIERS DE;PHILIPPE;;440
Présidentielles 1995 - 1er tour;Présidentielles;1995;1;;;9;BOIS COLOMBES;92009;14922;3871;11051;199;10852;LAGUILLER ARLETTE;F;LAGUILLER;ARLETTE;;503
Présidentielles 1995 - 1er tour;Présidentielles;1995;1;;;7;BAGNEUX;92007;20166;5090;15076;308;14768;JOSPIN LIONEL;M;JOSPIN;LIONEL;;3752
Présidentielles 1995 - 1er tour;Présidentielles;1995;1;;;47;MARNES LA COQUETTE;92047;1003;227;776;11;765;VILLIERS DE PHILIPPE;M;VILLIERS DE;PHILIPPE;;39
Présidentielles 2007 - 2ème tour;Présidentielles;2007;2;;;62;PUTEAUX;92062;26805;3862;22943;918;22025;ROYAL Ségolène;F;ROYAL;Ségolène;;9189
Présidentielles 2007 - 2ème tour;Présidentielles;2007;2;;;71;SCEAUX;92071;13826;1729;12097;468;11629;SARKOZY Nicolas;M;SARKOZY;Nicolas;;6771
Présidentielles 2007 - 2ème tour;Présidentielles;2007;2;;;73;SURESNES;92073;24258;3080;21178;918;20260;SARKOZY Nicolas;M;SARKOZY;Nicolas;;11777
Présidentielles 1995 - 1er tour;Présidentielles;1995;1;;;40;ISSY LES MOULINEAUX;92040;30054;8139;21915;444;21471;BALLADUR EDOUARD;M;BALLADUR;EDOUARD;;3971
Présidentielles 1995 - 1er tour;Présidentielles;1995;1;;;35;LA GARENNE COLOMBES;92035;14104;3637;10467;225;10242;VOYNET DOMINIQUE;F;VOYNET;DOMINIQUE;;403
Présidentielles 1995 - 1er tour;Présidentielles;1995;1;;;36;GENNEVILLIERS;92036;19543;5563;13980;326;13654;LE PEN J.MARIE;M;LE PEN;J.MARIE;;2353
Présidentielles 1995 - 2ème tour;Présidentielles;1995;2;;;4;ASNIERES SUR SEINE;92004;39050;9195;29855;1421;28434;JOSPIN LIONEL;M;JOSPIN;LIONEL;;17312
Présidentielles 1995 - 2ème tour;Présidentielles;1995;2;;;19;CHATENAY MALABRY;92019;18197;4260;13937;653;13284;JOSPIN LIONEL;M;JOSPIN;LIONEL;;6581
Présidentielles 1995 - 2ème tour;Présidentielles;1995;2;;;48;MEUDON;92048;29713;6526;23187;844;22343;CHIRAC JACQUES;M;CHIRAC;JACQUES;;12854
Présidentielles 1995 - 2ème tour;Présidentielles;1995;2;;;75;VANVES;92075;15604;2697;12907;537;12370;CHIRAC JACQUES;M;CHIRAC;JACQUES;;6901
Présidentielles 2002 - 2ème tour;Présidentielles;2002;2;;;14;BOURG LA REINE;92014;12075;1828;10247;333;9914;LE PEN JEAN-MARIE;M;LE PEN;JEAN-MARIE;;1065
Présidentielles 2002 - 2ème tour;Présidentielles;2002;2;;;22;CHAVILLE;92022;12123;2251;9872;345;9527;LE PEN JEAN-MARIE;M;LE PEN;JEAN-MARIE;;1123
Présidentielles 2002 - 2ème tour;Présidentielles;2002;2;;;63;RUEIL MALMAISON;92063;48284;10250;38034;1205;36829;CHIRAC JACQUES;M;CHIRAC;JACQUES;;32645
Présidentielles 2002 - 2ème tour;Présidentielles;2002;2;;;64;SAINT CLOUD;92064;17822;3470;14352;330;14022;CHIRAC JACQUES;M;CHIRAC;JACQUES;;12230
Présidentielles 1995 - 1er tour;Présidentielles;1995;1;;;4;ASNIERES SUR SEINE;92004;39050;10288;28762;594;28168;CHIRAC JACQUES;M;CHIRAC;JACQUES;;7388
Législatives 1993 - 1er tour;Législatives;1993;1;10;10ème circonscription;12;BOULOGNE BILLANCOURT;92012;4523;1581;2942;133;2809;VASSEUR J.YVES;M;VASSEUR;J.YVES;COM;298
Législatives 1993 - 1er tour;Législatives;1993;1;2;2ème circonscription;4;ASNIERES SUR SEINE;92004;37314;11544;25770;852;24918;FRAGER DOMINIQUE;M;FRAGER;DOMINIQUE;GEC;2034
Législatives 1993 - 1er tour;Législatives;1993;1;13;13ème circonscription;2;ANTONY;92002;36749;10226;26523;1007;25516;MERLE J.FRANCOIS;M;MERLE;J.FRANCOIS;SOC;4258
Législatives 1993 - 1er tour;Législatives;1993;1;11;11ème circonscription;7;BAGNEUX;92007;21150;7754;13396;474;12922;BOURDIN YVES;M;BOURDIN;YVES;EXG;81
Législatives 1997 - 1er tour;Législatives;1997;1;13;13ème circonscription;2;ANTONY;92002;37772;12082;25690;861;24829;MERLE J.FRANCOIS;M;MERLE;J.FRANCOIS;SOC;6038
Législatives 1993 - 2ème tour;Législatives;1993;2;11;11ème circonscription;46;MALAKOFF;92046;19559;6884;12675;609;12066;ROBERT ALAIN;M;ROBERT;ALAIN;RPR;4510
Législatives 1997 - 1er tour;Législatives;1997;1;11;11ème circonscription;7;BAGNEUX;92007;20284;7388;12896;374;12522;PRUNIER ROBERT;M;PRUNIER;ROBERT;DVD;9
Législatives 1997 - 1er tour;Législatives;1997;1;13;13ème circonscription;2;ANTONY;92002;37772;12082;25690;861;24829;LE NET HERVE;M;LE NET;HERVE;DVD;295
Législatives 1997 - 1er tour;Législatives;1997;1;10;10ème circonscription;12;BOULOGNE BILLANCOURT;92012;4529;1717;2812;99;2713;DENIAU RAYMOND;M;DENIAU;RAYMOND;EXG;22
Législatives 1997 - 1er tour;Législatives;1997;1;9;9ème circonscription;12;BOULOGNE BILLANCOURT;92012;53287;18902;34385;948;33437;RICARD BRUNO;M;RICARD;BRUNO;DIV;228
Législatives 1997 - 1er tour;Législatives;1997;1;5;5ème circonscription;24;CLICHY;92024;23725;8942;14783;486;14297;ALFARROBA CATHERINE;F;ALFARROBA;CATHERINE;DVG;1575
Législatives 1997 - 1er tour;Législatives;1997;1;5;5ème circonscription;24;CLICHY;92024;23725;8942;14783;486;14297;LIMOUSIN MICHEL;M;LIMOUSIN;MICHEL;COM;1248
Législatives 1997 - 1er tour;Législatives;1997;1;10;10ème circonscription;40;ISSY LES MOULINEAUX;92040;30164;10899;19265;543;18722;SANTINI ANDRE;M;SANTINI;ANDRE;UDF;8398
Législatives 1997 - 1er tour;Législatives;1997;1;5;5ème circonscription;24;CLICHY;92024;23725;8942;14783;486;14297;FLAHAULT BRIGITTE;F;FLAHAULT;BRIGITTE;DVD;295
Législatives 1997 - 1er tour;Législatives;1997;1;7;7ème circonscription;33;GARCHES;92033;11323;3745;7578;290;7288;MAULION CHRISTIANE;F;MAULION;CHRISTIANE;SOC;1364
Législatives 1997 - 1er tour;Législatives;1997;1;7;7ème circonscription;33;GARCHES;92033;11323;3745;7578;290;7288;LAGACHE YVES;M;LAGACHE;YVES;ECO;225
Législatives 1997 - 1er tour;Législatives;1997;1;7;7ème circonscription;33;GARCHES;92033;11323;3745;7578;290;7288;GIROUD JEAN;M;GIROUD;JEAN;DVG;80
Législatives 1993 - 1er tour;Législatives;1993;1;12;12ème circonscription;60;LE PLESSIS ROBINSON;92060;13118;4266;8852;315;8537;LE BERRE ALAIN;M;LE BERRE;ALAIN;FRN;872
Législatives 1993 - 1er tour;Législatives;1993;1;10;10ème circonscription;75;VANVES;92075;15286;4324;10962;394;10568;KERMIN J.CHARLES;M;KERMIN;J.CHARLES;EXG;70
Législatives 1993 - 1er tour;Législatives;1993;1;8;8ème circonscription;76;VAUCRESSON;92076;5515;1574;3941;93;3848;ROY CAROLINE;F;ROY;CAROLINE;RDG;371
Législatives 1993 - 1er tour;Législatives;1993;1;7;7ème circonscription;33;GARCHES;92033;11440;3330;8110;328;7782;MARECHAL CHRISTIAN;M;MARECHAL;CHRISTIAN;FRN;820
Législatives 1993 - 1er tour;Législatives;1993;1;1;1ère circonscription;25;COLOMBES;92025;26594;9512;17082;693;16389;BRETON MICHEL;M;BRETON;MICHEL;EXG;288
Législatives 1993 - 1er tour;Législatives;1993;1;5;5ème circonscription;44;LEVALLOIS PERRET;92044;27392;7486;19906;624;19282;PERCEVAULT RICHARD;M;PERCEVAULT;RICHARD;EXG;270
Législatives 1993 - 1er tour;Législatives;1993;1;8;8ème circonscription;47;MARNES LA COQUETTE;92047;1006;246;760;21;739;GUILLET J.JACQUES;M;GUILLET;J.JACQUES;RPR;314
Législatives 1993 - 1er tour;Législatives;1993;1;5;5ème circonscription;44;LEVALLOIS PERRET;92044;27392;7486;19906;624;19282;LUNEAU FRANCOISE;F;LUNEAU;FRANCOISE;DIV;347
Législatives 1993 - 1er tour;Législatives;1993;1;8;8ème circonscription;47;MARNES LA COQUETTE;92047;1006;246;760;21;739;BRISSAUD SOPHIE;F;BRISSAUD;SOPHIE;FRN;79
Législatives 1993 - 1er tour;Législatives;1993;1;5;5ème circonscription;44;LEVALLOIS PERRET;92044;27392;7486;19906;624;19282;LEFEBVRE HERVE;M;LEFEBVRE;HERVE;DVD;171
Législatives 1993 - 1er tour;Législatives;1993;1;11;11ème circonscription;46;MALAKOFF;92046;19559;6951;12608;416;12192;AYOUB SERGE;M;AYOUB;SERGE;EXD;13
Législatives 1993 - 1er tour;Législatives;1993;1;8;8ème circonscription;22;CHAVILLE;92022;12345;3904;8441;296;8145;GREGOIRE MAURICE;M;GREGOIRE;MAURICE;DIV;124
Législatives 1993 - 1er tour;Législatives;1993;1;12;12ème circonscription;23;CLAMART;92023;30899;9896;21003;704;20299;COUTAT RICHARD;M;COUTAT;RICHARD;EXG;204
Législatives 1993 - 1er tour;Législatives;1993;1;12;12ème circonscription;23;CLAMART;92023;30899;9896;21003;704;20299;BUFFET M.GEORGE;F;BUFFET;M.GEORGE;COM;1521
Législatives 1993 - 1er tour;Législatives;1993;1;12;12ème circonscription;23;CLAMART;92023;30899;9896;21003;704;20299;LE BERRE ALAIN;M;LE BERRE;ALAIN;FRN;2579
Législatives 1993 - 1er tour;Législatives;1993;1;5;5ème circonscription;24;CLICHY;92024;25172;9290;15882;514;15368;WILLIG PATRICK;M;WILLIG;PATRICK;DIV;226
Législatives 1993 - 1er tour;Législatives;1993;1;5;5ème circonscription;24;CLICHY;92024;25172;9290;15882;514;15368;DUTHEIL DANIEL;M;DUTHEIL;DANIEL;EXG;116
Législatives 1997 - 1er tour;Législatives;1997;1;13;13ème circonscription;71;SCEAUX;92071;13168;3887;9281;266;9015;GESLAIN A.MARIE;F;GESLAIN;A.MARIE;COM;389
Législatives 1997 - 1er tour;Législatives;1997;1;6;6ème circonscription;51;NEUILLY SUR SEINE;92051;35571;12347;23224;570;22654;LAURENT PATRICIA;F;LAURENT;PATRICIA;DVD;275
Législatives 1997 - 1er tour;Législatives;1997;1;4;4ème circonscription;50;NANTERRE;92050;38533;13799;24734;766;23968;CASSOU ANDRE;M;CASSOU;ANDRE;DVG;382
Législatives 1997 - 1er tour;Législatives;1997;1;11;11ème circonscription;49;MONTROUGE;92049;21975;7943;14032;388;13644;BATIFOL JEROME;M;BATIFOL;JEROME;DVD;132
Législatives 1997 - 1er tour;Législatives;1997;1;7;7ème circonscription;63;RUEIL MALMAISON;92063;44715;14813;29902;1094;28808;MAULION CHRISTIANE;F;MAULION;CHRISTIANE;SOC;5892
Législatives 1997 - 1er tour;Législatives;1997;1;10;10ème circonscription;75;VANVES;92075;15446;4682;10764;329;10435;BERTRAND GINETTE;F;BERTRAND;GINETTE;DVD;203
Législatives 1997 - 1er tour;Législatives;1997;1;8;8ème circonscription;77;VILLE D'AVRAY;92077;7112;2283;4829;139;4690;JASSERAND BERNARD;M;JASSERAND;BERNARD;COM;135
Législatives 2002 - 1er tour;Législatives;2002;1;1;1ère circonscription;25;COLOMBES;92025;26192;12273;13919;366;13553;POURDIEU Stéphanie;F;POURDIEU;Stéphanie;MAJ;34
Législatives 2002 - 1er tour;Législatives;2002;1;3;3ème circonscription;26;COURBEVOIE;92026;49151;19345;29806;541;29265;LASSERRE Jean-André;M;LASSERRE;Jean-André;SOC;5003
Législatives 2002 - 1er tour;Législatives;2002;1;7;7ème circonscription;33;GARCHES;92033;12286;4601;7685;112;7573;ROCHERON Bertrand;M;ROCHERON;Bertrand;SOC;1153
Législatives 2002 - 1er tour;Législatives;2002;1;3;3ème circonscription;35;LA GARENNE COLOMBES;92035;16552;5947;10605;101;10504;KOSSOWSKI Jacques;M;KOSSOWSKI;Jacques;UMP;5895
Législatives 2002 - 1er tour;Législatives;2002;1;3;3ème circonscription;35;LA GARENNE COLOMBES;92035;16552;5947;10605;101;10504;DERAMBARSH Arash;M;DERAMBARSH;Arash;DVD;110
Législatives 2002 - 1er tour;Législatives;2002;1;3;3ème circonscription;35;LA GARENNE COLOMBES;92035;16552;5947;10605;101;10504;SOUILLART Marie-Jeanne;F;SOUILLART;Marie-Jeanne;EXD;40
Législatives 2002 - 1er tour;Législatives;2002;1;1;1ère circonscription;36;GENNEVILLIERS;92036;20048;9522;10526;189;10337;LE GAL Anna;F;LE GAL;Anna;ECO;72
Législatives 2002 - 1er tour;Législatives;2002;1;10;10ème circonscription;40;ISSY LES MOULINEAUX;92040;38520;14017;24503;359;24144;NAVIAUX Catherine;F;NAVIAUX;Catherine;VEC;836
Législatives 2002 - 1er tour;Législatives;2002;1;8;8ème circonscription;48;MEUDON;92048;25427;9683;15744;202;15542;LEHIDEUX Bernard;M;LEHIDEUX;Bernard;UDFD;2373
Législatives 2017 - 1er tour;Législatives;2017;1;1;1ère circonscription;25;COLOMBES;92025;27867;16420;11447;405;11042;PRUVOST Emmanuel;M;PRUVOST;Emmanuel;ECO;61
Législatives 2017 - 1er tour;Législatives;2017;1;1;1ère circonscription;25;COLOMBES;92025;27867;16420;11447;405;11042;MEHARGA Ahcen;M;MEHARGA;Ahcen;ECO;7
Législatives 2017 - 1er tour;Législatives;2017;1;1;1ère circonscription;25;COLOMBES;92025;27867;16420;11447;405;11042;PIJOAN David;M;PIJOAN;David;EXG;30
Législatives 2017 - 1er tour;Législatives;2017;1;3;3ème circonscription;35;LA GARENNE COLOMBES;92035;18829;8238;10591;114;10477;FRANCOIS-DAINVILLE Grégoire;M;FRANCOIS-DAINVILLE;Grégoire;DVD;428
Législatives 2017 - 1er tour;Législatives;2017;1;4;4ème circonscription;73;SURESNES;92073;28524;12725;15799;423;15376;LE BAUT Anne;F;LE BAUT;Anne;EXD;85
Législatives 2017 - 1er tour;Législatives;2017;1;6;6ème circonscription;26;COURBEVOIE;92026;8107;4228;3879;107;3772;BRANNENS Marie;F;BRANNENS;Marie;SOC;205
Législatives 2017 - 1er tour;Législatives;2017;1;3;3ème circonscription;35;LA GARENNE COLOMBES;92035;18829;8238;10591;114;10477;BRESSY Christophe;M;BRESSY;Christophe;DIV;39
Législatives 2017 - 1er tour;Législatives;2017;1;3;3ème circonscription;35;LA GARENNE COLOMBES;92035;18829;8238;10591;114;10477;COURMONT Chloé;F;COURMONT;Chloé;COM;78
Législatives 2017 - 1er tour;Législatives;2017;1;11;11ème circonscription;46;MALAKOFF;92046;18448;8148;10300;133;10167;SOMMARUGA Julie;F;SOMMARUGA;Julie;SOC;1681
Législatives 2017 - 1er tour;Législatives;2017;1;12;12ème circonscription;20;CHATILLON;92020;22311;9527;12784;186;12598;REJA-BRET Alexandre;M;REJA-BRET;Alexandre;DIV;31
Législatives 2017 - 1er tour;Législatives;2017;1;13;13ème circonscription;2;ANTONY;92002;41542;17216;24326;446;23880;NICOLAS Cédric;M;NICOLAS;Cédric;DVD;330
Législatives 2017 - 2ème tour;Législatives;2017;2;4;4ème circonscription;50;NANTERRE;92050;47651;31219;16432;2247;14185;BEDIN Camille;F;BEDIN;Camille;LR;4711
Législatives 2017 - 2ème tour;Législatives;2017;2;5;5ème circonscription;44;LEVALLOIS PERRET;92044;41751;21610;20141;1437;18704;DE COURSON Arnaud;M;DE COURSON;Arnaud;LR;7510
Législatives 2017 - 2ème tour;Législatives;2017;2;8;8ème circonscription;22;CHAVILLE;92022;13523;6615;6908;568;6340;MAIRE Jacques;M;MAIRE;Jacques;REM;4083
Législatives 2017 - 2ème tour;Législatives;2017;2;8;8ème circonscription;47;MARNES LA COQUETTE;92047;1215;548;667;28;639;BOYER Gilles;M;BOYER;Gilles;LR;345
Législatives 2017 - 2ème tour;Législatives;2017;2;13;13ème circonscription;2;ANTONY;92002;41542;20515;21027;2006;19021;SIFFREDI Georges;M;SIFFREDI;Georges;LR;7054
Législatives 2017 - 2ème tour;Législatives;2017;2;13;13ème circonscription;19;CHATENAY MALABRY;92019;18752;9486;9266;806;8460;DUMAS Frédérique;F;DUMAS;Frédérique;REM;4509
Législatives 2017 - 1er tour;Législatives;2017;1;2;2ème circonscription;4;ASNIERES SUR SEINE;92004;48340;22557;25783;414;25369;PRADIER Liliane;F;PRADIER;Liliane;FN;1022
Législatives 2017 - 1er tour;Législatives;2017;1;8;8ème circonscription;76;VAUCRESSON;92076;6187;2474;3713;42;3671;MACHILLOT Alexandre;M;MACHILLOT;Alexandre;DIV;40
Législatives 2017 - 1er tour;Législatives;2017;1;6;6ème circonscription;62;PUTEAUX;92062;28983;11794;17189;436;16753;KARSENTY Philippe;M;KARSENTY;Philippe;DVD;269
Législatives 2017 - 1er tour;Législatives;2017;1;6;6ème circonscription;62;PUTEAUX;92062;28983;11794;17189;436;16753;PAUCHET Jonathan;M;PAUCHET;Jonathan;DIV;122
Législatives 2017 - 1er tour;Législatives;2017;1;6;6ème circonscription;62;PUTEAUX;92062;28983;11794;17189;436;16753;DUBAIL Vincent;M;DUBAIL;Vincent;ECO;526
Législatives 2017 - 1er tour;Législatives;2017;1;7;7ème circonscription;33;GARCHES;92033;12777;5514;7263;115;7148;MZOUGHI Olfa;F;MZOUGHI;Olfa;FI;282
Législatives 2017 - 1er tour;Législatives;2017;1;10;10ème circonscription;12;BOULOGNE BILLANCOURT;92012;9082;4562;4520;114;4406;FOSSAERT Michel;M;FOSSAERT;Michel;ECO;3
Législatives 2017 - 1er tour;Législatives;2017;1;10;10ème circonscription;40;ISSY LES MOULINEAUX;92040;45375;19009;26366;517;25849;ATTAL Gabriel;M;ATTAL;Gabriel;REM;10951
Législatives 2017 - 1er tour;Législatives;2017;1;10;10ème circonscription;48;MEUDON;92048;6009;2545;3464;38;3426;CROS Stéphane;M;CROS;Stéphane;DIV;22
Présidentielles 2002 - 1er tour;Présidentielles;2002;1;;;12;BOULOGNE BILLANCOURT;92012;57382;17570;39812;645;39167;LEPAGE CORINNE;F;LEPAGE;CORINNE;;1077
Présidentielles 2002 - 1er tour;Présidentielles;2002;1;;;20;CHATILLON;92020;18067;5487;12580;295;12285;LEPAGE CORINNE;F;LEPAGE;CORINNE;;339
Présidentielles 2002 - 1er tour;Présidentielles;2002;1;;;23;CLAMART;92023;31130;10977;20153;427;19726;LE PEN JEAN-MARIE;M;LE PEN;JEAN-MARIE;;2531
Présidentielles 2002 - 1er tour;Présidentielles;2002;1;;;23;CLAMART;92023;31130;10977;20153;427;19726;MAMERE NOEL;M;MAMERE;NOEL;;1267
Présidentielles 2002 - 1er tour;Présidentielles;2002;1;;;23;CLAMART;92023;31130;10977;20153;427;19726;JOSPIN LIONEL;M;JOSPIN;LIONEL;;3593
Présidentielles 2002 - 1er tour;Présidentielles;2002;1;;;24;CLICHY;92024;24491;8395;16096;399;15697;SAINT-JOSSE JEAN;M;SAINT-JOSSE;JEAN;;108
Présidentielles 2002 - 1er tour;Présidentielles;2002;1;;;25;COLOMBES;92025;39608;13654;25954;571;25383;BOUTIN CHRISTINE;F;BOUTIN;CHRISTINE;;254
Présidentielles 2002 - 1er tour;Présidentielles;2002;1;;;25;COLOMBES;92025;39608;13654;25954;571;25383;LAGUILLER ARLETTE;F;LAGUILLER;ARLETTE;;1288
Présidentielles 2002 - 1er tour;Présidentielles;2002;1;;;26;COURBEVOIE;92026;39941;11959;27982;520;27462;HUE ROBERT;M;HUE;ROBERT;;379
Présidentielles 2002 - 1er tour;Présidentielles;2002;1;;;26;COURBEVOIE;92026;39941;11959;27982;520;27462;BESANCENOT OLIVIER;M;BESANCENOT;OLIVIER;;640
Présidentielles 2002 - 1er tour;Présidentielles;2002;1;;;32;FONTENAY AUX ROSES;92032;14148;4309;9839;204;9635;MADELIN ALAIN;M;MADELIN;ALAIN;;448
Présidentielles 2002 - 1er tour;Présidentielles;2002;1;;;35;LA GARENNE COLOMBES;92035;15006;5167;9839;227;9612;HUE ROBERT;M;HUE;ROBERT;;202
Présidentielles 2002 - 1er tour;Présidentielles;2002;1;;;40;ISSY LES MOULINEAUX;92040;32059;9424;22635;510;22125;HUE ROBERT;M;HUE;ROBERT;;568
Présidentielles 2002 - 1er tour;Présidentielles;2002;1;;;46;MALAKOFF;92046;17268;6020;11248;271;10977;GLUCKSTEIN DANIEL;M;GLUCKSTEIN;DANIEL;;51
Présidentielles 2002 - 1er tour;Présidentielles;2002;1;;;47;MARNES LA COQUETTE;92047;997;272;725;7;718;TAUBIRA CHRISTIANE;F;TAUBIRA;CHRISTIANE;;12
Présidentielles 2002 - 1er tour;Présidentielles;2002;1;;;47;MARNES LA COQUETTE;92047;997;272;725;7;718;BOUTIN CHRISTINE;F;BOUTIN;CHRISTINE;;31
Présidentielles 2002 - 1er tour;Présidentielles;2002;1;;;48;MEUDON;92048;28283;9341;18942;321;18621;MEGRET BRUNO;M;MEGRET;BRUNO;;293
Présidentielles 2002 - 1er tour;Présidentielles;2002;1;;;63;RUEIL MALMAISON;92063;48302;17158;31144;693;30451;SAINT-JOSSE JEAN;M;SAINT-JOSSE;JEAN;;248
Présidentielles 2002 - 1er tour;Présidentielles;2002;1;;;64;SAINT CLOUD;92064;17818;6028;11790;141;11649;MEGRET BRUNO;M;MEGRET;BRUNO;;163
Présidentielles 2002 - 1er tour;Présidentielles;2002;1;;;64;SAINT CLOUD;92064;17818;6028;11790;141;11649;CHEVENEMENT JEAN-PIERRE;M;CHEVENEMENT;JEAN-PIERRE;;614
Présidentielles 2002 - 1er tour;Présidentielles;2002;1;;;73;SURESNES;92073;22099;7156;14943;329;14614;LEPAGE CORINNE;F;LEPAGE;CORINNE;;420
Présidentielles 2002 - 1er tour;Présidentielles;2002;1;;;73;SURESNES;92073;22099;7156;14943;329;14614;BAYROU FRANCOIS;M;BAYROU;FRANCOIS;;1258
Présidentielles 2002 - 1er tour;Présidentielles;2002;1;;;73;SURESNES;92073;22099;7156;14943;329;14614;MADELIN ALAIN;M;MADELIN;ALAIN;;922
Présidentielles 2002 - 1er tour;Présidentielles;2002;1;;;75;VANVES;92075;15493;4648;10845;221;10624;LE PEN JEAN-MARIE;M;LE PEN;JEAN-MARIE;;1088
Présidentielles 2007 - 1er tour;Présidentielles;2007;1;;;4;ASNIERES SUR SEINE;92004;43605;5665;37940;436;37504;SARKOZY Nicolas;M;SARKOZY;Nicolas;;13669
Présidentielles 2007 - 1er tour;Présidentielles;2007;1;;;7;BAGNEUX;92007;20438;2809;17629;261;17368;SCHIVARDI Gérard;M;SCHIVARDI;Gérard;;47
Présidentielles 2007 - 1er tour;Présidentielles;2007;1;;;9;BOIS COLOMBES;92009;16113;2534;13579;152;13427;BESANCENOT Olivier;M;BESANCENOT;Olivier;;268
Présidentielles 2007 - 1er tour;Présidentielles;2007;1;;;12;BOULOGNE BILLANCOURT;92012;64709;7685;57024;546;56478;NIHOUS Frédéric;M;NIHOUS;Frédéric;;89
Présidentielles 2007 - 1er tour;Présidentielles;2007;1;;;14;BOURG LA REINE;92014;13108;1436;11672;90;11582;BAYROU François;M;BAYROU;François;;2806
Présidentielles 2007 - 1er tour;Présidentielles;2007;1;;;19;CHATENAY MALABRY;92019;17598;2318;15280;229;15051;BESANCENOT Olivier;M;BESANCENOT;Olivier;;455
Présidentielles 2007 - 1er tour;Présidentielles;2007;1;;;19;CHATENAY MALABRY;92019;17598;2318;15280;229;15051;BUFFET Marie-George;F;BUFFET;Marie-George;;294
Présidentielles 2007 - 1er tour;Présidentielles;2007;1;;;20;CHATILLON;92020;20466;2231;18235;177;18058;ROYAL Ségolène;F;ROYAL;Ségolène;;5273
Présidentielles 2007 - 1er tour;Présidentielles;2007;1;;;22;CHAVILLE;92022;12743;1700;11043;119;10924;de VILLIERS Philippe;M;de VILLIERS;Philippe;;173
Présidentielles 2007 - 1er tour;Présidentielles;2007;1;;;35;LA GARENNE COLOMBES;92035;16350;1826;14524;117;14407;LE PEN Jean-Marie;M;LE PEN;Jean-Marie;;882
Présidentielles 2007 - 1er tour;Présidentielles;2007;1;;;40;ISSY LES MOULINEAUX;92040;37966;4920;33046;365;32681;SARKOZY Nicolas;M;SARKOZY;Nicolas;;11397
Présidentielles 2007 - 1er tour;Présidentielles;2007;1;;;44;LEVALLOIS PERRET;92044;38708;4734;33974;296;33678;VOYNET Dominique;F;VOYNET;Dominique;;390
Présidentielles 2007 - 1er tour;Présidentielles;2007;1;;;48;MEUDON;92048;29936;4129;25807;223;25584;LE PEN Jean-Marie;M;LE PEN;Jean-Marie;;1293
Présidentielles 2007 - 1er tour;Présidentielles;2007;1;;;49;MONTROUGE;92049;26299;3093;23206;219;22987;BAYROU François;M;BAYROU;François;;5373
Présidentielles 2007 - 1er tour;Présidentielles;2007;1;;;49;MONTROUGE;92049;26299;3093;23206;219;22987;de VILLIERS Philippe;M;de VILLIERS;Philippe;;294
Présidentielles 2007 - 1er tour;Présidentielles;2007;1;;;60;LE PLESSIS ROBINSON;92060;16571;1989;14582;159;14423;BAYROU François;M;BAYROU;François;;3063
Présidentielles 2007 - 1er tour;Présidentielles;2007;1;;;62;PUTEAUX;92062;26761;3397;23364;263;23101;SCHIVARDI Gérard;M;SCHIVARDI;Gérard;;44
Présidentielles 2007 - 1er tour;Présidentielles;2007;1;;;64;SAINT CLOUD;92064;18455;1926;16529;91;16438;BAYROU François;M;BAYROU;François;;3413
Présidentielles 2007 - 1er tour;Présidentielles;2007;1;;;64;SAINT CLOUD;92064;18455;1926;16529;91;16438;LE PEN Jean-Marie;M;LE PEN;Jean-Marie;;925
Présidentielles 2007 - 1er tour;Présidentielles;2007;1;;;72;SEVRES;92072;14178;1738;12440;129;12311;BAYROU François;M;BAYROU;François;;2875
Présidentielles 2007 - 1er tour;Présidentielles;2007;1;;;73;SURESNES;92073;24255;2600;21655;272;21383;SCHIVARDI Gérard;M;SCHIVARDI;Gérard;;35
Présidentielles 2007 - 1er tour;Présidentielles;2007;1;;;75;VANVES;92075;17139;2129;15010;126;14884;de VILLIERS Philippe;M;de VILLIERS;Philippe;;175
Présidentielles 1995 - 1er tour;Présidentielles;1995;1;;;25;COLOMBES;92025;44864;11966;32898;703;32195;HUE ROBERT;M;HUE;ROBERT;;3813
Présidentielles 1995 - 1er tour;Présidentielles;1995;1;;;32;FONTENAY AUX ROSES;92032;14917;3559;11358;196;11162;VILLIERS DE PHILIPPE;M;VILLIERS DE;PHILIPPE;;330
Présidentielles 1995 - 1er tour;Présidentielles;1995;1;;;32;FONTENAY AUX ROSES;92032;14917;3559;11358;196;11162;JOSPIN LIONEL;M;JOSPIN;LIONEL;;3172
Présidentielles 1995 - 1er tour;Présidentielles;1995;1;;;36;GENNEVILLIERS;92036;19543;5563;13980;326;13654;LAGUILLER ARLETTE;F;LAGUILLER;ARLETTE;;905
Présidentielles 1995 - 1er tour;Présidentielles;1995;1;;;36;GENNEVILLIERS;92036;19543;5563;13980;326;13654;VOYNET DOMINIQUE;F;VOYNET;DOMINIQUE;;390
Présidentielles 1995 - 1er tour;Présidentielles;1995;1;;;40;ISSY LES MOULINEAUX;92040;30054;8139;21915;444;21471;LE PEN J.MARIE;M;LE PEN;J.MARIE;;2386
Présidentielles 1995 - 1er tour;Présidentielles;1995;1;;;44;LEVALLOIS PERRET;92044;29477;6881;22596;402;22194;CHIRAC JACQUES;M;CHIRAC;JACQUES;;6974
Présidentielles 1995 - 1er tour;Présidentielles;1995;1;;;44;LEVALLOIS PERRET;92044;29477;6881;22596;402;22194;JOSPIN LIONEL;M;JOSPIN;LIONEL;;4529
Présidentielles 1995 - 1er tour;Présidentielles;1995;1;;;48;MEUDON;92048;29714;7851;21863;352;21511;VILLIERS DE PHILIPPE;M;VILLIERS DE;PHILIPPE;;771
Présidentielles 1995 - 1er tour;Présidentielles;1995;1;;;60;LE PLESSIS ROBINSON;92060;13056;3285;9771;199;9572;LAGUILLER ARLETTE;F;LAGUILLER;ARLETTE;;517
Présidentielles 1995 - 1er tour;Présidentielles;1995;1;;;62;PUTEAUX;92062;24192;6165;18027;379;17648;CHIRAC JACQUES;M;CHIRAC;JACQUES;;5202
Présidentielles 1995 - 1er tour;Présidentielles;1995;1;;;63;RUEIL MALMAISON;92063;44438;10571;33867;718;33149;LE PEN J.MARIE;M;LE PEN;J.MARIE;;3776
Présidentielles 1995 - 1er tour;Présidentielles;1995;1;;;72;SEVRES;92072;13745;2869;10876;183;10693;JOSPIN LIONEL;M;JOSPIN;LIONEL;;2817
Présidentielles 1995 - 1er tour;Présidentielles;1995;1;;;73;SURESNES;92073;21968;5851;16117;341;15776;LE PEN J.MARIE;M;LE PEN;J.MARIE;;1750
Présidentielles 1995 - 1er tour;Présidentielles;1995;1;;;75;VANVES;92075;15499;3343;12156;236;11920;HUE ROBERT;M;HUE;ROBERT;;740
Présidentielles 1995 - 1er tour;Présidentielles;1995;1;;;78;VILLENEUVE LA GARENNE;92078;11588;3130;8458;196;8262;VILLIERS DE PHILIPPE;M;VILLIERS DE;PHILIPPE;;252
Présidentielles 2002 - 2ème tour;Présidentielles;2002;2;;;14;BOURG LA REINE;92014;12075;1828;10247;333;9914;CHIRAC JACQUES;M;CHIRAC;JACQUES;;8849
Présidentielles 2002 - 2ème tour;Présidentielles;2002;2;;;33;GARCHES;92033;11709;2139;9570;234;9336;LE PEN JEAN-MARIE;M;LE PEN;JEAN-MARIE;;1170
Présidentielles 1995 - 2ème tour;Présidentielles;1995;2;;;62;PUTEAUX;92062;24192;5631;18561;941;17620;JOSPIN LIONEL;M;JOSPIN;LIONEL;;6915
Législatives 2007 - 1er tour;Législatives;2007;1;1;1ère circonscription;78;VILLENEUVE LA GARENNE;92078;13038;7211;5827;131;5696;POURDIEU Stéphanie;F;POURDIEU;Stéphanie;MAJ;40
Législatives 2007 - 1er tour;Législatives;2007;1;1;1ère circonscription;78;VILLENEUVE LA GARENNE;92078;13038;7211;5827;131;5696;VIGNON Véronique;F;VIGNON;Véronique;UMP;2148
Législatives 2007 - 2ème tour;Législatives;2007;2;11;11ème circonscription;7;BAGNEUX;92007;20521;8801;11720;247;11473;METTON Jean-Loup;M;METTON;Jean-Loup;MAJ;4105
Présidentielles 2017 - 1er tour;Présidentielles;2017;1;;;12;BOULOGNE BILLANCOURT;92012;77303;15227;62076;919;61157;HAMON Benoît;M;HAMON;Benoît;;3153
Présidentielles 2017 - 1er tour;Présidentielles;2017;1;;;22;CHAVILLE;92022;13493;2042;11451;183;11267;ASSELINEAU François;M;ASSELINEAU;François;;116
Présidentielles 2017 - 1er tour;Présidentielles;2017;1;;;33;GARCHES;92033;12767;1975;10792;194;10598;CHEMINADE Jacques;M;CHEMINADE;Jacques;;16
Présidentielles 2017 - 1er tour;Présidentielles;2017;1;;;35;LA GARENNE COLOMBES;92035;18828;3121;15707;289;15418;HAMON Benoît;M;HAMON;Benoît;;945
Présidentielles 2017 - 1er tour;Présidentielles;2017;1;;;36;GENNEVILLIERS;92036;22149;5526;16623;490;16133;LE PEN Marine;F;LE PEN;Marine;;1809
Présidentielles 2017 - 1er tour;Présidentielles;2017;1;;;44;LEVALLOIS PERRET;92044;41716;6107;35609;511;35098;LE PEN Marine;F;LE PEN;Marine;;2390
Présidentielles 2017 - 1er tour;Présidentielles;2017;1;;;49;MONTROUGE;92049;28899;4312;24587;429;24158;DUPONT-AIGNAN Nicolas;M;DUPONT-AIGNAN;Nicolas;;637
Présidentielles 2017 - 1er tour;Présidentielles;2017;1;;;49;MONTROUGE;92049;28899;4312;24587;429;24158;MACRON Emmanuel;M;MACRON;Emmanuel;;8706
Présidentielles 2012 - 1er tour;Présidentielles;2012;1;;;12;BOULOGNE BILLANCOURT;92012;67579;13310;54269;818;53451;BAYROU François;M;BAYROU;François;;5727
Présidentielles 2012 - 1er tour;Présidentielles;2012;1;;;19;CHATENAY MALABRY;92019;17914;3466;14448;325;14123;JOLY Eva;F;JOLY;Eva;;386
Présidentielles 2012 - 1er tour;Présidentielles;2012;1;;;19;CHATENAY MALABRY;92019;17914;3466;14448;325;14123;HOLLANDE François;M;HOLLANDE;François;;5039
Présidentielles 2012 - 1er tour;Présidentielles;2012;1;;;22;CHAVILLE;92022;12768;2527;10241;147;10094;POUTOU Philippe;M;POUTOU;Philippe;;69
Présidentielles 2012 - 1er tour;Présidentielles;2012;1;;;26;COURBEVOIE;92026;50576;11277;39299;681;38618;JOLY Eva;F;JOLY;Eva;;978
Présidentielles 2012 - 1er tour;Présidentielles;2012;1;;;26;COURBEVOIE;92026;50576;11277;39299;681;38618;DUPONT-AIGNAN Nicolas;M;DUPONT-AIGNAN;Nicolas;;488
Présidentielles 2012 - 1er tour;Présidentielles;2012;1;;;36;GENNEVILLIERS;92036;20990;5264;15726;342;15384;BAYROU François;M;BAYROU;François;;619
Présidentielles 2012 - 1er tour;Présidentielles;2012;1;;;48;MEUDON;92048;30572;6341;24231;318;23913;ARTHAUD Nathalie;F;ARTHAUD;Nathalie;;71
Présidentielles 2012 - 1er tour;Présidentielles;2012;1;;;71;SCEAUX;92071;14355;2941;11414;118;11296;DUPONT-AIGNAN Nicolas;M;DUPONT-AIGNAN;Nicolas;;143
Présidentielles 2012 - 1er tour;Présidentielles;2012;1;;;75;VANVES;92075;17512;3079;14433;161;14272;BAYROU François;M;BAYROU;François;;1624
Présidentielles 2012 - 1er tour;Présidentielles;2012;1;;;76;VAUCRESSON;92076;6089;1241;4848;74;4774;SARKOZY Nicolas;M;SARKOZY;Nicolas;;2768
Présidentielles 2017 - 2ème tour;Présidentielles;2017;2;;;32;FONTENAY AUX ROSES;92032;16037;4490;11547;953;10594;LE PEN Marine;F;LE PEN;Marine;;1585
Présidentielles 2017 - 2ème tour;Présidentielles;2017;2;;;36;GENNEVILLIERS;92036;22151;6800;15351;1611;13740;LE PEN Marine;F;LE PEN;Marine;;2352
Présidentielles 2017 - 2ème tour;Présidentielles;2017;2;;;50;NANTERRE;92050;47571;13323;34248;3029;31219;LE PEN Marine;F;LE PEN;Marine;;5259
Présidentielles 2012 - 2ème tour;Présidentielles;2012;2;;;47;MARNES LA COQUETTE;92047;1084;104;980;29;951;HOLLANDE François;M;HOLLANDE;François;;208
Présidentielles 2012 - 2ème tour;Présidentielles;2012;2;;;47;MARNES LA COQUETTE;92047;1084;104;980;29;951;SARKOZY Nicolas;M;SARKOZY;Nicolas;;743
Présidentielles 2012 - 2ème tour;Présidentielles;2012;2;;;62;PUTEAUX;92062;28241;4967;23274;1020;22254;HOLLANDE François;M;HOLLANDE;François;;10474
Présidentielles 2012 - 2ème tour;Présidentielles;2012;2;;;73;SURESNES;92073;26469;4257;22212;935;21277;SARKOZY Nicolas;M;SARKOZY;Nicolas;;11229
Législatives 2007 - 1er tour;Législatives;2007;1;12;12ème circonscription;60;LE PLESSIS ROBINSON;92060;16776;5588;11188;123;11065;ZANOLIN Ludovic;F;ZANOLIN;Ludovic;COM;323
Législatives 2007 - 1er tour;Législatives;2007;1;6;6ème circonscription;62;PUTEAUX;92062;26791;8829;17962;396;17566;OLIVIER Pascal;M;OLIVIER;Pascal;DVG;39
Législatives 2007 - 1er tour;Législatives;2007;1;3;3ème circonscription;35;LA GARENNE COLOMBES;92035;16552;5947;10605;101;10504;LASSERRE Jean-André;M;LASSERRE;Jean-André;SOC;1882
Législatives 2007 - 1er tour;Législatives;2007;1;3;3ème circonscription;26;COURBEVOIE;92026;49151;19345;29806;541;29265;PELISSIER Hélène;F;PELISSIER;Hélène;DIV;129
Législatives 2007 - 1er tour;Législatives;2007;1;13;13ème circonscription;14;BOURG LA REINE;92014;13381;4391;8990;78;8912;DELRIEU Denis;M;DELRIEU;Denis;VEC;371
Législatives 2007 - 1er tour;Législatives;2007;1;5;5ème circonscription;24;CLICHY;92024;28799;12380;16419;297;16122;DUTILLOY Marie-Catherine;F;DUTILLOY;Marie-Catherine;ECO;153
Législatives 2007 - 1er tour;Législatives;2007;1;1;1ère circonscription;25;COLOMBES;92025;26192;12273;13919;366;13553;MOURRE Odile;F;MOURRE;Odile;EXG;35
Législatives 2007 - 1er tour;Législatives;2007;1;12;12ème circonscription;23;CLAMART;92023;32916;11487;21429;154;21275;BENARD Paul;M;BENARD;Paul;EXG;71
Législatives 2007 - 1er tour;Législatives;2007;1;7;7ème circonscription;63;RUEIL MALMAISON;92063;51481;18902;32579;337;32242;BRISON Christian;M;BRISON;Christian;EXG;154
Législatives 2007 - 1er tour;Législatives;2007;1;7;7ème circonscription;64;SAINT CLOUD;92064;19115;6812;12303;93;12210;TERRAZZONI Valérie;F;TERRAZZONI;Valérie;DIV;48
Législatives 2007 - 1er tour;Législatives;2007;1;7;7ème circonscription;64;SAINT CLOUD;92064;19115;6812;12303;93;12210;ROCHERON Bertrand;M;ROCHERON;Bertrand;SOC;1553
Législatives 2007 - 1er tour;Législatives;2007;1;7;7ème circonscription;64;SAINT CLOUD;92064;19115;6812;12303;93;12210;BRISON Christian;M;BRISON;Christian;EXG;30
Législatives 2007 - 1er tour;Législatives;2007;1;13;13ème circonscription;71;SCEAUX;92071;14129;4679;9450;74;9376;RIEUX Françoise;F;RIEUX;Françoise;EXD;36
Législatives 2007 - 1er tour;Législatives;2007;1;8;8ème circonscription;77;VILLE D'AVRAY;92077;7475;2429;5046;60;4986;GUILLET Jean-Jacques;M;GUILLET;Jean-Jacques;UMP;2933
Législatives 2007 - 1er tour;Législatives;2007;1;1;1ère circonscription;78;VILLENEUVE LA GARENNE;92078;13038;7211;5827;131;5696;GRIMAL Jean;M;GRIMAL;Jean;EXG;35
Législatives 2007 - 1er tour;Législatives;2007;1;10;10ème circonscription;75;VANVES;92075;17351;5929;11422;137;11285;DROUET Valérie;F;DROUET;Valérie;EXD;46
Législatives 1993 - 1er tour;Législatives;1993;1;12;12ème circonscription;32;FONTENAY AUX ROSES;92032;15091;4963;10128;341;9787;BUFFET M.GEORGE;F;BUFFET;M.GEORGE;COM;683
Législatives 1993 - 1er tour;Législatives;1993;1;3;3ème circonscription;35;LA GARENNE COLOMBES;92035;13664;4290;9374;347;9027;EDMONDSON NEIL;M;EDMONDSON;NEIL;EXD;44
Législatives 1993 - 1er tour;Législatives;1993;1;10;10ème circonscription;12;BOULOGNE BILLANCOURT;92012;4523;1581;2942;133;2809;LARDOUX BRUNO;M;LARDOUX;BRUNO;EXG;24
Législatives 1993 - 1er tour;Législatives;1993;1;1;1ère circonscription;36;GENNEVILLIERS;92036;19185;6818;12367;395;11972;MAS J.LOUIS;M;MAS;J.LOUIS;DVD;126
Législatives 1993 - 1er tour;Législatives;1993;1;9;9ème circonscription;12;BOULOGNE BILLANCOURT;92012;53509;17387;36122;1224;34898;GARBARZ SARAH;F;GARBARZ;SARAH;DIV;319
Législatives 1993 - 1er tour;Législatives;1993;1;2;2ème circonscription;25;COLOMBES;92025;18324;5870;12454;434;12020;MASSOL HUBERT;M;MASSOL;HUBERT;FRN;1795
Législatives 1993 - 1er tour;Législatives;1993;1;8;8ème circonscription;22;CHAVILLE;92022;12345;3904;8441;296;8145;GUILLET J.JACQUES;M;GUILLET;J.JACQUES;RPR;2318
Législatives 1993 - 1er tour;Législatives;1993;1;1;1ère circonscription;78;VILLENEUVE LA GARENNE;92078;11604;4168;7436;212;7224;LEOPOLD CHANTAL;F;LEOPOLD;CHANTAL;SOC;546
Législatives 1993 - 2ème tour;Législatives;1993;2;8;8ème circonscription;22;CHAVILLE;92022;12346;6512;5834;2111;3723;GUILLET J.JACQUES;M;GUILLET;J.JACQUES;RPR;3723
Législatives 1993 - 1er tour;Législatives;1993;1;10;10ème circonscription;48;MEUDON;92048;4225;1396;2829;92;2737;VASSEUR J.YVES;M;VASSEUR;J.YVES;COM;189
Législatives 1993 - 1er tour;Législatives;1993;1;4;4ème circonscription;73;SURESNES;92073;21292;6457;14835;522;14313;FRAYSSE JACQUELINE;F;FRAYSSE;JACQUELINE;COM;1243
Législatives 1993 - 1er tour;Législatives;1993;1;4;4ème circonscription;73;SURESNES;92073;21292;6457;14835;522;14313;DUPUY CHRISTIAN;M;DUPUY;CHRISTIAN;RPR;6694
Législatives 1993 - 1er tour;Législatives;1993;1;10;10ème circonscription;40;ISSY LES MOULINEAUX;92040;29377;9425;19952;648;19304;KERMIN J.CHARLES;M;KERMIN;J.CHARLES;EXG;101
Législatives 1993 - 1er tour;Législatives;1993;1;6;6ème circonscription;62;PUTEAUX;92062;23271;6636;16635;697;15938;ABECASSIS DENIS;M;ABECASSIS;DENIS;GEC;1372
Législatives 1993 - 1er tour;Législatives;1993;1;13;13ème circonscription;19;CHATENAY MALABRY;92019;17809;6223;11586;435;11151;GAZZOLA DANIEL;M;GAZZOLA;DANIEL;FRN;1285
Législatives 1993 - 1er tour;Législatives;1993;1;3;3ème circonscription;9;BOIS COLOMBES;92009;14392;4251;10141;422;9719;PEREZ CHRISTIAN;M;PEREZ;CHRISTIAN;FRN;1716
Législatives 1993 - 1er tour;Législatives;1993;1;12;12ème circonscription;20;CHATILLON;92020;15705;4455;11250;435;10815;LARCHER ROBERT;M;LARCHER;ROBERT;EXG;221
Législatives 1993 - 1er tour;Législatives;1993;1;12;12ème circonscription;60;LE PLESSIS ROBINSON;92060;13118;4266;8852;315;8537;DUMAS J.FRANCOIS;M;DUMAS;J.FRANCOIS;VEC;656
Législatives 1993 - 1er tour;Législatives;1993;1;6;6ème circonscription;51;NEUILLY SUR SEINE;92051;35806;10146;25660;620;25040;DACHEZ ROGER;M;DACHEZ;ROGER;DIV;289
Législatives 1993 - 1er tour;Législatives;1993;1;5;5ème circonscription;44;LEVALLOIS PERRET;92044;27392;7486;19906;624;19282;DUTHEIL DANIEL;M;DUTHEIL;DANIEL;EXG;63
Législatives 2012 - 1er tour;Législatives;2012;1;3;3ème circonscription;9;BOIS COLOMBES;92009;16783;6763;10020;331;9689;KOSSOWSKI Jacques;M;KOSSOWSKI;Jacques;UMP;4096
Législatives 2012 - 1er tour;Législatives;2012;1;9;9ème circonscription;12;BOULOGNE BILLANCOURT;92012;61020;24579;36441;340;36101;KHALIL Mina;F;KHALIL;Mina;EXG;28
Législatives 2012 - 1er tour;Législatives;2012;1;10;10ème circonscription;12;BOULOGNE BILLANCOURT;92012;6600;2912;3688;126;3562;VIGUIE Laurence;F;VIGUIE;Laurence;EXG;20
Législatives 2012 - 1er tour;Législatives;2012;1;10;10ème circonscription;12;BOULOGNE BILLANCOURT;92012;6600;2912;3688;126;3562;BERGER Véronique;F;BERGER;Véronique;DVD;56
Législatives 2012 - 1er tour;Législatives;2012;1;13;13ème circonscription;19;CHATENAY MALABRY;92019;17908;6775;11133;210;10923;LE NEOUANNIC Pascale;F;LE NEOUANNIC;Pascale;FG;789
Législatives 2012 - 1er tour;Législatives;2012;1;13;13ème circonscription;19;CHATENAY MALABRY;92019;17908;6775;11133;210;10923;CADORET Mannone;M;CADORET;Mannone;AUT;55
Législatives 2012 - 1er tour;Législatives;2012;1;12;12ème circonscription;20;CHATILLON;92020;21681;8265;13416;122;13294;BAVAY Francine;F;BAVAY;Francine;VEC;564
Législatives 2012 - 1er tour;Législatives;2012;1;8;8ème circonscription;22;CHAVILLE;92022;12808;4688;8120;75;8045;VIERA Lydia;F;VIERA;Lydia;ECO;10
Législatives 2012 - 1er tour;Législatives;2012;1;8;8ème circonscription;22;CHAVILLE;92022;12808;4688;8120;75;8045;BECQ Michel;M;BECQ;Michel;DVD;21
Législatives 2012 - 1er tour;Législatives;2012;1;5;5ème circonscription;24;CLICHY;92024;29276;13521;15755;274;15481;FOURNIER Alain;M;FOURNIER;Alain;VEC;1019
Législatives 2012 - 1er tour;Législatives;2012;1;3;3ème circonscription;26;COURBEVOIE;92026;42456;16939;25517;317;25200;KOSSOWSKI Jacques;M;KOSSOWSKI;Jacques;UMP;12326
Législatives 2012 - 1er tour;Législatives;2012;1;7;7ème circonscription;33;GARCHES;92033;12412;5093;7319;98;7221;JEANMAIRE François;M;JEANMAIRE;François;DVD;368
Législatives 2012 - 1er tour;Législatives;2012;1;3;3ème circonscription;35;LA GARENNE COLOMBES;92035;17314;7036;10278;79;10199;PARRY Jean-Marie;M;PARRY;Jean-Marie;EXG;26
Législatives 2012 - 1er tour;Législatives;2012;1;1;1ère circonscription;36;GENNEVILLIERS;92036;20795;10523;10272;192;10080;DJELLAB Nora;F;DJELLAB;Nora;UMP;694
Législatives 2012 - 1er tour;Législatives;2012;1;10;10ème circonscription;40;ISSY LES MOULINEAUX;92040;42014;16484;25530;277;25253;SCHMID Lucile;F;SCHMID;Lucile;VEC;4817
Législatives 2012 - 1er tour;Législatives;2012;1;11;11ème circonscription;46;MALAKOFF;92046;18858;7608;11250;119;11131;BOURHIS Nadine;F;BOURHIS;Nadine;ECO;63
Législatives 2012 - 1er tour;Législatives;2012;1;11;11ème circonscription;46;MALAKOFF;92046;18858;7608;11250;119;11131;METTON Jean-Loup;M;METTON;Jean-Loup;NCE;1588
Législatives 2012 - 1er tour;Législatives;2012;1;11;11ème circonscription;49;MONTROUGE;92049;27889;10680;17209;123;17086;JACQUES Alain;M;JACQUES;Alain;EXG;50
Législatives 2012 - 1er tour;Législatives;2012;1;6;6ème circonscription;51;NEUILLY SUR SEINE;92051;37031;14672;22359;177;22182;MAYHEAD Ioanna;F;MAYHEAD;Ioanna;FG;147
Législatives 2012 - 1er tour;Législatives;2012;1;6;6ème circonscription;62;PUTEAUX;92062;28253;11141;17112;441;16671;LECLERC Monique;F;LECLERC;Monique;EXG;47
Législatives 2012 - 1er tour;Législatives;2012;1;6;6ème circonscription;62;PUTEAUX;92062;28253;11141;17112;441;16671;MAYHEAD Ioanna;F;MAYHEAD;Ioanna;FG;603
Législatives 2012 - 1er tour;Législatives;2012;1;6;6ème circonscription;62;PUTEAUX;92062;28253;11141;17112;441;16671;THEVENET Audric;M;THEVENET;Audric;ECO;132
Législatives 2012 - 1er tour;Législatives;2012;1;4;4ème circonscription;73;SURESNES;92073;26492;10723;15769;302;15467;DJAZIRI Yacine;M;DJAZIRI;Yacine;SOC;3552
Législatives 2012 - 1er tour;Législatives;2012;1;4;4ème circonscription;73;SURESNES;92073;26492;10723;15769;302;15467;PUJOL Nicolas;M;PUJOL;Nicolas;AUT;67
Législatives 2012 - 1er tour;Législatives;2012;1;10;10ème circonscription;75;VANVES;92075;17559;6347;11212;104;11108;SCHMID Lucile;F;SCHMID;Lucile;VEC;3470
Législatives 2012 - 1er tour;Législatives;2012;1;10;10ème circonscription;75;VANVES;92075;17559;6347;11212;104;11108;KNITTEL Gautier;M;KNITTEL;Gautier;AUT;92
Législatives 2002 - 1er tour;Législatives;2002;1;2;2ème circonscription;4;ASNIERES SUR SEINE;92004;44110;17783;26327;312;26015;FRAGER Dominique;M;FRAGER;Dominique;VEC;630
Législatives 2002 - 1er tour;Législatives;2002;1;3;3ème circonscription;9;BOIS COLOMBES;92009;16245;6561;9684;288;9396;BERKOUKI Sarah;F;BERKOUKI;Sarah;DIV;51
Législatives 2002 - 1er tour;Législatives;2002;1;9;9ème circonscription;12;BOULOGNE BILLANCOURT;92012;60773;22422;38351;535;37816;GOITIA Isabelle;F;GOITIA;Isabelle;COM;370
Législatives 2002 - 1er tour;Législatives;2002;1;9;9ème circonscription;12;BOULOGNE BILLANCOURT;92012;60773;22422;38351;535;37816;GROLIERE Catherine;F;GROLIERE;Catherine;ECO;254
Législatives 2002 - 1er tour;Législatives;2002;1;10;10ème circonscription;12;BOULOGNE BILLANCOURT;92012;5551;2367;3184;78;3106;ARIPA Alain;M;ARIPA;Alain;MPF;54
Législatives 2002 - 1er tour;Législatives;2002;1;13;13ème circonscription;14;BOURG LA REINE;92014;13381;4391;8990;78;8912;FIE Dominique;M;FIE;Dominique;COM;189
Législatives 2002 - 1er tour;Législatives;2002;1;13;13ème circonscription;14;BOURG LA REINE;92014;13381;4391;8990;78;8912;DELRIEU Denis;M;DELRIEU;Denis;VEC;371
Législatives 2002 - 1er tour;Législatives;2002;1;12;12ème circonscription;20;CHATILLON;92020;20661;7083;13578;137;13441;ANTZENBERGER Philippe;M;ANTZENBERGER;Philippe;EXG;308
Législatives 2017 - 1er tour;Législatives;2017;1;1;1ère circonscription;36;GENNEVILLIERS;92036;22174;13223;8951;243;8708;FAUCILLON Elsa;F;FAUCILLON;Elsa;COM;3016
Législatives 2017 - 1er tour;Législatives;2017;1;1;1ère circonscription;36;GENNEVILLIERS;92036;22174;13223;8951;243;8708;GRIMAL Jean;M;GRIMAL;Jean;EXG;23
Législatives 2017 - 1er tour;Législatives;2017;1;5;5ème circonscription;24;CLICHY;92024;28620;14628;13992;265;13727;BIEUVILLE François-Xavier;M;BIEUVILLE;François-Xavier;DVD;742
Législatives 2017 - 1er tour;Législatives;2017;1;6;6ème circonscription;51;NEUILLY SUR SEINE;92051;37215;15249;21966;119;21847;DUBAIL Vincent;M;DUBAIL;Vincent;ECO;229
Législatives 2017 - 1er tour;Législatives;2017;1;4;4ème circonscription;73;SURESNES;92073;28524;12725;15799;423;15376;FLORENNES Isabelle;F;FLORENNES;Isabelle;REM;8163
Législatives 2017 - 1er tour;Législatives;2017;1;3;3ème circonscription;35;LA GARENNE COLOMBES;92035;18829;8238;10591;114;10477;PARIS Joëlle;F;PARIS;Joëlle;ECO;319
Législatives 2017 - 1er tour;Législatives;2017;1;4;4ème circonscription;50;NANTERRE;92050;47651;26455;21196;432;20764;BOUDJEMAÏ Zahra;F;BOUDJEMAÏ;Zahra;DVG;4378
Législatives 2017 - 1er tour;Législatives;2017;1;3;3ème circonscription;26;COURBEVOIE;92026;44322;19890;24432;415;24017;DORE Patricia;F;DORE;Patricia;ECO;111
Législatives 2017 - 1er tour;Législatives;2017;1;10;10ème circonscription;75;VANVES;92075;18507;7626;10881;125;10756;DRELON Marie-Thérèse;F;DRELON;Marie-Thérèse;DIV;148
Législatives 2017 - 1er tour;Législatives;2017;1;11;11ème circonscription;7;BAGNEUX;92007;21911;12424;9487;167;9320;BOUDJENAH Yasmine;F;BOUDJENAH;Yasmine;FI;3013
Législatives 2017 - 1er tour;Législatives;2017;1;10;10ème circonscription;75;VANVES;92075;18507;7626;10881;125;10756;CROS Stéphane;M;CROS;Stéphane;DIV;76
Législatives 2017 - 1er tour;Législatives;2017;1;11;11ème circonscription;49;MONTROUGE;92049;28914;12071;16843;175;16668;EL-BOUZAÏDI CHEIKHI Aze-Dine;M;EL-BOUZAÏDI CHEIKHI;Aze-Dine;ECO;25
Législatives 2017 - 1er tour;Législatives;2017;1;12;12ème circonscription;20;CHATILLON;92020;22311;9527;12784;186;12598;PREVEL Guillaume;M;PREVEL;Guillaume;DIV;198
Législatives 2017 - 1er tour;Législatives;2017;1;12;12ème circonscription;23;CLAMART;92023;35342;15954;19388;238;19150;LEROY Christophe;M;LEROY;Christophe;COM;209
Législatives 2017 - 1er tour;Législatives;2017;1;13;13ème circonscription;2;ANTONY;92002;41542;17216;24326;446;23880;CUKIERMAN Maurice;M;CUKIERMAN;Maurice;EXG;62
Législatives 2017 - 1er tour;Législatives;2017;1;13;13ème circonscription;2;ANTONY;92002;41542;17216;24326;446;23880;LANIER Benjamin;M;LANIER;Benjamin;SOC;1135
Législatives 2017 - 1er tour;Législatives;2017;1;13;13ème circonscription;19;CHATENAY MALABRY;92019;18752;8166;10586;245;10341;ROLLOT Franck;M;ROLLOT;Franck;EXG;56
Législatives 2017 - 1er tour;Législatives;2017;1;13;13ème circonscription;19;CHATENAY MALABRY;92019;18752;8166;10586;245;10341;NICOLAS Cédric;M;NICOLAS;Cédric;DVD;52
Législatives 2017 - 1er tour;Législatives;2017;1;13;13ème circonscription;71;SCEAUX;92071;15078;6395;8683;84;8599;LANIER Benjamin;M;LANIER;Benjamin;SOC;563
Législatives 2017 - 1er tour;Législatives;2017;1;13;13ème circonscription;71;SCEAUX;92071;15078;6395;8683;84;8599;FARCY-BRIANT Laurent;M;FARCY-BRIANT;Laurent;DIV;49
Législatives 2017 - 2ème tour;Législatives;2017;2;4;4ème circonscription;73;SURESNES;92073;28524;15171;13353;1351;12002;FLORENNES Isabelle;F;FLORENNES;Isabelle;REM;8142
Législatives 2017 - 2ème tour;Législatives;2017;2;6;6ème circonscription;26;COURBEVOIE;92026;8107;4853;3254;361;2893;LE GRIP Constance;F;LE GRIP;Constance;LR;1104
Législatives 2017 - 2ème tour;Législatives;2017;2;8;8ème circonscription;72;SEVRES;92072;15144;7789;7355;638;6717;BOYER Gilles;M;BOYER;Gilles;LR;2366
Législatives 2017 - 1er tour;Législatives;2017;1;9;9ème circonscription;12;BOULOGNE BILLANCOURT;92012;64984;30321;34663;987;33676;SOUSTIEL Délissia;F;SOUSTIEL;Délissia;EXG;185
Législatives 2017 - 1er tour;Législatives;2017;1;8;8ème circonscription;48;MEUDON;92048;25240;11059;14181;174;14007;MACHILLOT Alexandre;M;MACHILLOT;Alexandre;DIV;156
Législatives 2017 - 1er tour;Législatives;2017;1;10;10ème circonscription;12;BOULOGNE BILLANCOURT;92012;9082;4562;4520;114;4406;COUR Philippine;F;COUR;Philippine;DLF;48
Législatives 2017 - 1er tour;Législatives;2017;1;10;10ème circonscription;75;VANVES;92075;18507;7626;10881;125;10756;AMOROZ Boris;M;AMOROZ;Boris;COM;237
Législatives 2017 - 1er tour;Législatives;2017;1;8;8ème circonscription;47;MARNES LA COQUETTE;92047;1215;451;764;4;760;BOYER Gilles;M;BOYER;Gilles;LR;281
Législatives 2017 - 1er tour;Législatives;2017;1;3;3ème circonscription;26;COURBEVOIE;92026;44322;19890;24432;415;24017;GAULTIER Stéphane;M;GAULTIER;Stéphane;EXG;36
Présidentielles 1995 - 1er tour;Présidentielles;1995;1;;;14;BOURG LA REINE;92014;12770;3430;9340;135;9205;HUE ROBERT;M;HUE;ROBERT;;401
Présidentielles 1995 - 1er tour;Présidentielles;1995;1;;;20;CHATILLON;92020;16579;4065;12514;245;12269;HUE ROBERT;M;HUE;ROBERT;;1103
Présidentielles 1995 - 1er tour;Présidentielles;1995;1;;;22;CHAVILLE;92022;12177;2870;9307;170;9137;CHEMINADE JACQUES;M;CHEMINADE;JACQUES;;20
Présidentielles 1995 - 1er tour;Présidentielles;1995;1;;;35;LA GARENNE COLOMBES;92035;14104;3637;10467;225;10242;VILLIERS DE PHILIPPE;M;VILLIERS DE;PHILIPPE;;369
Présidentielles 1995 - 1er tour;Présidentielles;1995;1;;;36;GENNEVILLIERS;92036;19543;5563;13980;326;13654;JOSPIN LIONEL;M;JOSPIN;LIONEL;;3312
Présidentielles 1995 - 1er tour;Présidentielles;1995;1;;;40;ISSY LES MOULINEAUX;92040;30054;8139;21915;444;21471;JOSPIN LIONEL;M;JOSPIN;LIONEL;;5374
Présidentielles 1995 - 1er tour;Présidentielles;1995;1;;;48;MEUDON;92048;29714;7851;21863;352;21511;CHIRAC JACQUES;M;CHIRAC;JACQUES;;5448
Présidentielles 1995 - 1er tour;Présidentielles;1995;1;;;63;RUEIL MALMAISON;92063;44438;10571;33867;718;33149;CHEMINADE JACQUES;M;CHEMINADE;JACQUES;;57
Présidentielles 1995 - 1er tour;Présidentielles;1995;1;;;64;SAINT CLOUD;92064;18989;5119;13870;179;13691;BALLADUR EDOUARD;M;BALLADUR;EDOUARD;;3747
Présidentielles 1995 - 1er tour;Présidentielles;1995;1;;;71;SCEAUX;92071;13371;3073;10298;170;10128;VOYNET DOMINIQUE;F;VOYNET;DOMINIQUE;;355
Présidentielles 1995 - 1er tour;Présidentielles;1995;1;;;73;SURESNES;92073;21968;5851;16117;341;15776;JOSPIN LIONEL;M;JOSPIN;LIONEL;;3844
Présidentielles 1995 - 1er tour;Présidentielles;1995;1;;;76;VAUCRESSON;92076;5529;1334;4195;65;4130;LE PEN J.MARIE;M;LE PEN;J.MARIE;;366
Présidentielles 1995 - 1er tour;Présidentielles;1995;1;;;77;VILLE D'AVRAY;92077;7139;1490;5649;74;5575;LAGUILLER ARLETTE;F;LAGUILLER;ARLETTE;;154
Présidentielles 1995 - 2ème tour;Présidentielles;1995;2;;;36;GENNEVILLIERS;92036;19543;5757;13786;960;12826;JOSPIN LIONEL;M;JOSPIN;LIONEL;;8289
Présidentielles 1995 - 2ème tour;Présidentielles;1995;2;;;64;SAINT CLOUD;92064;18989;4088;14901;486;14415;JOSPIN LIONEL;M;JOSPIN;LIONEL;;3607
Présidentielles 1995 - 2ème tour;Présidentielles;1995;2;;;75;VANVES;92075;15604;2697;12907;537;12370;JOSPIN LIONEL;M;JOSPIN;LIONEL;;5469
Présidentielles 1995 - 1er tour;Présidentielles;1995;1;;;12;BOULOGNE BILLANCOURT;92012;58255;14334;43921;656;43265;VILLIERS DE PHILIPPE;M;VILLIERS DE;PHILIPPE;;1554
Législatives 2007 - 1er tour;Législatives;2007;1;6;6ème circonscription;51;NEUILLY SUR SEINE;92051;39134;14738;24396;185;24211;GONZALEZ David;M;GONZALEZ;David;DIV;0
Législatives 2007 - 1er tour;Législatives;2007;1;6;6ème circonscription;62;PUTEAUX;92062;26791;8829;17962;396;17566;HARMAND Alexandre;M;HARMAND;Alexandre;UDFD;1921
Législatives 2007 - 1er tour;Législatives;2007;1;6;6ème circonscription;62;PUTEAUX;92062;26791;8829;17962;396;17566;DANIS Thierry;M;DANIS;Thierry;COM;221
Législatives 2007 - 1er tour;Législatives;2007;1;4;4ème circonscription;73;SURESNES;92073;24666;8949;15717;206;15511;FRAYSSE Jacqueline;F;FRAYSSE;Jacqueline;COM;1797
Législatives 2007 - 1er tour;Législatives;2007;1;10;10ème circonscription;75;VANVES;92075;17351;5929;11422;137;11285;WOUTERS Nina;F;WOUTERS;Nina;EXG;234
Législatives 2007 - 1er tour;Législatives;2007;1;8;8ème circonscription;76;VAUCRESSON;92076;6076;2206;3870;46;3824;LUCET Francis;M;LUCET;Francis;EXG;8
Législatives 2007 - 1er tour;Législatives;2007;1;10;10ème circonscription;75;VANVES;92075;17351;5929;11422;137;11285;ARIPA Alain;M;ARIPA;Alain;MPF;127
Législatives 2007 - 1er tour;Législatives;2007;1;1;1ère circonscription;78;VILLENEUVE LA GARENNE;92078;13038;7211;5827;131;5696;LEGHMARA Leïla;F;LEGHMARA;Leïla;UDFD;397
Législatives 2007 - 1er tour;Législatives;2007;1;2;2ème circonscription;4;ASNIERES SUR SEINE;92004;44110;17783;26327;312;26015;SEMOUN Jean-Jacques;M;SEMOUN;Jean-Jacques;DVD;218
Législatives 2007 - 1er tour;Législatives;2007;1;11;11ème circonscription;7;BAGNEUX;92007;20520;8538;11982;178;11804;BOUKHEDIMI Patrick;M;BOUKHEDIMI;Patrick;EXG;45
Législatives 2007 - 1er tour;Législatives;2007;1;13;13ème circonscription;2;ANTONY;92002;39807;13942;25865;456;25409;BENLOLO Martine;F;BENLOLO;Martine;EXG;124
Législatives 2007 - 1er tour;Législatives;2007;1;13;13ème circonscription;2;ANTONY;92002;39807;13942;25865;456;25409;DELRIEU Denis;M;DELRIEU;Denis;VEC;1179
Législatives 2007 - 1er tour;Législatives;2007;1;10;10ème circonscription;12;BOULOGNE BILLANCOURT;92012;5551;2367;3184;78;3106;NAVIAUX Catherine;F;NAVIAUX;Catherine;VEC;117
Législatives 2007 - 1er tour;Législatives;2007;1;1;1ère circonscription;36;GENNEVILLIERS;92036;20048;9522;10526;189;10337;LEGHMARA Leïla;F;LEGHMARA;Leïla;UDFD;495
Législatives 2007 - 1er tour;Législatives;2007;1;11;11ème circonscription;46;MALAKOFF;92046;18478;7045;11433;204;11229;DADARE Sébastien;M;DADARE;Sébastien;DIV;102
Législatives 2007 - 1er tour;Législatives;2007;1;8;8ème circonscription;22;CHAVILLE;92022;12928;4682;8246;120;8126;CYROULNIK Marie-France;F;CYROULNIK;Marie-France;EXG;136
Législatives 2007 - 1er tour;Législatives;2007;1;12;12ème circonscription;23;CLAMART;92023;32916;11487;21429;154;21275;ANTZENBERGER Philippe;M;ANTZENBERGER;Philippe;EXG;384
Législatives 2007 - 1er tour;Législatives;2007;1;5;5ème circonscription;24;CLICHY;92024;28799;12380;16419;297;16122;MUZEAU Rémi;M;MUZEAU;Rémi;DVD;1848
Législatives 2007 - 1er tour;Législatives;2007;1;3;3ème circonscription;26;COURBEVOIE;92026;49151;19345;29806;541;29265;CHAGNON Louis;M;CHAGNON;Louis;MPF;278
Législatives 2007 - 1er tour;Législatives;2007;1;7;7ème circonscription;33;GARCHES;92033;12286;4601;7685;112;7573;CHOLLOU Sylvia;F;CHOLLOU;Sylvia;DIV;5
Législatives 2007 - 1er tour;Législatives;2007;1;8;8ème circonscription;47;MARNES LA COQUETTE;92047;1074;316;758;5;753;GUILLET Jean-Jacques;M;GUILLET;Jean-Jacques;UMP;567
Législatives 2007 - 1er tour;Législatives;2007;1;8;8ème circonscription;48;MEUDON;92048;25427;9683;15744;202;15542;SUCHARD Sophie;F;SUCHARD;Sophie;EXG;42
Législatives 2007 - 1er tour;Législatives;2007;1;6;6ème circonscription;51;NEUILLY SUR SEINE;92051;39134;14738;24396;185;24211;JEANNE Nadine;F;JEANNE;Nadine;SOC;1421
Législatives 2007 - 1er tour;Législatives;2007;1;8;8ème circonscription;72;SEVRES;92072;14460;5279;9181;151;9030;GUILLET Jean-Jacques;M;GUILLET;Jean-Jacques;UMP;4294
Législatives 2007 - 1er tour;Législatives;2007;1;1;1ère circonscription;25;COLOMBES;92025;26192;12273;13919;366;13553;BEN M'BAREK Hassan;M;BEN M'BAREK;Hassan;DIV;65
Législatives 2007 - 1er tour;Législatives;2007;1;3;3ème circonscription;26;COURBEVOIE;92026;49151;19345;29806;541;29265;BERKOUKI Sarah;F;BERKOUKI;Sarah;DIV;113
Législatives 2007 - 1er tour;Législatives;2007;1;2;2ème circonscription;25;COLOMBES;92025;18336;7144;11192;207;10985;VILLIERS Claire;F;VILLIERS;Claire;EXG;356
Législatives 2007 - 1er tour;Législatives;2007;1;2;2ème circonscription;25;COLOMBES;92025;18336;7144;11192;207;10985;JOURDAN Pascal;M;JOURDAN;Pascal;ECO;132
Législatives 2007 - 1er tour;Législatives;2007;1;2;2ème circonscription;25;COLOMBES;92025;18336;7144;11192;207;10985;MASSOL Hubert;M;MASSOL;Hubert;EXD;48
Présidentielles 2002 - 1er tour;Présidentielles;2002;1;;;9;BOIS COLOMBES;92009;13996;4554;9442;200;9242;CHEVENEMENT JEAN-PIERRE;M;CHEVENEMENT;JEAN-PIERRE;;680
Présidentielles 2002 - 1er tour;Présidentielles;2002;1;;;12;BOULOGNE BILLANCOURT;92012;57382;17570;39812;645;39167;JOSPIN LIONEL;M;JOSPIN;LIONEL;;5794
Présidentielles 2002 - 1er tour;Présidentielles;2002;1;;;14;BOURG LA REINE;92014;12075;3519;8556;149;8407;TAUBIRA CHRISTIANE;F;TAUBIRA;CHRISTIANE;;299
Présidentielles 2002 - 1er tour;Présidentielles;2002;1;;;14;BOURG LA REINE;92014;12075;3519;8556;149;8407;BESANCENOT OLIVIER;M;BESANCENOT;OLIVIER;;243
Présidentielles 2002 - 1er tour;Présidentielles;2002;1;;;22;CHAVILLE;92022;12122;3826;8296;162;8134;HUE ROBERT;M;HUE;ROBERT;;223
Présidentielles 2002 - 1er tour;Présidentielles;2002;1;;;22;CHAVILLE;92022;12122;3826;8296;162;8134;MADELIN ALAIN;M;MADELIN;ALAIN;;433
Présidentielles 2002 - 1er tour;Présidentielles;2002;1;;;26;COURBEVOIE;92026;39941;11959;27982;520;27462;GLUCKSTEIN DANIEL;M;GLUCKSTEIN;DANIEL;;75
Présidentielles 2002 - 1er tour;Présidentielles;2002;1;;;26;COURBEVOIE;92026;39941;11959;27982;520;27462;JOSPIN LIONEL;M;JOSPIN;LIONEL;;4253
Présidentielles 2002 - 1er tour;Présidentielles;2002;1;;;26;COURBEVOIE;92026;39941;11959;27982;520;27462;LAGUILLER ARLETTE;F;LAGUILLER;ARLETTE;;900
Présidentielles 2002 - 1er tour;Présidentielles;2002;1;;;48;MEUDON;92048;28283;9341;18942;321;18621;LAGUILLER ARLETTE;F;LAGUILLER;ARLETTE;;682
Présidentielles 2002 - 1er tour;Présidentielles;2002;1;;;49;MONTROUGE;92049;23382;8142;15240;301;14939;MAMERE NOEL;M;MAMERE;NOEL;;1075
Présidentielles 2002 - 1er tour;Présidentielles;2002;1;;;62;PUTEAUX;92062;23861;6804;17057;487;16570;BESANCENOT OLIVIER;M;BESANCENOT;OLIVIER;;500
Présidentielles 2002 - 1er tour;Présidentielles;2002;1;;;64;SAINT CLOUD;92064;17818;6028;11790;141;11649;BESANCENOT OLIVIER;M;BESANCENOT;OLIVIER;;136
Présidentielles 2002 - 1er tour;Présidentielles;2002;1;;;75;VANVES;92075;15493;4648;10845;221;10624;JOSPIN LIONEL;M;JOSPIN;LIONEL;;2113
Présidentielles 2002 - 1er tour;Présidentielles;2002;1;;;75;VANVES;92075;15493;4648;10845;221;10624;BOUTIN CHRISTINE;F;BOUTIN;CHRISTINE;;132
Présidentielles 2002 - 1er tour;Présidentielles;2002;1;;;76;VAUCRESSON;92076;5861;2048;3813;62;3751;BESANCENOT OLIVIER;M;BESANCENOT;OLIVIER;;62
Présidentielles 2012 - 1er tour;Présidentielles;2012;1;;;12;BOULOGNE BILLANCOURT;92012;67579;13310;54269;818;53451;SARKOZY Nicolas;M;SARKOZY;Nicolas;;25891
Présidentielles 2012 - 1er tour;Présidentielles;2012;1;;;12;BOULOGNE BILLANCOURT;92012;67579;13310;54269;818;53451;CHEMINADE Jacques;M;CHEMINADE;Jacques;;99
Présidentielles 2012 - 1er tour;Présidentielles;2012;1;;;22;CHAVILLE;92022;12768;2527;10241;147;10094;DUPONT-AIGNAN Nicolas;M;DUPONT-AIGNAN;Nicolas;;169
Présidentielles 2012 - 1er tour;Présidentielles;2012;1;;;24;CLICHY;92024;29226;6786;22440;374;22066;SARKOZY Nicolas;M;SARKOZY;Nicolas;;4422
Présidentielles 2012 - 1er tour;Présidentielles;2012;1;;;24;CLICHY;92024;29226;6786;22440;374;22066;DUPONT-AIGNAN Nicolas;M;DUPONT-AIGNAN;Nicolas;;289
Présidentielles 2012 - 1er tour;Présidentielles;2012;1;;;25;COLOMBES;92025;44741;10181;34560;526;34034;LE PEN Marine;F;LE PEN;Marine;;3435
Présidentielles 2012 - 1er tour;Présidentielles;2012;1;;;25;COLOMBES;92025;44741;10181;34560;526;34034;CHEMINADE Jacques;M;CHEMINADE;Jacques;;104
Présidentielles 2012 - 1er tour;Présidentielles;2012;1;;;46;MALAKOFF;92046;18852;4162;14690;207;14483;MÉLENCHON Jean-Luc;M;MÉLENCHON;Jean-Luc;;3340
Présidentielles 2012 - 1er tour;Présidentielles;2012;1;;;47;MARNES LA COQUETTE;92047;1082;163;919;8;911;MÉLENCHON Jean-Luc;M;MÉLENCHON;Jean-Luc;;26
Présidentielles 2012 - 1er tour;Présidentielles;2012;1;;;50;NANTERRE;92050;44307;10435;33872;654;33218;ARTHAUD Nathalie;F;ARTHAUD;Nathalie;;180
Présidentielles 2012 - 1er tour;Présidentielles;2012;1;;;62;PUTEAUX;92062;28189;5597;22592;470;22122;BAYROU François;M;BAYROU;François;;2492
Présidentielles 2012 - 1er tour;Présidentielles;2012;1;;;64;SAINT CLOUD;92064;18973;3529;15444;153;15291;LE PEN Marine;F;LE PEN;Marine;;1279
Présidentielles 2012 - 1er tour;Présidentielles;2012;1;;;72;SEVRES;92072;14837;2876;11961;219;11742;JOLY Eva;F;JOLY;Eva;;424
Présidentielles 2012 - 1er tour;Présidentielles;2012;1;;;75;VANVES;92075;17512;3079;14433;161;14272;ARTHAUD Nathalie;F;ARTHAUD;Nathalie;;41
Présidentielles 2012 - 1er tour;Présidentielles;2012;1;;;75;VANVES;92075;17512;3079;14433;161;14272;CHEMINADE Jacques;M;CHEMINADE;Jacques;;38
Présidentielles 2012 - 1er tour;Présidentielles;2012;1;;;77;VILLE D'AVRAY;92077;7132;1060;6072;80;5992;ARTHAUD Nathalie;F;ARTHAUD;Nathalie;;11
Présidentielles 2007 - 1er tour;Présidentielles;2007;1;;;2;ANTONY;92002;39316;4695;34621;413;34208;BUFFET Marie-George;F;BUFFET;Marie-George;;594
Présidentielles 2007 - 1er tour;Présidentielles;2007;1;;;9;BOIS COLOMBES;92009;16113;2534;13579;152;13427;SCHIVARDI Gérard;M;SCHIVARDI;Gérard;;26
Présidentielles 2007 - 1er tour;Présidentielles;2007;1;;;24;CLICHY;92024;28539;4472;24067;245;23822;VOYNET Dominique;F;VOYNET;Dominique;;384
Présidentielles 2007 - 1er tour;Présidentielles;2007;1;;;33;GARCHES;92033;11957;1346;10611;106;10505;VOYNET Dominique;F;VOYNET;Dominique;;152
Présidentielles 2007 - 1er tour;Présidentielles;2007;1;;;33;GARCHES;92033;11957;1346;10611;106;10505;ROYAL Ségolène;F;ROYAL;Ségolène;;1764
Présidentielles 2007 - 1er tour;Présidentielles;2007;1;;;35;LA GARENNE COLOMBES;92035;16350;1826;14524;117;14407;BAYROU François;M;BAYROU;François;;3104
Présidentielles 2007 - 1er tour;Présidentielles;2007;1;;;46;MALAKOFF;92046;18259;2640;15619;178;15441;LAGUILLER Arlette;F;LAGUILLER;Arlette;;164
Présidentielles 2007 - 1er tour;Présidentielles;2007;1;;;47;MARNES LA COQUETTE;92047;1054;91;963;9;954;LAGUILLER Arlette;F;LAGUILLER;Arlette;;7
Présidentielles 2007 - 1er tour;Présidentielles;2007;1;;;50;NANTERRE;92050;42083;6117;35966;477;35489;NIHOUS Frédéric;M;NIHOUS;Frédéric;;81
Présidentielles 2007 - 1er tour;Présidentielles;2007;1;;;62;PUTEAUX;92062;26761;3397;23364;263;23101;ROYAL Ségolène;F;ROYAL;Ségolène;;5496
Présidentielles 2007 - 1er tour;Présidentielles;2007;1;;;63;RUEIL MALMAISON;92063;50540;5920;44620;393;44227;SCHIVARDI Gérard;M;SCHIVARDI;Gérard;;73
Présidentielles 2007 - 1er tour;Présidentielles;2007;1;;;71;SCEAUX;92071;13824;1539;12285;86;12199;NIHOUS Frédéric;M;NIHOUS;Frédéric;;26
Présidentielles 2007 - 1er tour;Présidentielles;2007;1;;;72;SEVRES;92072;14178;1738;12440;129;12311;VOYNET Dominique;F;VOYNET;Dominique;;194
Présidentielles 2007 - 1er tour;Présidentielles;2007;1;;;76;VAUCRESSON;92076;5902;781;5121;42;5079;NIHOUS Frédéric;M;NIHOUS;Frédéric;;16
Présidentielles 2007 - 1er tour;Présidentielles;2007;1;;;78;VILLENEUVE LA GARENNE;92078;12897;2898;9999;145;9854;BUFFET Marie-George;F;BUFFET;Marie-George;;140
Présidentielles 2007 - 1er tour;Présidentielles;2007;1;;;78;VILLENEUVE LA GARENNE;92078;12897;2898;9999;145;9854;BOVÉ José;M;BOVÉ;José;;91
Présidentielles 2017 - 1er tour;Présidentielles;2017;1;;;9;BOIS COLOMBES;92009;17896;3242;14654;318;14336;DUPONT-AIGNAN Nicolas;M;DUPONT-AIGNAN;Nicolas;;399
Présidentielles 2017 - 1er tour;Présidentielles;2017;1;;;14;BOURG LA REINE;92014;13769;2202;11567;212;11355;FILLON François;M;FILLON;François;;3189
Présidentielles 2017 - 1er tour;Présidentielles;2017;1;;;20;CHATILLON;92020;22292;3682;18610;351;18259;MÉLENCHON Jean-Luc;M;MÉLENCHON;Jean-Luc;;3536
Présidentielles 2017 - 1er tour;Présidentielles;2017;1;;;24;CLICHY;92024;28553;5564;22989;498;22491;FILLON François;M;FILLON;François;;3292
Présidentielles 2017 - 1er tour;Présidentielles;2017;1;;;25;COLOMBES;92025;47454;9714;37740;907;36833;CHEMINADE Jacques;M;CHEMINADE;Jacques;;75
Présidentielles 2017 - 1er tour;Présidentielles;2017;1;;;25;COLOMBES;92025;47454;9714;37740;907;36833;HAMON Benoît;M;HAMON;Benoît;;3098
Présidentielles 2017 - 1er tour;Présidentielles;2017;1;;;26;COURBEVOIE;92026;52391;9609;42782;817;41965;CHEMINADE Jacques;M;CHEMINADE;Jacques;;60
Présidentielles 2017 - 1er tour;Présidentielles;2017;1;;;36;GENNEVILLIERS;92036;22149;5526;16623;490;16133;FILLON François;M;FILLON;François;;1164
Présidentielles 2017 - 1er tour;Présidentielles;2017;1;;;44;LEVALLOIS PERRET;92044;41716;6107;35609;511;35098;DUPONT-AIGNAN Nicolas;M;DUPONT-AIGNAN;Nicolas;;811
Présidentielles 2017 - 1er tour;Présidentielles;2017;1;;;46;MALAKOFF;92046;18434;3186;15248;268;14979;HAMON Benoît;M;HAMON;Benoît;;1650
Présidentielles 2017 - 1er tour;Présidentielles;2017;1;;;48;MEUDON;92048;31280;5715;25565;405;25160;MACRON Emmanuel;M;MACRON;Emmanuel;;8239
Présidentielles 2017 - 1er tour;Présidentielles;2017;1;;;63;RUEIL MALMAISON;92063;54426;9298;45128;713;44414;ASSELINEAU François;M;ASSELINEAU;François;;400
Présidentielles 2017 - 1er tour;Présidentielles;2017;1;;;71;SCEAUX;92071;15052;2914;12138;145;11993;ARTHAUD Nathalie;F;ARTHAUD;Nathalie;;21
Présidentielles 2017 - 1er tour;Présidentielles;2017;1;;;73;SURESNES;92073;28497;4342;24155;520;23635;HAMON Benoît;M;HAMON;Benoît;;1427
Présidentielles 2017 - 1er tour;Présidentielles;2017;1;;;75;VANVES;92075;18500;3228;15272;248;15024;DUPONT-AIGNAN Nicolas;M;DUPONT-AIGNAN;Nicolas;;388
Présidentielles 2017 - 1er tour;Présidentielles;2017;1;;;76;VAUCRESSON;92076;6176;835;5341;72;5269;FILLON François;M;FILLON;François;;2653
Présidentielles 2002 - 2ème tour;Présidentielles;2002;2;;;4;ASNIERES SUR SEINE;92004;35708;6723;28985;905;28080;LE PEN JEAN-MARIE;M;LE PEN;JEAN-MARIE;;3794
Présidentielles 2002 - 2ème tour;Présidentielles;2002;2;;;12;BOULOGNE BILLANCOURT;92012;57397;10488;46909;1202;45707;LE PEN JEAN-MARIE;M;LE PEN;JEAN-MARIE;;4982
Présidentielles 2002 - 2ème tour;Présidentielles;2002;2;;;36;GENNEVILLIERS;92036;18215;4731;13484;577;12907;CHIRAC JACQUES;M;CHIRAC;JACQUES;;11116
Présidentielles 2002 - 2ème tour;Présidentielles;2002;2;;;48;MEUDON;92048;28289;5448;22841;707;22134;CHIRAC JACQUES;M;CHIRAC;JACQUES;;19695
Présidentielles 2002 - 2ème tour;Présidentielles;2002;2;;;77;VILLE D'AVRAY;92077;7249;1193;6056;116;5940;CHIRAC JACQUES;M;CHIRAC;JACQUES;;5392
Présidentielles 2007 - 2ème tour;Présidentielles;2007;2;;;20;CHATILLON;92020;20472;2480;17992;669;17323;SARKOZY Nicolas;M;SARKOZY;Nicolas;;8762
Présidentielles 2007 - 2ème tour;Présidentielles;2007;2;;;35;LA GARENNE COLOMBES;92035;16356;2112;14244;525;13719;ROYAL Ségolène;F;ROYAL;Ségolène;;5188
Présidentielles 2007 - 2ème tour;Présidentielles;2007;2;;;64;SAINT CLOUD;92064;18486;2227;16259;511;15748;SARKOZY Nicolas;M;SARKOZY;Nicolas;;11681
Présidentielles 2017 - 2ème tour;Présidentielles;2017;2;;;12;BOULOGNE BILLANCOURT;92012;74030;16351;57679;4671;53008;MACRON Emmanuel;M;MACRON;Emmanuel;;47003
Présidentielles 2017 - 2ème tour;Présidentielles;2017;2;;;14;BOURG LA REINE;92014;13769;2887;10882;941;9941;LE PEN Marine;F;LE PEN;Marine;;1216
Présidentielles 2017 - 2ème tour;Présidentielles;2017;2;;;77;VILLE D'AVRAY;92077;7433;1235;6198;479;5719;LE PEN Marine;F;LE PEN;Marine;;666
Législatives 1993 - 1er tour;Législatives;1993;1;2;2ème circonscription;4;ASNIERES SUR SEINE;92004;37314;11544;25770;852;24918;TRANCHANT GEORGES;M;TRANCHANT;GEORGES;RPR;6566
Législatives 1993 - 1er tour;Législatives;1993;1;2;2ème circonscription;4;ASNIERES SUR SEINE;92004;37314;11544;25770;852;24918;MATET EVELYNE;F;MATET;EVELYNE;DIV;317
Législatives 1993 - 1er tour;Législatives;1993;1;2;2ème circonscription;4;ASNIERES SUR SEINE;92004;37314;11544;25770;852;24918;MACE J.PAUL;M;MACE;J.PAUL;EXG;410
Législatives 1993 - 1er tour;Législatives;1993;1;11;11ème circonscription;7;BAGNEUX;92007;21150;7754;13396;474;12922;POUSSIER MARTIAL;M;POUSSIER;MARTIAL;MAJ;49
Législatives 1993 - 1er tour;Législatives;1993;1;12;12ème circonscription;20;CHATILLON;92020;15705;4455;11250;435;10815;GRIELEN ALAIN;M;GRIELEN;ALAIN;MAJ;108
Législatives 1993 - 1er tour;Législatives;1993;1;7;7ème circonscription;64;SAINT CLOUD;92064;19166;6250;12916;429;12487;WAGNER JACQUES;M;WAGNER;JACQUES;DVD;66
Législatives 1993 - 1er tour;Législatives;1993;1;13;13ème circonscription;71;SCEAUX;92071;13127;3574;9553;306;9247;GAZZOLA DANIEL;M;GAZZOLA;DANIEL;FRN;1023
Législatives 1993 - 1er tour;Législatives;1993;1;1;1ère circonscription;25;COLOMBES;92025;26594;9512;17082;693;16389;PREVOT ROGER;M;PREVOT;ROGER;UDF;3078
Législatives 1993 - 1er tour;Législatives;1993;1;1;1ère circonscription;78;VILLENEUVE LA GARENNE;92078;11604;4168;7436;212;7224;LE GALLOU J.YVES;M;LE GALLOU;J.YVES;FRN;1314
Législatives 1993 - 2ème tour;Législatives;1993;2;2;2ème circonscription;4;ASNIERES SUR SEINE;92004;37314;14413;22901;3359;19542;TAITTINGER FRANTZ;M;TAITTINGER;FRANTZ;DVD;12302
Législatives 1993 - 2ème tour;Législatives;1993;2;13;13ème circonscription;19;CHATENAY MALABRY;92019;17809;6289;11520;705;10815;MERLE J.FRANCOIS;M;MERLE;J.FRANCOIS;SOC;5221
Législatives 1993 - 1er tour;Législatives;1993;1;8;8ème circonscription;77;VILLE D'AVRAY;92077;7199;1786;5413;149;5264;NICOLAS PATRICK;M;NICOLAS;PATRICK;DVD;11
Législatives 1993 - 1er tour;Législatives;1993;1;3;3ème circonscription;9;BOIS COLOMBES;92009;14392;4251;10141;422;9719;MARSAULT PHILIPPE;M;MARSAULT;PHILIPPE;EXG;196
Législatives 1993 - 1er tour;Législatives;1993;1;9;9ème circonscription;12;BOULOGNE BILLANCOURT;92012;53509;17387;36122;1224;34898;ALLARD JEAN;M;ALLARD;JEAN;FRN;3878
Législatives 1993 - 1er tour;Législatives;1993;1;13;13ème circonscription;19;CHATENAY MALABRY;92019;17809;6223;11586;435;11151;AUBRY ANDRE;M;AUBRY;ANDRE;COM;995
Législatives 1993 - 1er tour;Législatives;1993;1;11;11ème circonscription;7;BAGNEUX;92007;21150;7754;13396;474;12922;JAMBU JANINE;F;JAMBU;JANINE;COM;3627
Législatives 1993 - 1er tour;Législatives;1993;1;3;3ème circonscription;35;LA GARENNE COLOMBES;92035;13664;4290;9374;347;9027;BRIGAND CATHERINE;F;BRIGAND;CATHERINE;GEC;880
Législatives 1993 - 1er tour;Législatives;1993;1;11;11ème circonscription;49;MONTROUGE;92049;22632;7554;15078;554;14524;RAKETITCH RAOUL;M;RAKETITCH;RAOUL;FRN;1514
Législatives 1993 - 1er tour;Législatives;1993;1;11;11ème circonscription;49;MONTROUGE;92049;22632;7554;15078;554;14524;AFONSO HENRI;M;AFONSO;HENRI;DIV;139
Législatives 1993 - 1er tour;Législatives;1993;1;4;4ème circonscription;50;NANTERRE;92050;38007;11484;26523;795;25728;ALLAIN MICHEL;M;ALLAIN;MICHEL;EXG;144
Législatives 1993 - 1er tour;Législatives;1993;1;10;10ème circonscription;75;VANVES;92075;15286;4324;10962;394;10568;HERVO DIDIER;M;HERVO;DIDIER;VEC;1035
Législatives 1993 - 1er tour;Législatives;1993;1;10;10ème circonscription;75;VANVES;92075;15286;4324;10962;394;10568;PEYNAUD JEAN;M;PEYNAUD;JEAN;MAJ;161
Législatives 1993 - 1er tour;Législatives;1993;1;5;5ème circonscription;44;LEVALLOIS PERRET;92044;27392;7486;19906;624;19282;DUPREZ PAUL;M;DUPREZ;PAUL;GEC;1438
Législatives 1993 - 1er tour;Législatives;1993;1;10;10ème circonscription;40;ISSY LES MOULINEAUX;92040;29377;9425;19952;648;19304;VASSEUR J.YVES;M;VASSEUR;J.YVES;COM;1364
Législatives 1993 - 1er tour;Législatives;1993;1;11;11ème circonscription;46;MALAKOFF;92046;19559;6951;12608;416;12192;NGUYEN M.FRANCE;F;NGUYEN;M.FRANCE;DIV;236
Législatives 1993 - 1er tour;Législatives;1993;1;8;8ème circonscription;48;MEUDON;92048;25126;7628;17498;529;16969;GODICHEAU PIERRE;M;GODICHEAU;PIERRE;DVD;150
Législatives 1993 - 1er tour;Législatives;1993;1;8;8ème circonscription;48;MEUDON;92048;25126;7628;17498;529;16969;BRISSAUD SOPHIE;F;BRISSAUD;SOPHIE;FRN;1660
Législatives 1993 - 1er tour;Législatives;1993;1;8;8ème circonscription;72;SEVRES;92072;13536;3690;9846;336;9510;KONOPNICKI GUY;M;KONOPNICKI;GUY;GEC;1108
Législatives 2002 - 1er tour;Législatives;2002;1;11;11ème circonscription;7;BAGNEUX;92007;20520;8538;11982;178;11804;BARBEROUSSE Olivier;M;BARBEROUSSE;Olivier;EXG;327
Législatives 2002 - 1er tour;Législatives;2002;1;11;11ème circonscription;7;BAGNEUX;92007;20520;8538;11982;178;11804;BOUKHEDIMI Patrick;M;BOUKHEDIMI;Patrick;EXG;45
Législatives 2002 - 1er tour;Législatives;2002;1;9;9ème circonscription;12;BOULOGNE BILLANCOURT;92012;60773;22422;38351;535;37816;BRUNET Françoise;F;BRUNET;Françoise;EXG;101
Législatives 2002 - 1er tour;Législatives;2002;1;10;10ème circonscription;12;BOULOGNE BILLANCOURT;92012;5551;2367;3184;78;3106;DROUET Valérie;F;DROUET;Valérie;EXD;12
Législatives 2002 - 1er tour;Législatives;2002;1;13;13ème circonscription;14;BOURG LA REINE;92014;13381;4391;8990;78;8912;BASTIDE Anne;F;BASTIDE;Anne;ECO;71
Législatives 2002 - 1er tour;Législatives;2002;1;12;12ème circonscription;23;CLAMART;92023;32916;11487;21429;154;21275;DIAZ GOMEZ Elisabeth;F;DIAZ GOMEZ;Elisabeth;DIV;0
Législatives 2002 - 1er tour;Législatives;2002;1;5;5ème circonscription;24;CLICHY;92024;28799;12380;16419;297;16122;DUTILLOY Marie-Catherine;F;DUTILLOY;Marie-Catherine;ECO;153
Législatives 2002 - 1er tour;Législatives;2002;1;2;2ème circonscription;25;COLOMBES;92025;18336;7144;11192;207;10985;FISCHER Josiane;F;FISCHER;Josiane;DVD;188
Législatives 2002 - 1er tour;Législatives;2002;1;12;12ème circonscription;32;FONTENAY AUX ROSES;92032;15468;5605;9863;84;9779;DELMATTO Geneviève;F;DELMATTO;Geneviève;EXD;47
Législatives 2002 - 1er tour;Législatives;2002;1;3;3ème circonscription;35;LA GARENNE COLOMBES;92035;16552;5947;10605;101;10504;BERKOUKI Sarah;F;BERKOUKI;Sarah;DIV;25
Législatives 2002 - 1er tour;Législatives;2002;1;10;10ème circonscription;40;ISSY LES MOULINEAUX;92040;38520;14017;24503;359;24144;BOTTET Philippe;M;BOTTET;Philippe;EXG;51
Législatives 2002 - 1er tour;Législatives;2002;1;11;11ème circonscription;46;MALAKOFF;92046;18478;7045;11433;204;11229;KADRI Malika;F;KADRI;Malika;DIV;56
Législatives 2002 - 1er tour;Législatives;2002;1;11;11ème circonscription;49;MONTROUGE;92049;26595;9698;16897;213;16684;GALATEAU Marie-Thérèse;F;GALATEAU;Marie-Thérèse;EXD;162
Législatives 2002 - 1er tour;Législatives;2002;1;6;6ème circonscription;62;PUTEAUX;92062;26791;8829;17962;396;17566;EISENBERG Mathilde;F;EISENBERG;Mathilde;EXG;304
Législatives 2002 - 1er tour;Législatives;2002;1;6;6ème circonscription;62;PUTEAUX;92062;26791;8829;17962;396;17566;FROMANTIN Jean-Christophe;M;FROMANTIN;Jean-Christophe;DIV;799
Législatives 2002 - 1er tour;Législatives;2002;1;6;6ème circonscription;62;PUTEAUX;92062;26791;8829;17962;396;17566;GONZALEZ David;M;GONZALEZ;David;DIV;7
Législatives 2002 - 1er tour;Législatives;2002;1;6;6ème circonscription;62;PUTEAUX;92062;26791;8829;17962;396;17566;STRAUSS Anne-Christine;F;STRAUSS;Anne-Christine;FN;652
Législatives 2002 - 1er tour;Législatives;2002;1;6;6ème circonscription;62;PUTEAUX;92062;26791;8829;17962;396;17566;LARAQUE Isabelle;F;LARAQUE;Isabelle;EXD;71
Législatives 2002 - 1er tour;Législatives;2002;1;7;7ème circonscription;63;RUEIL MALMAISON;92063;51481;18902;32579;337;32242;TERRAZZONI Valérie;F;TERRAZZONI;Valérie;DIV;178
Législatives 2002 - 1er tour;Législatives;2002;1;7;7ème circonscription;63;RUEIL MALMAISON;92063;51481;18902;32579;337;32242;FARCIS Dominique;M;FARCIS;Dominique;DVD;82
Législatives 2002 - 1er tour;Législatives;2002;1;13;13ème circonscription;71;SCEAUX;92071;14129;4679;9450;74;9376;HOLLEBEKE Dominique;F;HOLLEBEKE;Dominique;MPF;106
Législatives 2002 - 1er tour;Législatives;2002;1;10;10ème circonscription;75;VANVES;92075;17351;5929;11422;137;11285;SCHMID Lucille;F;SCHMID;Lucille;SOC;3333
Législatives 2002 - 1er tour;Législatives;2002;1;8;8ème circonscription;76;VAUCRESSON;92076;6076;2206;3870;46;3824;RAFFALI Danielle;F;RAFFALI;Danielle;ECO;40
Législatives 2002 - 1er tour;Législatives;2002;1;1;1ère circonscription;78;VILLENEUVE LA GARENNE;92078;13038;7211;5827;131;5696;JEAN Yves;M;JEAN;Yves;DVD;18
Législatives 1997 - 1er tour;Législatives;1997;1;10;10ème circonscription;40;ISSY LES MOULINEAUX;92040;30164;10899;19265;543;18722;VIDAL ISABELLE;F;VIDAL;ISABELLE;EXG;106
Législatives 1997 - 1er tour;Législatives;1997;1;10;10ème circonscription;40;ISSY LES MOULINEAUX;92040;30164;10899;19265;543;18722;DAUJON XAVIER;M;DAUJON;XAVIER;DVD;350
Législatives 1997 - 1er tour;Législatives;1997;1;1;1ère circonscription;36;GENNEVILLIERS;92036;19277;7226;12051;295;11756;LE GALLOU J.YVES;M;LE GALLOU;J.YVES;FRN;2170
Législatives 1997 - 1er tour;Législatives;1997;1;5;5ème circonscription;44;LEVALLOIS PERRET;92044;28281;9315;18966;650;18316;COURT MIREILLE;F;COURT;MIREILLE;EXG;112
Législatives 1997 - 1er tour;Législatives;1997;1;3;3ème circonscription;35;LA GARENNE COLOMBES;92035;13992;5163;8829;294;8535;PEREZ CHRISTIAN;M;PEREZ;CHRISTIAN;FRN;1252
Législatives 1997 - 1er tour;Législatives;1997;1;12;12ème circonscription;32;FONTENAY AUX ROSES;92032;14748;4655;10093;259;9834;ILTIS DANIELLE;F;ILTIS;DANIELLE;EXG;41
Législatives 1997 - 1er tour;Législatives;1997;1;12;12ème circonscription;32;FONTENAY AUX ROSES;92032;14748;4655;10093;259;9834;LE BERRE ALAIN;M;LE BERRE;ALAIN;FRN;1055
Législatives 1997 - 1er tour;Législatives;1997;1;7;7ème circonscription;33;GARCHES;92033;11323;3745;7578;290;7288;MUGNIER JEANNINE;F;MUGNIER;JEANNINE;EXG;99
Législatives 1997 - 1er tour;Législatives;1997;1;10;10ème circonscription;12;BOULOGNE BILLANCOURT;92012;4529;1717;2812;99;2713;HERVO DIDIER;M;HERVO;DIDIER;ECO;91
Législatives 1997 - 1er tour;Législatives;1997;1;2;2ème circonscription;25;COLOMBES;92025;17603;6110;11493;415;11078;DEBIONNE ALAIN;M;DEBIONNE;ALAIN;DVD;310
Législatives 1997 - 1er tour;Législatives;1997;1;1;1ère circonscription;25;COLOMBES;92025;26238;10153;16085;513;15572;ORGET GERARD;M;ORGET;GERARD;EXD;115
Législatives 1997 - 1er tour;Législatives;1997;1;9;9ème circonscription;12;BOULOGNE BILLANCOURT;92012;53287;18902;34385;948;33437;GORSE GEORGES;M;GORSE;GEORGES;RPR;4795
Législatives 1997 - 1er tour;Législatives;1997;1;13;13ème circonscription;2;ANTONY;92002;37772;12082;25690;861;24829;RIVIERE ALAIN;M;RIVIERE;ALAIN;DVD;731
Législatives 1997 - 1er tour;Législatives;1997;1;4;4ème circonscription;73;SURESNES;92073;20985;7217;13768;441;13327;MARSAULT PHILIPPE;M;MARSAULT;PHILIPPE;EXG;202
Législatives 1997 - 1er tour;Législatives;1997;1;13;13ème circonscription;71;SCEAUX;92071;13168;3887;9281;266;9015;LETTRON J.PIERRE;M;LETTRON;J.PIERRE;DVG;177
Législatives 1997 - 1er tour;Législatives;1997;1;7;7ème circonscription;63;RUEIL MALMAISON;92063;44715;14813;29902;1094;28808;TRON ROGER;M;TRON;ROGER;DVD;764
Législatives 1997 - 1er tour;Législatives;1997;1;6;6ème circonscription;62;PUTEAUX;92062;24329;8862;15467;635;14832;GIRONDE DE OLIVIER;M;GIRONDE DE;OLIVIER;ECO;725
Législatives 1997 - 1er tour;Législatives;1997;1;6;6ème circonscription;62;PUTEAUX;92062;24329;8862;15467;635;14832;LIGONIE B.XAVIER;M;LIGONIE;B.XAVIER;FRN;2327
Législatives 1997 - 1er tour;Législatives;1997;1;8;8ème circonscription;76;VAUCRESSON;92076;5546;1861;3685;139;3546;LEVAIN JEAN;M;LEVAIN;JEAN;PRS;508
Législatives 1997 - 1er tour;Législatives;1997;1;5;5ème circonscription;24;CLICHY;92024;23725;8942;14783;486;14297;CHAZEAUX DE OLIVIER;M;CHAZEAUX DE;OLIVIER;RPR;2985
Législatives 1997 - 1er tour;Législatives;1997;1;5;5ème circonscription;24;CLICHY;92024;23725;8942;14783;486;14297;BALKANY ISABELLE;F;BALKANY;ISABELLE;DVD;407
Législatives 1997 - 1er tour;Législatives;1997;1;12;12ème circonscription;23;CLAMART;92023;30471;10310;20161;590;19571;LARCHER ROBERT;M;LARCHER;ROBERT;EXG;447
Législatives 1997 - 1er tour;Législatives;1997;1;8;8ème circonscription;48;MEUDON;92048;24248;8136;16112;629;15483;JASSERAND BERNARD;M;JASSERAND;BERNARD;COM;1432
Législatives 1997 - 1er tour;Législatives;1997;1;11;11ème circonscription;49;MONTROUGE;92049;21975;7943;14032;388;13644;PRUNIER ROBERT;M;PRUNIER;ROBERT;DVD;8
Législatives 1997 - 1er tour;Législatives;1997;1;1;1ère circonscription;78;VILLENEUVE LA GARENNE;92078;11471;4645;6826;211;6615;BRETON MICHEL;M;BRETON;MICHEL;EXG;185
Législatives 1997 - 1er tour;Législatives;1997;1;1;1ère circonscription;78;VILLENEUVE LA GARENNE;92078;11471;4645;6826;211;6615;ORGET GERARD;M;ORGET;GERARD;EXD;47
Législatives 1997 - 1er tour;Législatives;1997;1;8;8ème circonscription;77;VILLE D'AVRAY;92077;7112;2283;4829;139;4690;BRISSAUD SOPHIE;F;BRISSAUD;SOPHIE;FRN;450
Législatives 1997 - 1er tour;Législatives;1997;1;8;8ème circonscription;77;VILLE D'AVRAY;92077;7112;2283;4829;139;4690;JOURNE SILIAN;M;JOURNE;SILIAN;DVD;239
Législatives 2012 - 1er tour;Législatives;2012;1;11;11ème circonscription;7;BAGNEUX;92007;20609;9648;10961;145;10816;BRANAA Jean-Eric;M;BRANAA;Jean-Eric;CEN;56
Législatives 2012 - 1er tour;Législatives;2012;1;11;11ème circonscription;7;BAGNEUX;92007;20609;9648;10961;145;10816;BOCHER Aurélie;F;BOCHER;Aurélie;DVD;56
Législatives 2012 - 1er tour;Législatives;2012;1;11;11ème circonscription;7;BAGNEUX;92007;20609;9648;10961;145;10816;DE FONTENAILLES Marie;F;DE FONTENAILLES;Marie;FN;826
Législatives 2012 - 1er tour;Législatives;2012;1;10;10ème circonscription;12;BOULOGNE BILLANCOURT;92012;6600;2912;3688;126;3562;HESSE Frédéric;M;HESSE;Frédéric;AUT;3
Législatives 2012 - 1er tour;Législatives;2012;1;13;13ème circonscription;14;BOURG LA REINE;92014;13305;4436;8869;87;8782;DE LAMBILLY Gaëtan;M;DE LAMBILLY;Gaëtan;DVD;167
Législatives 2012 - 1er tour;Législatives;2012;1;13;13ème circonscription;14;BOURG LA REINE;92014;13305;4436;8869;87;8782;GEORGET Michel;M;GEORGET;Michel;FN;481
Législatives 2012 - 1er tour;Législatives;2012;1;13;13ème circonscription;19;CHATENAY MALABRY;92019;17908;6775;11133;210;10923;GEORGET Michel;M;GEORGET;Michel;FN;610
Législatives 2012 - 1er tour;Législatives;2012;1;5;5ème circonscription;24;CLICHY;92024;29276;13521;15755;274;15481;DELALLEAU François;M;DELALLEAU;François;FG;1103
Législatives 2012 - 1er tour;Législatives;2012;1;3;3ème circonscription;26;COURBEVOIE;92026;42456;16939;25517;317;25200;EISENBERG Mathilde;F;EISENBERG;Mathilde;EXG;61
Législatives 2012 - 1er tour;Législatives;2012;1;6;6ème circonscription;26;COURBEVOIE;92026;8123;3742;4381;140;4241;DEROCHE François;M;DEROCHE;François;DVD;62
Législatives 2012 - 1er tour;Législatives;2012;1;5;5ème circonscription;44;LEVALLOIS PERRET;92044;39546;14667;24879;238;24641;SAUGE Jean-Michel;M;SAUGE;Jean-Michel;EXG;21
Législatives 2012 - 1er tour;Législatives;2012;1;7;7ème circonscription;63;RUEIL MALMAISON;92063;52518;20526;31992;298;31694;ROSENMAN Gabriel;M;ROSENMAN;Gabriel;EXG;91
Législatives 2012 - 1er tour;Législatives;2012;1;7;7ème circonscription;64;SAINT CLOUD;92064;19029;7431;11598;97;11501;ROSENMAN Gabriel;M;ROSENMAN;Gabriel;EXG;13
Législatives 2012 - 1er tour;Législatives;2012;1;7;7ème circonscription;64;SAINT CLOUD;92064;19029;7431;11598;97;11501;ROCHERON Bertrand;M;ROCHERON;Bertrand;SOC;2595
Législatives 2012 - 1er tour;Législatives;2012;1;8;8ème circonscription;72;SEVRES;92072;14861;5785;9076;101;8975;RABANY Dominique;F;RABANY;Dominique;FG;332
Législatives 2012 - 1er tour;Législatives;2012;1;8;8ème circonscription;72;SEVRES;92072;14861;5785;9076;101;8975;PAILLARD Christophe;M;PAILLARD;Christophe;AUT;12
Législatives 2012 - 1er tour;Législatives;2012;1;8;8ème circonscription;76;VAUCRESSON;92076;6093;2463;3630;39;3591;CANDELIER Catherine;F;CANDELIER;Catherine;VEC;111
Législatives 2012 - 1er tour;Législatives;2012;1;8;8ème circonscription;76;VAUCRESSON;92076;6093;2463;3630;39;3591;VIERA Lydia;F;VIERA;Lydia;ECO;2
Législatives 2012 - 1er tour;Législatives;2012;1;8;8ème circonscription;77;VILLE D'AVRAY;92077;7169;2468;4701;48;4653;LE BAUT Anne;F;LE BAUT;Anne;FN;249
Législatives 2012 - 2ème tour;Législatives;2012;2;8;8ème circonscription;48;MEUDON;92048;25003;9964;15039;336;14703;GUILLET Jean-Jacques;M;GUILLET;Jean-Jacques;UMP;7357
Législatives 2012 - 2ème tour;Législatives;2012;2;10;10ème circonscription;75;VANVES;92075;17559;6475;11084;203;10881;SCHMID Lucile;F;SCHMID;Lucile;VEC;5855
Législatives 2002 - 2ème tour;Législatives;2002;2;13;13ème circonscription;2;ANTONY;92002;37341;12747;24594;681;23913;DEVEDJIAN PATRICK;M;DEVEDJIAN;PATRICK;UMP;13774
Législatives 2002 - 2ème tour;Législatives;2002;2;4;4ème circonscription;50;NANTERRE;92050;37881;15862;22019;653;21366;FRAYSSE JACQUELINE;F;FRAYSSE;JACQUELINE;COM;12596
Législatives 2002 - 2ème tour;Législatives;2002;2;1;1ère circonscription;78;VILLENEUVE LA GARENNE;92078;11470;6358;5112;189;4923;BARTHE CECILE;F;BARTHE;CECILE;UMP;2425
Présidentielles 1995 - 2ème tour;Présidentielles;1995;2;;;60;LE PLESSIS ROBINSON;92060;13056;2868;10188;561;9627;JOSPIN LIONEL;M;JOSPIN;LIONEL;;4516
Présidentielles 1995 - 2ème tour;Présidentielles;1995;2;;;73;SURESNES;92073;21968;4886;17082;803;16279;JOSPIN LIONEL;M;JOSPIN;LIONEL;;9456
Présidentielles 1995 - 1er tour;Présidentielles;1995;1;;;76;VAUCRESSON;92076;5529;1334;4195;65;4130;CHIRAC JACQUES;M;CHIRAC;JACQUES;;1461
Législatives 1993 - 1er tour;Législatives;1993;1;1;1ère circonscription;25;COLOMBES;92025;26594;9512;17082;693;16389;RANAIVOSON BRIGITTE;F;RANAIVOSON;BRIGITTE;DIV;291
Législatives 1993 - 1er tour;Législatives;1993;1;3;3ème circonscription;26;COURBEVOIE;92026;34737;9916;24821;828;23993;BRIGAND CATHERINE;F;BRIGAND;CATHERINE;GEC;2382
Législatives 1993 - 1er tour;Législatives;1993;1;3;3ème circonscription;26;COURBEVOIE;92026;34737;9916;24821;828;23993;MORIN GABRIEL;M;MORIN;GABRIEL;DIV;559
Législatives 1993 - 1er tour;Législatives;1993;1;8;8ème circonscription;47;MARNES LA COQUETTE;92047;1006;246;760;21;739;ROY CAROLINE;F;ROY;CAROLINE;RDG;54
Législatives 1993 - 1er tour;Législatives;1993;1;8;8ème circonscription;47;MARNES LA COQUETTE;92047;1006;246;760;21;739;FIEVET ALAIN;M;FIEVET;ALAIN;SOC;4
Législatives 1993 - 1er tour;Législatives;1993;1;8;8ème circonscription;72;SEVRES;92072;13536;3690;9846;336;9510;GUILLET J.JACQUES;M;GUILLET;J.JACQUES;RPR;3080
Législatives 1993 - 1er tour;Législatives;1993;1;10;10ème circonscription;75;VANVES;92075;15286;4324;10962;394;10568;RIEUPET ANNIE;F;RIEUPET;ANNIE;EXG;144
Législatives 1993 - 1er tour;Législatives;1993;1;8;8ème circonscription;72;SEVRES;92072;13536;3690;9846;336;9510;ROY CAROLINE;F;ROY;CAROLINE;RDG;1597
Législatives 1993 - 1er tour;Législatives;1993;1;8;8ème circonscription;72;SEVRES;92072;13536;3690;9846;336;9510;WOLF HENRY;M;WOLF;HENRY;UDF;1514
Législatives 1993 - 1er tour;Législatives;1993;1;6;6ème circonscription;51;NEUILLY SUR SEINE;92051;35806;10146;25660;620;25040;GARCIA ACEBEDO NADINE;F;GARCIA ACEBEDO;NADINE;COM;317
Législatives 1993 - 1er tour;Législatives;1993;1;8;8ème circonscription;48;MEUDON;92048;25126;7628;17498;529;16969;FIEVET ALAIN;M;FIEVET;ALAIN;SOC;134
Législatives 1993 - 1er tour;Législatives;1993;1;1;1ère circonscription;78;VILLENEUVE LA GARENNE;92078;11604;4168;7436;212;7224;MOURRE DOMINIQUE;M;MOURRE;DOMINIQUE;EXG;39
Législatives 1993 - 2ème tour;Législatives;1993;2;5;5ème circonscription;24;CLICHY;92024;25172;9456;15716;1166;14550;CATOIRE GILLES;M;CATOIRE;GILLES;SOC;7101
Législatives 1993 - 1er tour;Législatives;1993;1;10;10ème circonscription;12;BOULOGNE BILLANCOURT;92012;4523;1581;2942;133;2809;HERVO DIDIER;M;HERVO;DIDIER;VEC;224
Législatives 1993 - 1er tour;Législatives;1993;1;11;11ème circonscription;7;BAGNEUX;92007;21150;7754;13396;474;12922;LE CORGUILLE VIVETTE;F;LE CORGUILLE;VIVETTE;EXG;45
Législatives 1993 - 1er tour;Législatives;1993;1;12;12ème circonscription;20;CHATILLON;92020;15705;4455;11250;435;10815;LE BERRE ALAIN;M;LE BERRE;ALAIN;FRN;1287
Législatives 1993 - 1er tour;Législatives;1993;1;5;5ème circonscription;24;CLICHY;92024;25172;9290;15882;514;15368;GALLAIS ALAIN;M;GALLAIS;ALAIN;FRN;2204
Législatives 1993 - 1er tour;Législatives;1993;1;5;5ème circonscription;44;LEVALLOIS PERRET;92044;27392;7486;19906;624;19282;LE GALL EMMANUELLE;F;LE GALL;EMMANUELLE;DIV;165
Législatives 1993 - 2ème tour;Législatives;1993;2;4;4ème circonscription;73;SURESNES;92073;21290;6617;14673;815;13858;FRAYSSE JACQUELINE;F;FRAYSSE;JACQUELINE;COM;5262
Législatives 1993 - 2ème tour;Législatives;1993;2;3;3ème circonscription;26;COURBEVOIE;92026;34737;11583;23154;1313;21841;ROUSSEL PIERRE;M;ROUSSEL;PIERRE;SOC;7382
Législatives 1993 - 2ème tour;Législatives;1993;2;1;1ère circonscription;25;COLOMBES;92025;26587;9243;17344;988;16356;BRUNHES JACQUES;M;BRUNHES;JACQUES;COM;8778
Législatives 1993 - 2ème tour;Législatives;1993;2;3;3ème circonscription;26;COURBEVOIE;92026;34737;11583;23154;1313;21841;HABY J.YVES;M;HABY;J.YVES;UDF;14459
Législatives 2017 - 1er tour;Législatives;2017;1;1;1ère circonscription;36;GENNEVILLIERS;92036;22174;13223;8951;243;8708;MEHARGA Ahcen;M;MEHARGA;Ahcen;ECO;29
Législatives 2017 - 1er tour;Législatives;2017;1;1;1ère circonscription;25;COLOMBES;92025;27867;16420;11447;405;11042;LAJILI Nasser;M;LAJILI;Nasser;FI;1385
Législatives 2017 - 1er tour;Législatives;2017;1;8;8ème circonscription;47;MARNES LA COQUETTE;92047;1215;451;764;4;760;MEROUCHI Sandra;F;MEROUCHI;Sandra;DIV;3
Législatives 2017 - 1er tour;Législatives;2017;1;8;8ème circonscription;47;MARNES LA COQUETTE;92047;1215;451;764;4;760;DE SAINT ALBIN Stéphane;M;DE SAINT ALBIN;Stéphane;DVD;24
Législatives 2017 - 1er tour;Législatives;2017;1;8;8ème circonscription;48;MEUDON;92048;25240;11059;14181;174;14007;BOYER Gilles;M;BOYER;Gilles;LR;3218
Législatives 2017 - 1er tour;Législatives;2017;1;8;8ème circonscription;48;MEUDON;92048;25240;11059;14181;174;14007;CHETAILLE Romain;M;CHETAILLE;Romain;DVD;206
Législatives 2017 - 1er tour;Législatives;2017;1;8;8ème circonscription;77;VILLE D'AVRAY;92077;7440;2857;4583;44;4539;PAILLARD Christophe;M;PAILLARD;Christophe;DVD;19
Législatives 2017 - 1er tour;Législatives;2017;1;11;11ème circonscription;46;MALAKOFF;92046;18448;8148;10300;133;10167;BOUDJENAH Yasmine;F;BOUDJENAH;Yasmine;FI;2872
Législatives 2017 - 1er tour;Législatives;2017;1;11;11ème circonscription;46;MALAKOFF;92046;18448;8148;10300;133;10167;GUYOMARD Sandra;F;GUYOMARD;Sandra;DIV;175
Législatives 2017 - 1er tour;Législatives;2017;1;11;11ème circonscription;49;MONTROUGE;92049;28914;12071;16843;175;16668;SOMMARUGA Julie;F;SOMMARUGA;Julie;SOC;2415
Législatives 2017 - 1er tour;Législatives;2017;1;12;12ème circonscription;32;FONTENAY AUX ROSES;92032;16049;7756;8293;93;8200;PEMEZEC Philippe;M;PEMEZEC;Philippe;LR;1499
Législatives 2017 - 1er tour;Législatives;2017;1;12;12ème circonscription;60;LE PLESSIS ROBINSON;92060;19154;7496;11658;130;11528;GARCIA-BADIN Théo;M;GARCIA-BADIN;Théo;ECO;273
Législatives 2017 - 1er tour;Législatives;2017;1;12;12ème circonscription;60;LE PLESSIS ROBINSON;92060;19154;7496;11658;130;11528;PREVEL Guillaume;M;PREVEL;Guillaume;DIV;126
Législatives 2017 - 1er tour;Législatives;2017;1;12;12ème circonscription;60;LE PLESSIS ROBINSON;92060;19154;7496;11658;130;11528;REJA-BRET Alexandre;M;REJA-BRET;Alexandre;DIV;13
Législatives 2017 - 1er tour;Législatives;2017;1;13;13ème circonscription;2;ANTONY;92002;41542;17216;24326;446;23880;ROLLOT Franck;M;ROLLOT;Franck;EXG;120
Législatives 2017 - 1er tour;Législatives;2017;1;13;13ème circonscription;2;ANTONY;92002;41542;17216;24326;446;23880;LASGI Nicolas;M;LASGI;Nicolas;FI;2105
Législatives 2017 - 1er tour;Législatives;2017;1;13;13ème circonscription;2;ANTONY;92002;41542;17216;24326;446;23880;FARCY-BRIANT Laurent;M;FARCY-BRIANT;Laurent;DIV;75
Législatives 2017 - 1er tour;Législatives;2017;1;13;13ème circonscription;2;ANTONY;92002;41542;17216;24326;446;23880;YANEZ Jérôme;M;YANEZ;Jérôme;DIV;161
Législatives 2017 - 1er tour;Législatives;2017;1;13;13ème circonscription;71;SCEAUX;92071;15078;6395;8683;84;8599;DELRIEU Denis;M;DELRIEU;Denis;ECO;395
Législatives 2017 - 1er tour;Législatives;2017;1;13;13ème circonscription;71;SCEAUX;92071;15078;6395;8683;84;8599;ACHACHE Tristan;M;ACHACHE;Tristan;DIV;28
Législatives 2017 - 1er tour;Législatives;2017;1;13;13ème circonscription;71;SCEAUX;92071;15078;6395;8683;84;8599;YANEZ Jérôme;M;YANEZ;Jérôme;DIV;69
Législatives 2017 - 1er tour;Législatives;2017;1;13;13ème circonscription;71;SCEAUX;92071;15078;6395;8683;84;8599;DUMAS Frédérique;F;DUMAS;Frédérique;REM;4217
Législatives 2017 - 2ème tour;Législatives;2017;2;6;6ème circonscription;62;PUTEAUX;92062;28983;13852;15131;1602;13529;LE GRIP Constance;F;LE GRIP;Constance;LR;6065
Législatives 2017 - 2ème tour;Législatives;2017;2;12;12ème circonscription;20;CHATILLON;92020;22311;11653;10658;1083;9575;PEMEZEC Philippe;M;PEMEZEC;Philippe;LR;3573
Législatives 2017 - 2ème tour;Législatives;2017;2;13;13ème circonscription;71;SCEAUX;92071;15078;7708;7370;551;6819;SIFFREDI Georges;M;SIFFREDI;Georges;LR;2395
Législatives 2017 - 1er tour;Législatives;2017;1;2;2ème circonscription;4;ASNIERES SUR SEINE;92004;48340;22557;25783;414;25369;GAROYAN Fabrice;M;GAROYAN;Fabrice;DLF;277
Législatives 2017 - 1er tour;Législatives;2017;1;2;2ème circonscription;25;COLOMBES;92025;19668;8354;11314;229;11085;RICHARD Julien;M;RICHARD;Julien;ECO;118
Législatives 2017 - 1er tour;Législatives;2017;1;2;2ème circonscription;25;COLOMBES;92025;19668;8354;11314;229;11085;DERRIEN Amand;M;DERRIEN;Amand;DIV;125
Législatives 2017 - 1er tour;Législatives;2017;1;1;1ère circonscription;78;VILLENEUVE LA GARENNE;92078;12445;8430;4015;143;3872;WICQUART Emmanuelle;F;WICQUART;Emmanuelle;DLF;82
Législatives 2017 - 1er tour;Législatives;2017;1;3;3ème circonscription;9;BOIS COLOMBES;92009;17921;7869;10052;437;9615;DAHAN Isabelle;F;DAHAN;Isabelle;SOC;680
Législatives 2017 - 1er tour;Législatives;2017;1;3;3ème circonscription;9;BOIS COLOMBES;92009;17921;7869;10052;437;9615;FOURNET Arnaud;M;FOURNET;Arnaud;EXD;50
Législatives 2017 - 1er tour;Législatives;2017;1;3;3ème circonscription;26;COURBEVOIE;92026;44322;19890;24432;415;24017;MUGERIN Richard;M;MUGERIN;Richard;DLF;231
Législatives 2017 - 1er tour;Législatives;2017;1;1;1ère circonscription;78;VILLENEUVE LA GARENNE;92078;12445;8430;4015;143;3872;BARON Jean-Baptiste;M;BARON;Jean-Baptiste;DIV;63
Législatives 2017 - 1er tour;Législatives;2017;1;1;1ère circonscription;78;VILLENEUVE LA GARENNE;92078;12445;8430;4015;143;3872;PRUVOST Emmanuel;M;PRUVOST;Emmanuel;ECO;26
Législatives 2017 - 1er tour;Législatives;2017;1;2;2ème circonscription;4;ASNIERES SUR SEINE;92004;48340;22557;25783;414;25369;LAURENT Hadrien;M;LAURENT;Hadrien;RDG;254
Législatives 2017 - 1er tour;Législatives;2017;1;1;1ère circonscription;78;VILLENEUVE LA GARENNE;92078;12445;8430;4015;143;3872;ANOU Tommy;M;ANOU;Tommy;FN;428
Législatives 2017 - 1er tour;Législatives;2017;1;6;6ème circonscription;62;PUTEAUX;92062;28983;11794;17189;436;16753;LAGARDE Patrick;M;LAGARDE;Patrick;DLF;214
Présidentielles 2002 - 1er tour;Présidentielles;2002;1;;;19;CHATENAY MALABRY;92019;15965;4483;11482;241;11241;HUE ROBERT;M;HUE;ROBERT;;369
Présidentielles 2002 - 1er tour;Présidentielles;2002;1;;;20;CHATILLON;92020;18067;5487;12580;295;12285;MAMERE NOEL;M;MAMERE;NOEL;;844
Présidentielles 2002 - 1er tour;Présidentielles;2002;1;;;20;CHATILLON;92020;18067;5487;12580;295;12285;LAGUILLER ARLETTE;F;LAGUILLER;ARLETTE;;552
Présidentielles 2002 - 1er tour;Présidentielles;2002;1;;;22;CHAVILLE;92022;12122;3826;8296;162;8134;MAMERE NOEL;M;MAMERE;NOEL;;479
Présidentielles 2002 - 1er tour;Présidentielles;2002;1;;;22;CHAVILLE;92022;12122;3826;8296;162;8134;CHEVENEMENT JEAN-PIERRE;M;CHEVENEMENT;JEAN-PIERRE;;552
Présidentielles 2002 - 1er tour;Présidentielles;2002;1;;;23;CLAMART;92023;31130;10977;20153;427;19726;BESANCENOT OLIVIER;M;BESANCENOT;OLIVIER;;690
Présidentielles 2002 - 1er tour;Présidentielles;2002;1;;;32;FONTENAY AUX ROSES;92032;14148;4309;9839;204;9635;MEGRET BRUNO;M;MEGRET;BRUNO;;164
Présidentielles 2002 - 1er tour;Présidentielles;2002;1;;;36;GENNEVILLIERS;92036;18213;6933;11280;303;10977;CHEVENEMENT JEAN-PIERRE;M;CHEVENEMENT;JEAN-PIERRE;;672
Présidentielles 2002 - 1er tour;Présidentielles;2002;1;;;36;GENNEVILLIERS;92036;18213;6933;11280;303;10977;BESANCENOT OLIVIER;M;BESANCENOT;OLIVIER;;506
Présidentielles 2002 - 1er tour;Présidentielles;2002;1;;;44;LEVALLOIS PERRET;92044;33618;9640;23978;575;23403;JOSPIN LIONEL;M;JOSPIN;LIONEL;;3315
Présidentielles 2002 - 2ème tour;Présidentielles;2002;2;;;2;ANTONY;92002;37045;5846;31199;1081;30118;LE PEN JEAN-MARIE;M;LE PEN;JEAN-MARIE;;3275
Présidentielles 2002 - 2ème tour;Présidentielles;2002;2;;;40;ISSY LES MOULINEAUX;92040;32093;5437;26656;863;25793;LE PEN JEAN-MARIE;M;LE PEN;JEAN-MARIE;;2710
Présidentielles 2017 - 2ème tour;Présidentielles;2017;2;;;19;CHATENAY MALABRY;92019;18708;4337;14371;1468;12903;LE PEN Marine;F;LE PEN;Marine;;2043
Présidentielles 2017 - 2ème tour;Présidentielles;2017;2;;;60;LE PLESSIS ROBINSON;92060;19141;4081;15060;1601;13459;LE PEN Marine;F;LE PEN;Marine;;3024
Présidentielles 2007 - 2ème tour;Présidentielles;2007;2;;;12;BOULOGNE BILLANCOURT;92012;64778;8373;56405;1995;54410;SARKOZY Nicolas;M;SARKOZY;Nicolas;;36270
Présidentielles 2012 - 2ème tour;Présidentielles;2012;2;;;60;LE PLESSIS ROBINSON;92060;18774;3079;15695;745;14950;SARKOZY Nicolas;M;SARKOZY;Nicolas;;7747
Législatives 2007 - 2ème tour;Législatives;2007;2;10;10ème circonscription;12;BOULOGNE BILLANCOURT;92012;5551;2854;2697;89;2608;SANTINI André;M;SANTINI;André;MAJ;1306
Législatives 2007 - 1er tour;Législatives;2007;1;13;13ème circonscription;2;ANTONY;92002;39807;13942;25865;456;25409;RIEUX Françoise;F;RIEUX;Françoise;EXD;104
Législatives 2007 - 1er tour;Législatives;2007;1;9;9ème circonscription;12;BOULOGNE BILLANCOURT;92012;60773;22422;38351;535;37816;MISSOFFE Ségolène;F;MISSOFFE;Ségolène;MAJ;505
Législatives 2007 - 1er tour;Législatives;2007;1;3;3ème circonscription;9;BOIS COLOMBES;92009;16245;6561;9684;288;9396;MARCEL Françoise;F;MARCEL;Françoise;EXG;29
Législatives 2007 - 1er tour;Législatives;2007;1;3;3ème circonscription;9;BOIS COLOMBES;92009;16245;6561;9684;288;9396;DERAMBARSH Arash;M;DERAMBARSH;Arash;DVD;87
Législatives 2007 - 1er tour;Législatives;2007;1;11;11ème circonscription;7;BAGNEUX;92007;20520;8538;11982;178;11804;BONJEAN Hubert;M;BONJEAN;Hubert;FN;433
Législatives 2007 - 1er tour;Législatives;2007;1;13;13ème circonscription;71;SCEAUX;92071;14129;4679;9450;74;9376;LEPEUVE Stéphane;M;LEPEUVE;Stéphane;EXG;148
Législatives 2007 - 1er tour;Législatives;2007;1;7;7ème circonscription;33;GARCHES;92033;12286;4601;7685;112;7573;TERRAZZONI Valérie;F;TERRAZZONI;Valérie;DIV;36
Législatives 2007 - 1er tour;Législatives;2007;1;7;7ème circonscription;33;GARCHES;92033;12286;4601;7685;112;7573;ROCHERON Bertrand;M;ROCHERON;Bertrand;SOC;1153
Législatives 2007 - 1er tour;Législatives;2007;1;6;6ème circonscription;51;NEUILLY SUR SEINE;92051;39134;14738;24396;185;24211;CECCALDI-RAYNAUD Joëlle;F;CECCALDI-RAYNAUD;Joëlle;UMP;13355
Législatives 2007 - 1er tour;Législatives;2007;1;4;4ème circonscription;50;NANTERRE;92050;42631;18721;23910;314;23596;MARINESE Vito;M;MARINESE;Vito;DIV;1
Législatives 2007 - 1er tour;Législatives;2007;1;8;8ème circonscription;47;MARNES LA COQUETTE;92047;1074;316;758;5;753;ROY Caroline;F;ROY;Caroline;RDG;71
Législatives 2007 - 1er tour;Législatives;2007;1;1;1ère circonscription;25;COLOMBES;92025;26192;12273;13919;366;13553;SARRE Philippe;M;SARRE;Philippe;SOC;4404
Législatives 2007 - 1er tour;Législatives;2007;1;13;13ème circonscription;19;CHATENAY MALABRY;92019;17835;6584;11251;211;11040;RIEUX Françoise;F;RIEUX;Françoise;EXD;35
Législatives 2007 - 1er tour;Législatives;2007;1;10;10ème circonscription;12;BOULOGNE BILLANCOURT;92012;5551;2367;3184;78;3106;TERRET Eugène;M;TERRET;Eugène;FN;91
Législatives 2007 - 1er tour;Législatives;2007;1;6;6ème circonscription;62;PUTEAUX;92062;26791;8829;17962;396;17566;LARAQUE Isabelle;F;LARAQUE;Isabelle;EXD;71
Législatives 2007 - 1er tour;Législatives;2007;1;1;1ère circonscription;36;GENNEVILLIERS;92036;20048;9522;10526;189;10337;DENJEAN Jean-Marc;M;DENJEAN;Jean-Marc;VEC;189
Législatives 2007 - 1er tour;Législatives;2007;1;8;8ème circonscription;47;MARNES LA COQUETTE;92047;1074;316;758;5;753;BLANCHARD Luc;M;BLANCHARD;Luc;VEC;4
Législatives 2007 - 1er tour;Législatives;2007;1;8;8ème circonscription;48;MEUDON;92048;25427;9683;15744;202;15542;LUCET Francis;M;LUCET;Francis;EXG;106
Législatives 2007 - 2ème tour;Législatives;2007;2;2;2ème circonscription;25;COLOMBES;92025;18336;8059;10277;373;9904;AESCHLIMANN Manuel;M;AESCHLIMANN;Manuel;UMP;5472
Législatives 2007 - 2ème tour;Législatives;2007;2;10;10ème circonscription;75;VANVES;92075;17351;6819;10532;243;10289;SANTINI André;M;SANTINI;André;MAJ;5246
Législatives 2017 - 1er tour;Législatives;2017;1;2;2ème circonscription;4;ASNIERES SUR SEINE;92004;48340;22557;25783;414;25369;SCHILLACI Nino;M;SCHILLACI;Nino;FI;2172
Législatives 2017 - 1er tour;Législatives;2017;1;1;1ère circonscription;78;VILLENEUVE LA GARENNE;92078;12445;8430;4015;143;3872;KHALFI Isia;F;KHALFI;Isia;REM;1308
Législatives 2017 - 2ème tour;Législatives;2017;2;1;1ère circonscription;78;VILLENEUVE LA GARENNE;92078;12445;8883;3562;297;3265;KHALFI Isia;F;KHALFI;Isia;REM;1652
Législatives 2017 - 2ème tour;Législatives;2017;2;3;3ème circonscription;9;BOIS COLOMBES;92009;17921;9466;8455;816;7639;SPIRI Jean;M;SPIRI;Jean;LR;2808
Législatives 2017 - 2ème tour;Législatives;2017;2;5;5ème circonscription;44;LEVALLOIS PERRET;92044;41751;21610;20141;1437;18704;CALVEZ Céline;F;CALVEZ;Céline;REM;11194
Législatives 2017 - 2ème tour;Législatives;2017;2;7;7ème circonscription;64;SAINT CLOUD;92064;19410;8757;10653;436;10217;BERDOATI Eric;M;BERDOATI;Eric;LR;5066
Législatives 2017 - 2ème tour;Législatives;2017;2;8;8ème circonscription;76;VAUCRESSON;92076;6187;2981;3206;125;3081;BOYER Gilles;M;BOYER;Gilles;LR;1398
Législatives 2017 - 2ème tour;Législatives;2017;2;11;11ème circonscription;49;MONTROUGE;92049;28914;14304;14610;920;13690;BOUDJENAH Yasmine;F;BOUDJENAH;Yasmine;FI;4964
Législatives 2017 - 2ème tour;Législatives;2017;2;12;12ème circonscription;23;CLAMART;92023;35342;18577;16765;1453;15312;PEMEZEC Philippe;M;PEMEZEC;Philippe;LR;5842
Législatives 2007 - 1er tour;Législatives;2007;1;8;8ème circonscription;76;VAUCRESSON;92076;6076;2206;3870;46;3824;LEGRAND Pauline;F;LEGRAND;Pauline;EXD;22
Législatives 2007 - 1er tour;Législatives;2007;1;10;10ème circonscription;75;VANVES;92075;17351;5929;11422;137;11285;ALEZARD Lysiane;F;ALEZARD;Lysiane;COM;283
Législatives 2007 - 1er tour;Législatives;2007;1;10;10ème circonscription;75;VANVES;92075;17351;5929;11422;137;11285;SANTINI André;M;SANTINI;André;MAJ;4808
Législatives 2007 - 1er tour;Législatives;2007;1;4;4ème circonscription;73;SURESNES;92073;24666;8949;15717;206;15511;MARINESE Vito;M;MARINESE;Vito;DIV;0
Législatives 2002 - 1er tour;Législatives;2002;1;6;6ème circonscription;51;NEUILLY SUR SEINE;92051;39134;14738;24396;185;24211;DANIS Thierry;M;DANIS;Thierry;COM;64
Législatives 2002 - 1er tour;Législatives;2002;1;6;6ème circonscription;51;NEUILLY SUR SEINE;92051;39134;14738;24396;185;24211;GALIENNE Jean;M;GALIENNE;Jean;DIV;91
Législatives 2002 - 1er tour;Législatives;2002;1;7;7ème circonscription;63;RUEIL MALMAISON;92063;51481;18902;32579;337;32242;BRISON Christian;M;BRISON;Christian;EXG;154
Législatives 2002 - 1er tour;Législatives;2002;1;7;7ème circonscription;63;RUEIL MALMAISON;92063;51481;18902;32579;337;32242;BORNETTE Bernard;M;BORNETTE;Bernard;EXD;86
Législatives 2002 - 1er tour;Législatives;2002;1;7;7ème circonscription;64;SAINT CLOUD;92064;19115;6812;12303;93;12210;ROCHERON Bertrand;M;ROCHERON;Bertrand;SOC;1553
Législatives 2002 - 1er tour;Législatives;2002;1;8;8ème circonscription;72;SEVRES;92072;14460;5279;9181;151;9030;SUCHARD Sophie;F;SUCHARD;Sophie;EXG;21
Législatives 2002 - 1er tour;Législatives;2002;1;8;8ème circonscription;72;SEVRES;92072;14460;5279;9181;151;9030;FILLOUX Delphine;F;FILLOUX;Delphine;DIV;120
Législatives 2002 - 1er tour;Législatives;2002;1;4;4ème circonscription;73;SURESNES;92073;24666;8949;15717;206;15511;BOUKHEDIMI Yvonne;F;BOUKHEDIMI;Yvonne;EXG;24
Législatives 2002 - 1er tour;Législatives;2002;1;10;10ème circonscription;75;VANVES;92075;17351;5929;11422;137;11285;VIGUIE Laurence;F;VIGUIE;Laurence;EXG;51
Législatives 2002 - 1er tour;Législatives;2002;1;8;8ème circonscription;77;VILLE D'AVRAY;92077;7475;2429;5046;60;4986;RUSSO Annick;F;RUSSO;Annick;DIV;1
Législatives 2002 - 2ème tour;Législatives;2002;2;8;8ème circonscription;76;VAUCRESSON;92076;5983;2400;3583;112;3471;GUILLET J.JACQUES;M;GUILLET;J.JACQUES;UMP;2671
Législatives 1997 - 2ème tour;Législatives;1997;2;7;7ème circonscription;64;SAINT CLOUD;92064;18908;6982;11926;480;11446;MAULION CHRISTIANE;F;MAULION;CHRISTIANE;SOC;3019
Législatives 1997 - 2ème tour;Législatives;1997;2;12;12ème circonscription;32;FONTENAY AUX ROSES;92032;14748;4006;10742;406;10336;BUCHET PASCAL;M;BUCHET;PASCAL;SOC;5265
Législatives 1997 - 2ème tour;Législatives;1997;2;7;7ème circonscription;63;RUEIL MALMAISON;92063;44715;15188;29527;1355;28172;BAUMEL JACQUES;M;BAUMEL;JACQUES;RPR;17995
Législatives 2012 - 1er tour;Législatives;2012;1;10;10ème circonscription;75;VANVES;92075;17559;6347;11212;104;11108;VIGUIE Laurence;F;VIGUIE;Laurence;EXG;36
Législatives 2012 - 1er tour;Législatives;2012;1;10;10ème circonscription;75;VANVES;92075;17559;6347;11212;104;11108;LACOMBE Maxime;M;LACOMBE;Maxime;ECO;107
Législatives 2012 - 1er tour;Législatives;2012;1;10;10ème circonscription;75;VANVES;92075;17559;6347;11212;104;11108;GAMBIEZ Fabienne;F;GAMBIEZ;Fabienne;CEN;423
Législatives 2012 - 2ème tour;Législatives;2012;2;9;9ème circonscription;12;BOULOGNE BILLANCOURT;92012;61020;25102;35918;564;35354;GUEANT Claude;M;GUEANT;Claude;UMP;13578
Législatives 2012 - 2ème tour;Législatives;2012;2;11;11ème circonscription;49;MONTROUGE;92049;27889;11155;16734;283;16451;SOMMARUGA Julie;F;SOMMARUGA;Julie;SOC;8976
Législatives 2012 - 2ème tour;Législatives;2012;2;6;6ème circonscription;62;PUTEAUX;92062;28253;11728;16525;586;15939;LEPIDI Bernard;M;LEPIDI;Bernard;DVD;3842
Législatives 2012 - 2ème tour;Législatives;2012;2;13;13ème circonscription;71;SCEAUX;92071;14395;5370;9025;208;8817;LANDFRIED Julien;M;LANDFRIED;Julien;DVG;4184
Législatives 2002 - 1er tour;Législatives;2002;1;3;3ème circonscription;9;BOIS COLOMBES;92009;16245;6561;9684;288;9396;PELISSIER Hélène;F;PELISSIER;Hélène;DIV;49
Législatives 2002 - 1er tour;Législatives;2002;1;13;13ème circonscription;19;CHATENAY MALABRY;92019;17835;6584;11251;211;11040;RIEUX Françoise;F;RIEUX;Françoise;EXD;35
Législatives 2012 - 1er tour;Législatives;2012;1;13;13ème circonscription;2;ANTONY;92002;40941;15088;25853;361;25492;CADORET Mannone;M;CADORET;Mannone;AUT;304
Législatives 2012 - 1er tour;Législatives;2012;1;10;10ème circonscription;12;BOULOGNE BILLANCOURT;92012;6600;2912;3688;126;3562;RONCHINI Vanessa;F;RONCHINI;Vanessa;EXG;13
Législatives 2012 - 1er tour;Législatives;2012;1;13;13ème circonscription;14;BOURG LA REINE;92014;13305;4436;8869;87;8782;FEUILLADE Fabien;M;FEUILLADE;Fabien;VEC;1783
Législatives 2012 - 1er tour;Législatives;2012;1;5;5ème circonscription;24;CLICHY;92024;29276;13521;15755;274;15481;CHIARELLI Xavier;M;CHIARELLI;Xavier;EXG;73
Législatives 2012 - 1er tour;Législatives;2012;1;1;1ère circonscription;25;COLOMBES;92025;26337;13144;13193;209;12984;GUICHARD Isabelle;F;GUICHARD;Isabelle;EXG;53
Législatives 2012 - 1er tour;Législatives;2012;1;1;1ère circonscription;25;COLOMBES;92025;26337;13144;13193;209;12984;MELIHI Rachida;F;MELIHI;Rachida;ECO;63
Législatives 2012 - 1er tour;Législatives;2012;1;3;3ème circonscription;26;COURBEVOIE;92026;42456;16939;25517;317;25200;MARTINEZ Chaïb;M;MARTINEZ;Chaïb;AUT;234
Législatives 2012 - 1er tour;Législatives;2012;1;6;6ème circonscription;26;COURBEVOIE;92026;8123;3742;4381;140;4241;LEPIDI Bernard;M;LEPIDI;Bernard;DVD;831
Législatives 2012 - 1er tour;Législatives;2012;1;1;1ère circonscription;36;GENNEVILLIERS;92036;20795;10523;10272;192;10080;GRIMAL Jean;M;GRIMAL;Jean;EXG;59
Législatives 2012 - 1er tour;Législatives;2012;1;11;11ème circonscription;46;MALAKOFF;92046;18858;7608;11250;119;11131;LEGENDRE Cédric;M;LEGENDRE;Cédric;DVD;70
Législatives 2012 - 1er tour;Législatives;2012;1;8;8ème circonscription;48;MEUDON;92048;25002;9709;15293;150;15143;PAILLARD Christophe;M;PAILLARD;Christophe;AUT;15
Législatives 2012 - 1er tour;Législatives;2012;1;11;11ème circonscription;49;MONTROUGE;92049;27889;10680;17209;123;17086;LEGENDRE Cédric;M;LEGENDRE;Cédric;DVD;43
Législatives 2012 - 1er tour;Législatives;2012;1;4;4ème circonscription;50;NANTERRE;92050;44344;21046;23298;337;22961;DE BEAUFORT Viviane;F;DE BEAUFORT;Viviane;PRV;107
Législatives 2012 - 1er tour;Législatives;2012;1;12;12ème circonscription;60;LE PLESSIS ROBINSON;92060;18785;6274;12511;101;12410;LE METAYER Jocelyne;F;LE METAYER;Jocelyne;FG;593
Législatives 2012 - 1er tour;Législatives;2012;1;7;7ème circonscription;63;RUEIL MALMAISON;92063;52518;20526;31992;298;31694;CHAUDON Anne-Laure;F;CHAUDON;Anne-Laure;EXG;101
Législatives 2012 - 1er tour;Législatives;2012;1;8;8ème circonscription;72;SEVRES;92072;14861;5785;9076;101;8975;CHETAILLE Romain;M;CHETAILLE;Romain;DVD;556
Législatives 2002 - 1er tour;Législatives;2002;1;12;12ème circonscription;23;CLAMART;92023;32916;11487;21429;154;21275;KALTENBACH Philippe;M;KALTENBACH;Philippe;SOC;6919
Législatives 2002 - 1er tour;Législatives;2002;1;1;1ère circonscription;25;COLOMBES;92025;26192;12273;13919;366;13553;GUICHARD Isabelle;F;GUICHARD;Isabelle;EXG;240
Législatives 2002 - 1er tour;Législatives;2002;1;7;7ème circonscription;33;GARCHES;92033;12286;4601;7685;112;7573;INDJIAN Patrick;M;INDJIAN;Patrick;DVG;20
Législatives 2002 - 1er tour;Législatives;2002;1;1;1ère circonscription;36;GENNEVILLIERS;92036;20048;9522;10526;189;10337;BEN M'BAREK Hassan;M;BEN M'BAREK;Hassan;DIV;247
Législatives 2002 - 1er tour;Législatives;2002;1;10;10ème circonscription;40;ISSY LES MOULINEAUX;92040;38520;14017;24503;359;24144;VENTURINI Jean-Michel;M;VENTURINI;Jean-Michel;DIV;20
Législatives 2002 - 1er tour;Législatives;2002;1;10;10ème circonscription;48;MEUDON;92048;5066;1864;3202;29;3173;TERRET Eugène;M;TERRET;Eugène;FN;75
Législatives 2002 - 1er tour;Législatives;2002;1;12;12ème circonscription;60;LE PLESSIS ROBINSON;92060;16776;5588;11188;123;11065;PEMEZEC Philippe;M;PEMEZEC;Philippe;UMP;6531
Législatives 2002 - 1er tour;Législatives;2002;1;7;7ème circonscription;64;SAINT CLOUD;92064;19115;6812;12303;93;12210;FARCIS Dominique;M;FARCIS;Dominique;DVD;48
Législatives 2002 - 1er tour;Législatives;2002;1;8;8ème circonscription;72;SEVRES;92072;14460;5279;9181;151;9030;GONNET Nicolas;M;GONNET;Nicolas;COM;158
Législatives 2002 - 1er tour;Législatives;2002;1;4;4ème circonscription;73;SURESNES;92073;24666;8949;15717;206;15511;FRAYSSE Jacqueline;F;FRAYSSE;Jacqueline;COM;1797
Législatives 2002 - 1er tour;Législatives;2002;1;4;4ème circonscription;73;SURESNES;92073;24666;8949;15717;206;15511;MEYER Marie-Laure;F;MEYER;Marie-Laure;SOC;2360
Législatives 2002 - 1er tour;Législatives;2002;1;10;10ème circonscription;75;VANVES;92075;17351;5929;11422;137;11285;NAVIAUX Catherine;F;NAVIAUX;Catherine;VEC;527
Législatives 2002 - 1er tour;Législatives;2002;1;8;8ème circonscription;76;VAUCRESSON;92076;6076;2206;3870;46;3824;CYROULNIK Marie-France;F;CYROULNIK;Marie-France;EXG;25
Législatives 2002 - 1er tour;Législatives;2002;1;8;8ème circonscription;77;VILLE D'AVRAY;92077;7475;2429;5046;60;4986;CYROULNIK Marie-France;F;CYROULNIK;Marie-France;EXG;36
Législatives 2002 - 1er tour;Législatives;2002;1;8;8ème circonscription;77;VILLE D'AVRAY;92077;7475;2429;5046;60;4986;BOUCHARD Renaud;M;BOUCHARD;Renaud;DIV;3
Législatives 2002 - 1er tour;Législatives;2002;1;1;1ère circonscription;78;VILLENEUVE LA GARENNE;92078;13038;7211;5827;131;5696;SARRE Philippe;M;SARRE;Philippe;SOC;1390
Législatives 1997 - 1er tour;Législatives;1997;1;10;10ème circonscription;40;ISSY LES MOULINEAUX;92040;30164;10899;19265;543;18722;BRUNET FRANCOISE;F;BRUNET;FRANCOISE;EXG;474
Législatives 1997 - 1er tour;Législatives;1997;1;9;9ème circonscription;12;BOULOGNE BILLANCOURT;92012;53287;18902;34385;948;33437;MAURICE J.PIERRE;M;MAURICE;J.PIERRE;EXG;561
Législatives 1997 - 1er tour;Législatives;1997;1;10;10ème circonscription;40;ISSY LES MOULINEAUX;92040;30164;10899;19265;543;18722;JANVIER GUY;M;JANVIER;GUY;SOC;3893
Législatives 1997 - 1er tour;Législatives;1997;1;12;12ème circonscription;32;FONTENAY AUX ROSES;92032;14748;4655;10093;259;9834;LARCHER ROBERT;M;LARCHER;ROBERT;EXG;251
Législatives 1997 - 1er tour;Législatives;1997;1;1;1ère circonscription;25;COLOMBES;92025;26238;10153;16085;513;15572;BRUNHES JACQUES;M;BRUNHES;JACQUES;COM;4218
Législatives 1997 - 1er tour;Législatives;1997;1;12;12ème circonscription;23;CLAMART;92023;30471;10310;20161;590;19571;GERMA PHILIPPE;M;GERMA;PHILIPPE;DVD;527
Législatives 1997 - 1er tour;Législatives;1997;1;12;12ème circonscription;23;CLAMART;92023;30471;10310;20161;590;19571;LE BERRE ALAIN;M;LE BERRE;ALAIN;FRN;2388
Législatives 1997 - 1er tour;Législatives;1997;1;1;1ère circonscription;25;COLOMBES;92025;26238;10153;16085;513;15572;LOBRY MAURICE;M;LOBRY;MAURICE;SOC;2777
Législatives 1997 - 1er tour;Législatives;1997;1;13;13ème circonscription;19;CHATENAY MALABRY;92019;17859;6462;11397;367;11030;LE NET HERVE;M;LE NET;HERVE;DVD;80
Législatives 1997 - 1er tour;Législatives;1997;1;8;8ème circonscription;22;CHAVILLE;92022;12268;3930;8338;262;8076;GUILLET J.JACQUES;M;GUILLET;J.JACQUES;RPR;2906
Législatives 1997 - 1er tour;Législatives;1997;1;13;13ème circonscription;19;CHATENAY MALABRY;92019;17859;6462;11397;367;11030;ORHAN LOUIS;M;ORHAN;LOUIS;EXG;272
Législatives 1997 - 1er tour;Législatives;1997;1;12;12ème circonscription;23;CLAMART;92023;30471;10310;20161;590;19571;FOUCHER J.PIERRE;M;FOUCHER;J.PIERRE;UDF;5617
Législatives 1997 - 1er tour;Législatives;1997;1;8;8ème circonscription;77;VILLE D'AVRAY;92077;7112;2283;4829;139;4690;ARIA D DANIELA;F;ARIA D;DANIELA;DIV;0
Législatives 1997 - 1er tour;Législatives;1997;1;8;8ème circonscription;47;MARNES LA COQUETTE;92047;985;289;696;19;677;JOURNE SILIAN;M;JOURNE;SILIAN;DVD;47
Législatives 2002 - 2ème tour;Législatives;2002;2;10;10ème circonscription;12;BOULOGNE BILLANCOURT;92012;4747;2219;2528;80;2448;SANTINI ANDRE;M;SANTINI;ANDRE;UDF;1296
Législatives 2002 - 2ème tour;Législatives;2002;2;12;12ème circonscription;32;FONTENAY AUX ROSES;92032;14272;4933;9339;309;9030;PEMEZEC PHILIPPE;M;PEMEZEC;PHILIPPE;RPF;4332
Législatives 1997 - 1er tour;Législatives;1997;1;3;3ème circonscription;9;BOIS COLOMBES;92009;14757;5447;9310;293;9017;DENJEAN NAVAILLE J.MARC;M;DENJEAN NAVAILLE;J.MARC;EXG;102
Législatives 1997 - 2ème tour;Législatives;1997;2;1;1ère circonscription;78;VILLENEUVE LA GARENNE;92078;11471;4809;6662;598;6064;BRUNHES JACQUES;M;BRUNHES;JACQUES;COM;3770
Législatives 1997 - 2ème tour;Législatives;1997;2;10;10ème circonscription;40;ISSY LES MOULINEAUX;92040;34277;11408;22869;932;21937;SANTINI ANDRE;M;SANTINI;ANDRE;UDF;12780
Législatives 1997 - 2ème tour;Législatives;1997;2;7;7ème circonscription;33;GARCHES;92033;26236;8908;17328;768;16560;BAUMEL JACQUES;M;BAUMEL;JACQUES;RPR;11167
Législatives 1997 - 1er tour;Législatives;1997;1;3;3ème circonscription;9;BOIS COLOMBES;92009;14757;5447;9310;293;9017;LEROY BUREL CORINNE;F;LEROY BUREL;CORINNE;ECO;426
Législatives 1997 - 1er tour;Législatives;1997;1;7;7ème circonscription;33;GARCHES;92033;11323;3745;7578;290;7288;PEYRILLER PAUL;M;PEYRILLER;PAUL;ECO;53
Législatives 1997 - 1er tour;Législatives;1997;1;12;12ème circonscription;60;LE PLESSIS ROBINSON;92060;13002;3860;9142;204;8938;ILTIS DANIELLE;F;ILTIS;DANIELLE;EXG;54
Législatives 1997 - 1er tour;Législatives;1997;1;6;6ème circonscription;62;PUTEAUX;92062;24329;8862;15467;635;14832;LAURENT PATRICIA;F;LAURENT;PATRICIA;DVD;263
Législatives 1997 - 1er tour;Législatives;1997;1;4;4ème circonscription;50;NANTERRE;92050;38533;13799;24734;766;23968;KATZ AGNES;F;KATZ;AGNES;DVG;60
Législatives 1997 - 1er tour;Législatives;1997;1;3;3ème circonscription;9;BOIS COLOMBES;92009;14757;5447;9310;293;9017;HABANS ROGER;M;HABANS;ROGER;EXD;19
Législatives 2012 - 2ème tour;Législatives;2012;2;3;3ème circonscription;26;COURBEVOIE;92026;42456;18036;24420;545;23875;KOSSOWSKI Jacques;M;KOSSOWSKI;Jacques;UMP;13953
Législatives 2012 - 2ème tour;Législatives;2012;2;3;3ème circonscription;35;LA GARENNE COLOMBES;92035;17314;7511;9803;208;9595;LASSERRE Jean-André;M;LASSERRE;Jean-André;SOC;4034
Législatives 2012 - 2ème tour;Législatives;2012;2;8;8ème circonscription;76;VAUCRESSON;92076;6093;2589;3504;111;3393;LIME-BIFFE Catherine;F;LIME-BIFFE;Catherine;SOC;917
Législatives 1997 - 1er tour;Législatives;1997;1;10;10ème circonscription;12;BOULOGNE BILLANCOURT;92012;4529;1717;2812;99;2713;JANVIER FREDERIC;M;JANVIER;FREDERIC;EXD;104
Législatives 1997 - 1er tour;Législatives;1997;1;9;9ème circonscription;12;BOULOGNE BILLANCOURT;92012;53287;18902;34385;948;33437;GABORIT PIERRE;M;GABORIT;PIERRE;SOC;6367
Législatives 1997 - 1er tour;Législatives;1997;1;10;10ème circonscription;12;BOULOGNE BILLANCOURT;92012;4529;1717;2812;99;2713;LE ROY THIERRY;M;LE ROY;THIERRY;DVG;239
Législatives 2012 - 1er tour;Législatives;2012;1;6;6ème circonscription;26;COURBEVOIE;92026;8123;3742;4381;140;4241;CABRERA Julien;M;CABRERA;Julien;DVD;45
Législatives 2012 - 1er tour;Législatives;2012;1;3;3ème circonscription;35;LA GARENNE COLOMBES;92035;17314;7036;10278;79;10199;LAUPIES Pierre-Louis;M;LAUPIES;Pierre-Louis;DVD;50
Législatives 2012 - 1er tour;Législatives;2012;1;1;1ère circonscription;36;GENNEVILLIERS;92036;20795;10523;10272;192;10080;BUTAYE Denis;M;BUTAYE;Denis;DVD;134
Législatives 2012 - 1er tour;Législatives;2012;1;10;10ème circonscription;40;ISSY LES MOULINEAUX;92040;42014;16484;25530;277;25253;BUNOT Sandrine;F;BUNOT;Sandrine;FN;1160
Législatives 2012 - 1er tour;Législatives;2012;1;5;5ème circonscription;44;LEVALLOIS PERRET;92044;39546;14667;24879;238;24641;CHIARELLI Xavier;M;CHIARELLI;Xavier;EXG;39
Législatives 2012 - 1er tour;Législatives;2012;1;5;5ème circonscription;44;LEVALLOIS PERRET;92044;39546;14667;24879;238;24641;RONDEPIERRE Geoffroy;M;RONDEPIERRE;Geoffroy;FN;1180
Législatives 2012 - 1er tour;Législatives;2012;1;11;11ème circonscription;46;MALAKOFF;92046;18858;7608;11250;119;11131;BRANAA Jean-Eric;M;BRANAA;Jean-Eric;CEN;58
Législatives 2012 - 1er tour;Législatives;2012;1;8;8ème circonscription;47;MARNES LA COQUETTE;92047;1085;330;755;2;753;BECQ Michel;M;BECQ;Michel;DVD;1
Législatives 2012 - 1er tour;Législatives;2012;1;8;8ème circonscription;48;MEUDON;92048;25002;9709;15293;150;15143;CANDELIER Catherine;F;CANDELIER;Catherine;VEC;586
Législatives 2012 - 1er tour;Législatives;2012;1;8;8ème circonscription;48;MEUDON;92048;25002;9709;15293;150;15143;LE BAUT Anne;F;LE BAUT;Anne;FN;1101
Législatives 2012 - 1er tour;Législatives;2012;1;6;6ème circonscription;62;PUTEAUX;92062;28253;11141;17112;441;16671;DEROCHE François;M;DEROCHE;François;DVD;307
Législatives 2012 - 1er tour;Législatives;2012;1;7;7ème circonscription;63;RUEIL MALMAISON;92063;52518;20526;31992;298;31694;HOSTEINS Olivier;M;HOSTEINS;Olivier;CEN;1141
Législatives 2012 - 1er tour;Législatives;2012;1;7;7ème circonscription;64;SAINT CLOUD;92064;19029;7431;11598;97;11501;OLLIER Patrick;M;OLLIER;Patrick;UMP;5801
Législatives 2012 - 1er tour;Législatives;2012;1;13;13ème circonscription;71;SCEAUX;92071;14395;5253;9142;70;9072;DE ZAYAS Marie;F;DE ZAYAS;Marie;DVD;89
Législatives 2012 - 1er tour;Législatives;2012;1;13;13ème circonscription;71;SCEAUX;92071;14395;5253;9142;70;9072;GEORGET Michel;M;GEORGET;Michel;FN;479
Législatives 2012 - 1er tour;Législatives;2012;1;8;8ème circonscription;72;SEVRES;92072;14861;5785;9076;101;8975;MOGHIR Naïma;F;MOGHIR;Naïma;ECO;59
Législatives 2012 - 1er tour;Législatives;2012;1;4;4ème circonscription;73;SURESNES;92073;26492;10723;15769;302;15467;BOUQUET André;M;BOUQUET;André;EXG;9
Législatives 2012 - 1er tour;Législatives;2012;1;1;1ère circonscription;78;VILLENEUVE LA GARENNE;92078;12349;6903;5446;131;5315;YAHIAOUI Karim;M;YAHIAOUI;Karim;CEN;203
Législatives 1997 - 1er tour;Législatives;1997;1;3;3ème circonscription;26;COURBEVOIE;92026;35738;12354;23384;653;22731;LAIDI AMIROUCHE;M;LAIDI;AMIROUCHE;ECO;472
Législatives 1997 - 1er tour;Législatives;1997;1;1;1ère circonscription;25;COLOMBES;92025;26238;10153;16085;513;15572;MICHON SYLVAIN;M;MICHON;SYLVAIN;EXG;99
Législatives 1997 - 1er tour;Législatives;1997;1;2;2ème circonscription;25;COLOMBES;92025;17603;6110;11493;415;11078;HOUZEL ALAIN;M;HOUZEL;ALAIN;ECO;513
Législatives 1997 - 1er tour;Législatives;1997;1;12;12ème circonscription;20;CHATILLON;92020;16406;5234;11172;367;10805;PEMEZEC PHILIPPE;M;PEMEZEC;PHILIPPE;DVD;983
Législatives 1997 - 1er tour;Législatives;1997;1;5;5ème circonscription;24;CLICHY;92024;23725;8942;14783;486;14297;PERCEVAULT RICHARD;M;PERCEVAULT;RICHARD;EXG;402
Législatives 1997 - 1er tour;Législatives;1997;1;12;12ème circonscription;20;CHATILLON;92020;16406;5234;11172;367;10805;GERMA PHILIPPE;M;GERMA;PHILIPPE;DVD;292
Législatives 1997 - 1er tour;Législatives;1997;1;12;12ème circonscription;20;CHATILLON;92020;16406;5234;11172;367;10805;ILTIS DANIELLE;F;ILTIS;DANIELLE;EXG;51
Législatives 1997 - 1er tour;Législatives;1997;1;12;12ème circonscription;23;CLAMART;92023;30471;10310;20161;590;19571;GRIELEN ALAIN;M;GRIELEN;ALAIN;DVG;59
Législatives 1997 - 1er tour;Législatives;1997;1;5;5ème circonscription;24;CLICHY;92024;23725;8942;14783;486;14297;GALLAIS ALAIN;M;GALLAIS;ALAIN;FRN;2564
Législatives 1997 - 1er tour;Législatives;1997;1;8;8ème circonscription;72;SEVRES;92072;13776;4413;9363;352;9011;MULLERIS KONOPNICKI A.PAULE;F;MULLERIS KONOPNICKI;A.PAULE;ECO;685
Législatives 1997 - 1er tour;Législatives;1997;1;4;4ème circonscription;73;SURESNES;92073;20985;7217;13768;441;13327;SCHMIT MICHEL;M;SCHMIT;MICHEL;FRN;1631
Législatives 2012 - 1er tour;Législatives;2012;1;11;11ème circonscription;7;BAGNEUX;92007;20609;9648;10961;145;10816;JACQUES Alain;M;JACQUES;Alain;EXG;50
Législatives 2012 - 1er tour;Législatives;2012;1;9;9ème circonscription;12;BOULOGNE BILLANCOURT;92012;61020;24579;36441;340;36101;DUFOUR Julien;M;DUFOUR;Julien;FN;1908
Législatives 2012 - 1er tour;Législatives;2012;1;8;8ème circonscription;22;CHAVILLE;92022;12808;4688;8120;75;8045;HENIQUE Philippe;M;HENIQUE;Philippe;EXG;20
Législatives 2012 - 1er tour;Législatives;2012;1;8;8ème circonscription;22;CHAVILLE;92022;12808;4688;8120;75;8045;SALA Emmanuel;M;SALA;Emmanuel;DVD;47
Législatives 2012 - 1er tour;Législatives;2012;1;2;2ème circonscription;25;COLOMBES;92025;18458;7115;11343;114;11229;MARTIN SAINT LEON Laurent;M;MARTIN SAINT LEON;Laurent;DVD;220
Législatives 1997 - 1er tour;Législatives;1997;1;12;12ème circonscription;20;CHATILLON;92020;16406;5234;11172;367;10805;LARCHER ROBERT;M;LARCHER;ROBERT;EXG;333
Législatives 1997 - 1er tour;Législatives;1997;1;11;11ème circonscription;7;BAGNEUX;92007;20284;7388;12896;374;12522;BATIFOL JEROME;M;BATIFOL;JEROME;DVD;108
Législatives 1997 - 1er tour;Législatives;1997;1;1;1ère circonscription;78;VILLENEUVE LA GARENNE;92078;11471;4645;6826;211;6615;GAZEAU STEPHANE;M;GAZEAU;STEPHANE;DIV;0
Législatives 1997 - 1er tour;Législatives;1997;1;1;1ère circonscription;78;VILLENEUVE LA GARENNE;92078;11471;4645;6826;211;6615;BRUNHES JACQUES;M;BRUNHES;JACQUES;COM;1465
Législatives 1997 - 2ème tour;Législatives;1997;2;10;10ème circonscription;12;BOULOGNE BILLANCOURT;92012;4529;1615;2914;124;2790;SANTINI ANDRE;M;SANTINI;ANDRE;UDF;1324
Législatives 2012 - 2ème tour;Législatives;2012;2;13;13ème circonscription;14;BOURG LA REINE;92014;13306;4586;8720;216;8504;LANDFRIED Julien;M;LANDFRIED;Julien;DVG;4347
Législatives 2012 - 2ème tour;Législatives;2012;2;3;3ème circonscription;26;COURBEVOIE;92026;42456;18036;24420;545;23875;LASSERRE Jean-André;M;LASSERRE;Jean-André;SOC;9922
Législatives 2012 - 2ème tour;Législatives;2012;2;8;8ème circonscription;76;VAUCRESSON;92076;6093;2589;3504;111;3393;GUILLET Jean-Jacques;M;GUILLET;Jean-Jacques;UMP;2476
Législatives 2002 - 1er tour;Législatives;2002;1;2;2ème circonscription;4;ASNIERES SUR SEINE;92004;44110;17783;26327;312;26015;MASSOL Hubert;M;MASSOL;Hubert;EXD;282
Législatives 2002 - 1er tour;Législatives;2002;1;13;13ème circonscription;14;BOURG LA REINE;92014;13381;4391;8990;78;8912;DEVEDJIAN Patrick;M;DEVEDJIAN;Patrick;UMP;3910
Législatives 2002 - 1er tour;Législatives;2002;1;13;13ème circonscription;19;CHATENAY MALABRY;92019;17835;6584;11251;211;11040;LEPEUVE Stéphane;M;LEPEUVE;Stéphane;EXG;281
Législatives 2002 - 1er tour;Législatives;2002;1;13;13ème circonscription;19;CHATENAY MALABRY;92019;17835;6584;11251;211;11040;DELRIEU Denis;M;DELRIEU;Denis;VEC;427
Législatives 2002 - 1er tour;Législatives;2002;1;13;13ème circonscription;19;CHATENAY MALABRY;92019;17835;6584;11251;211;11040;HOLLEBEKE Dominique;F;HOLLEBEKE;Dominique;MPF;95
Législatives 2002 - 1er tour;Législatives;2002;1;8;8ème circonscription;22;CHAVILLE;92022;12928;4682;8246;120;8126;RUSSO Annick;F;RUSSO;Annick;DIV;8
Législatives 2002 - 1er tour;Législatives;2002;1;12;12ème circonscription;23;CLAMART;92023;32916;11487;21429;154;21275;SCHMITT Jean-Pierre;M;SCHMITT;Jean-Pierre;FN;492
Législatives 2002 - 1er tour;Législatives;2002;1;12;12ème circonscription;32;FONTENAY AUX ROSES;92032;15468;5605;9863;84;9779;PEMEZEC Philippe;M;PEMEZEC;Philippe;UMP;3974
Législatives 2002 - 1er tour;Législatives;2002;1;3;3ème circonscription;35;LA GARENNE COLOMBES;92035;16552;5947;10605;101;10504;MARCEL Françoise;F;MARCEL;Françoise;EXG;57
Législatives 2002 - 1er tour;Législatives;2002;1;3;3ème circonscription;35;LA GARENNE COLOMBES;92035;16552;5947;10605;101;10504;HERBIN Annick;F;HERBIN;Annick;COM;175
Législatives 2002 - 1er tour;Législatives;2002;1;3;3ème circonscription;35;LA GARENNE COLOMBES;92035;16552;5947;10605;101;10504;DORE Patricia;F;DORE;Patricia;ECO;169
Législatives 2002 - 1er tour;Législatives;2002;1;3;3ème circonscription;35;LA GARENNE COLOMBES;92035;16552;5947;10605;101;10504;TRIBOULET Catherine;F;TRIBOULET;Catherine;DIV;0
Législatives 2002 - 1er tour;Législatives;2002;1;10;10ème circonscription;40;ISSY LES MOULINEAUX;92040;38520;14017;24503;359;24144;WOUTERS Nina;F;WOUTERS;Nina;EXG;392
Législatives 2002 - 1er tour;Législatives;2002;1;5;5ème circonscription;44;LEVALLOIS PERRET;92044;39466;14724;24742;404;24338;FURON Férial;F;FURON;Férial;DVD;220
Législatives 2002 - 1er tour;Législatives;2002;1;8;8ème circonscription;48;MEUDON;92048;25427;9683;15744;202;15542;CYROULNIK Marie-France;F;CYROULNIK;Marie-France;EXG;294
Législatives 2002 - 1er tour;Législatives;2002;1;12;12ème circonscription;60;LE PLESSIS ROBINSON;92060;16776;5588;11188;123;11065;BENARD Paul;M;BENARD;Paul;EXG;24
Législatives 2002 - 1er tour;Législatives;2002;1;12;12ème circonscription;60;LE PLESSIS ROBINSON;92060;16776;5588;11188;123;11065;ZANOLIN Ludovic;F;ZANOLIN;Ludovic;COM;323
Législatives 2002 - 1er tour;Législatives;2002;1;7;7ème circonscription;63;RUEIL MALMAISON;92063;51481;18902;32579;337;32242;DE VAUREIX Anne;F;DE VAUREIX;Anne;MPF;166
Législatives 2002 - 1er tour;Législatives;2002;1;7;7ème circonscription;64;SAINT CLOUD;92064;19115;6812;12303;93;12210;INDJIAN Patrick;M;INDJIAN;Patrick;DVG;30
Législatives 2002 - 1er tour;Législatives;2002;1;8;8ème circonscription;72;SEVRES;92072;14460;5279;9181;151;9030;BLANCHARD Luc;M;BLANCHARD;Luc;VEC;462
Législatives 2002 - 1er tour;Législatives;2002;1;4;4ème circonscription;73;SURESNES;92073;24666;8949;15717;206;15511;LE TOUZE Estelle;F;LE TOUZE;Estelle;VEC;398
Législatives 2002 - 1er tour;Législatives;2002;1;4;4ème circonscription;73;SURESNES;92073;24666;8949;15717;206;15511;HOUTART Arnaud;M;HOUTART;Arnaud;MPF;102
Législatives 1997 - 1er tour;Législatives;1997;1;13;13ème circonscription;19;CHATENAY MALABRY;92019;17859;6462;11397;367;11030;SCHNEITER LEONORE;F;SCHNEITER;LEONORE;ECO;231
Législatives 1997 - 1er tour;Législatives;1997;1;8;8ème circonscription;47;MARNES LA COQUETTE;92047;985;289;696;19;677;ARIA D DANIELA;F;ARIA D;DANIELA;DIV;0
Législatives 1997 - 1er tour;Législatives;1997;1;11;11ème circonscription;46;MALAKOFF;92046;19124;7233;11891;338;11553;METTON J.LOUP;M;METTON;J.LOUP;UDF;2197
Législatives 1997 - 2ème tour;Législatives;1997;2;5;5ème circonscription;44;LEVALLOIS PERRET;92044;28281;8240;20041;1147;18894;CHAZEAUX DE OLIVIER;M;CHAZEAUX DE;OLIVIER;RPR;10785
Législatives 1997 - 2ème tour;Législatives;1997;2;11;11ème circonscription;46;MALAKOFF;92046;19124;7011;12113;528;11585;JAMBU JANINE;F;JAMBU;JANINE;COM;7601
Législatives 1997 - 1er tour;Législatives;1997;1;7;7ème circonscription;33;GARCHES;92033;11323;3745;7578;290;7288;DRIOUT PIERRE;M;DRIOUT;PIERRE;EXD;40
Législatives 1997 - 1er tour;Législatives;1997;1;10;10ème circonscription;40;ISSY LES MOULINEAUX;92040;30164;10899;19265;543;18722;DENIAU RAYMOND;M;DENIAU;RAYMOND;EXG;187
Législatives 1997 - 1er tour;Législatives;1997;1;1;1ère circonscription;36;GENNEVILLIERS;92036;19277;7226;12051;295;11756;MERRA RICHARD;M;MERRA;RICHARD;EXG;258
Législatives 1997 - 2ème tour;Législatives;1997;2;8;8ème circonscription;77;VILLE D'AVRAY;92077;7112;1988;5124;162;4962;LEVAIN JEAN;M;LEVAIN;JEAN;PRS;1320
Présidentielles 2017 - 1er tour;Présidentielles;2017;1;;;7;BAGNEUX;92007;21873;5369;16504;428;16076;LE PEN Marine;F;LE PEN;Marine;;1685
Présidentielles 2017 - 1er tour;Présidentielles;2017;1;;;14;BOURG LA REINE;92014;13769;2202;11567;212;11355;LASSALLE Jean;M;LASSALLE;Jean;;65
Présidentielles 2017 - 1er tour;Présidentielles;2017;1;;;19;CHATENAY MALABRY;92019;18708;3336;15372;454;14918;LE PEN Marine;F;LE PEN;Marine;;1366
Présidentielles 2017 - 1er tour;Présidentielles;2017;1;;;20;CHATILLON;92020;22292;3682;18610;351;18259;MACRON Emmanuel;M;MACRON;Emmanuel;;6212
Présidentielles 2017 - 1er tour;Présidentielles;2017;1;;;23;CLAMART;92023;35291;6330;28961;560;28401;ARTHAUD Nathalie;F;ARTHAUD;Nathalie;;112
Présidentielles 2017 - 1er tour;Présidentielles;2017;1;;;24;CLICHY;92024;28553;5564;22989;498;22491;DUPONT-AIGNAN Nicolas;M;DUPONT-AIGNAN;Nicolas;;546
Présidentielles 2017 - 1er tour;Présidentielles;2017;1;;;26;COURBEVOIE;92026;52391;9609;42782;817;41965;ASSELINEAU François;M;ASSELINEAU;François;;415
Présidentielles 2017 - 1er tour;Présidentielles;2017;1;;;33;GARCHES;92033;12767;1975;10792;194;10598;ARTHAUD Nathalie;F;ARTHAUD;Nathalie;;18
Présidentielles 2017 - 1er tour;Présidentielles;2017;1;;;35;LA GARENNE COLOMBES;92035;18828;3121;15707;289;15418;LASSALLE Jean;M;LASSALLE;Jean;;99
Présidentielles 2017 - 1er tour;Présidentielles;2017;1;;;36;GENNEVILLIERS;92036;22149;5526;16623;490;16133;DUPONT-AIGNAN Nicolas;M;DUPONT-AIGNAN;Nicolas;;328
Présidentielles 2017 - 1er tour;Présidentielles;2017;1;;;40;ISSY LES MOULINEAUX;92040;46800;9050;37750;728;37022;DUPONT-AIGNAN Nicolas;M;DUPONT-AIGNAN;Nicolas;;1008
Présidentielles 2017 - 1er tour;Présidentielles;2017;1;;;44;LEVALLOIS PERRET;92044;41716;6107;35609;511;35098;ARTHAUD Nathalie;F;ARTHAUD;Nathalie;;54
Présidentielles 2017 - 1er tour;Présidentielles;2017;1;;;44;LEVALLOIS PERRET;92044;41716;6107;35609;511;35098;POUTOU Philippe;M;POUTOU;Philippe;;150
Présidentielles 2017 - 1er tour;Présidentielles;2017;1;;;47;MARNES LA COQUETTE;92047;1215;171;1044;5;1039;ASSELINEAU François;M;ASSELINEAU;François;;3
Présidentielles 2017 - 1er tour;Présidentielles;2017;1;;;48;MEUDON;92048;31280;5715;25565;405;25160;DUPONT-AIGNAN Nicolas;M;DUPONT-AIGNAN;Nicolas;;682
Présidentielles 2017 - 1er tour;Présidentielles;2017;1;;;62;PUTEAUX;92062;28950;4530;24420;549;23871;POUTOU Philippe;M;POUTOU;Philippe;;211
Présidentielles 2017 - 1er tour;Présidentielles;2017;1;;;63;RUEIL MALMAISON;92063;54426;9298;45128;713;44414;DUPONT-AIGNAN Nicolas;M;DUPONT-AIGNAN;Nicolas;;1381
Présidentielles 2017 - 1er tour;Présidentielles;2017;1;;;77;VILLE D'AVRAY;92077;7433;837;6596;89;6507;HAMON Benoît;M;HAMON;Benoît;;368
Législatives 2007 - 1er tour;Législatives;2007;1;2;2ème circonscription;4;ASNIERES SUR SEINE;92004;44110;17783;26327;312;26015;ETCHEBERRY Michèle;F;ETCHEBERRY;Michèle;SOC;5799
Législatives 2007 - 1er tour;Législatives;2007;1;8;8ème circonscription;47;MARNES LA COQUETTE;92047;1074;316;758;5;753;BOUCHARD Renaud;M;BOUCHARD;Renaud;DIV;0
Législatives 2007 - 1er tour;Législatives;2007;1;10;10ème circonscription;48;MEUDON;92048;5066;1864;3202;29;3173;BOTTET Philippe;M;BOTTET;Philippe;EXG;15
Législatives 2007 - 1er tour;Législatives;2007;1;10;10ème circonscription;48;MEUDON;92048;5066;1864;3202;29;3173;SCHMID Lucille;F;SCHMID;Lucille;SOC;752
Législatives 2007 - 1er tour;Législatives;2007;1;10;10ème circonscription;48;MEUDON;92048;5066;1864;3202;29;3173;SANTINI André;M;SANTINI;André;MAJ;1456
Législatives 2007 - 1er tour;Législatives;2007;1;6;6ème circonscription;62;PUTEAUX;92062;26791;8829;17962;396;17566;FROMANTIN Jean-Christophe;M;FROMANTIN;Jean-Christophe;DIV;799
Législatives 2007 - 1er tour;Législatives;2007;1;7;7ème circonscription;63;RUEIL MALMAISON;92063;51481;18902;32579;337;32242;DE VAUREIX Anne;F;DE VAUREIX;Anne;MPF;166
Législatives 2007 - 1er tour;Législatives;2007;1;7;7ème circonscription;64;SAINT CLOUD;92064;19115;6812;12303;93;12210;DE VAUREIX Anne;F;DE VAUREIX;Anne;MPF;133
Législatives 2007 - 1er tour;Législatives;2007;1;7;7ème circonscription;64;SAINT CLOUD;92064;19115;6812;12303;93;12210;FARCIS Dominique;M;FARCIS;Dominique;DVD;48
Législatives 2007 - 1er tour;Législatives;2007;1;13;13ème circonscription;71;SCEAUX;92071;14129;4679;9450;74;9376;BRAULT Chantal;F;BRAULT;Chantal;UDFD;2012
Législatives 2007 - 1er tour;Législatives;2007;1;8;8ème circonscription;72;SEVRES;92072;14460;5279;9181;151;9030;LUCET Francis;M;LUCET;Francis;EXG;47
Législatives 2007 - 1er tour;Législatives;2007;1;4;4ème circonscription;73;SURESNES;92073;24666;8949;15717;206;15511;LE TOUZE Estelle;F;LE TOUZE;Estelle;VEC;398
Législatives 2007 - 2ème tour;Législatives;2007;2;11;11ème circonscription;7;BAGNEUX;92007;20521;8801;11720;247;11473;AMIABLE Marie-Hélène;F;AMIABLE;Marie-Hélène;COM;7368
Législatives 2007 - 2ème tour;Législatives;2007;2;11;11ème circonscription;46;MALAKOFF;92046;18478;7595;10883;247;10636;AMIABLE Marie-Hélène;F;AMIABLE;Marie-Hélène;COM;7431
Législatives 2007 - 1er tour;Législatives;2007;1;12;12ème circonscription;32;FONTENAY AUX ROSES;92032;15468;5605;9863;84;9779;BRILLON Freddy;M;BRILLON;Freddy;DVD;88
Législatives 2007 - 1er tour;Législatives;2007;1;3;3ème circonscription;35;LA GARENNE COLOMBES;92035;16552;5947;10605;101;10504;HERBIN Annick;F;HERBIN;Annick;COM;175
Législatives 2007 - 1er tour;Législatives;2007;1;3;3ème circonscription;9;BOIS COLOMBES;92009;16245;6561;9684;288;9396;LASSERRE Jean-André;M;LASSERRE;Jean-André;SOC;1968
Législatives 2007 - 1er tour;Législatives;2007;1;3;3ème circonscription;9;BOIS COLOMBES;92009;16245;6561;9684;288;9396;CHAGNON Louis;M;CHAGNON;Louis;MPF;117
Législatives 2007 - 1er tour;Législatives;2007;1;12;12ème circonscription;32;FONTENAY AUX ROSES;92032;15468;5605;9863;84;9779;DELOM Christian;M;DELOM;Christian;UDFD;1092
Législatives 2007 - 1er tour;Législatives;2007;1;12;12ème circonscription;32;FONTENAY AUX ROSES;92032;15468;5605;9863;84;9779;LARCHER Robert;M;LARCHER;Robert;EXG;46
Législatives 2007 - 1er tour;Législatives;2007;1;3;3ème circonscription;26;COURBEVOIE;92026;49151;19345;29806;541;29265;RAGOT Jean-Louis;M;RAGOT;Jean-Louis;UDFD;3074
Législatives 2007 - 1er tour;Législatives;2007;1;3;3ème circonscription;26;COURBEVOIE;92026;49151;19345;29806;541;29265;CARILLON Rémi;M;CARILLON;Rémi;FN;832
Législatives 2007 - 1er tour;Législatives;2007;1;1;1ère circonscription;25;COLOMBES;92025;26192;12273;13919;366;13553;POURDIEU Stéphanie;F;POURDIEU;Stéphanie;MAJ;34
Législatives 2007 - 1er tour;Législatives;2007;1;5;5ème circonscription;44;LEVALLOIS PERRET;92044;39466;14724;24742;404;24338;FOURNIER Alain;M;FOURNIER;Alain;VEC;558
Législatives 2007 - 1er tour;Législatives;2007;1;5;5ème circonscription;44;LEVALLOIS PERRET;92044;39466;14724;24742;404;24338;MUZEAU Rémi;M;MUZEAU;Rémi;DVD;1540
Législatives 2007 - 1er tour;Législatives;2007;1;13;13ème circonscription;19;CHATENAY MALABRY;92019;17835;6584;11251;211;11040;FIE Dominique;M;FIE;Dominique;COM;268
Législatives 2007 - 1er tour;Législatives;2007;1;13;13ème circonscription;19;CHATENAY MALABRY;92019;17835;6584;11251;211;11040;BASTIDE Anne;F;BASTIDE;Anne;ECO;15
Législatives 2007 - 1er tour;Législatives;2007;1;13;13ème circonscription;14;BOURG LA REINE;92014;13381;4391;8990;78;8912;FIE Dominique;M;FIE;Dominique;COM;189
Législatives 2007 - 1er tour;Législatives;2007;1;12;12ème circonscription;20;CHATILLON;92020;20661;7083;13578;137;13441;DELOM Christian;M;DELOM;Christian;UDFD;1501
Législatives 2007 - 1er tour;Législatives;2007;1;12;12ème circonscription;20;CHATILLON;92020;20661;7083;13578;137;13441;LARCHER Robert;M;LARCHER;Robert;EXG;75
Législatives 2007 - 1er tour;Législatives;2007;1;8;8ème circonscription;22;CHAVILLE;92022;12928;4682;8246;120;8126;GONNET Nicolas;M;GONNET;Nicolas;COM;182
Présidentielles 2002 - 1er tour;Présidentielles;2002;1;;;7;BAGNEUX;92007;18489;5873;12616;519;12097;BAYROU FRANCOIS;M;BAYROU;FRANCOIS;;571
Présidentielles 2002 - 1er tour;Présidentielles;2002;1;;;7;BAGNEUX;92007;18489;5873;12616;519;12097;CHIRAC JACQUES;M;CHIRAC;JACQUES;;1834
Présidentielles 2002 - 1er tour;Présidentielles;2002;1;;;7;BAGNEUX;92007;18489;5873;12616;519;12097;MAMERE NOEL;M;MAMERE;NOEL;;742
Présidentielles 2002 - 1er tour;Présidentielles;2002;1;;;19;CHATENAY MALABRY;92019;15965;4483;11482;241;11241;JOSPIN LIONEL;M;JOSPIN;LIONEL;;2291
Présidentielles 2002 - 1er tour;Présidentielles;2002;1;;;23;CLAMART;92023;31130;10977;20153;427;19726;MEGRET BRUNO;M;MEGRET;BRUNO;;368
Présidentielles 2002 - 1er tour;Présidentielles;2002;1;;;25;COLOMBES;92025;39608;13654;25954;571;25383;LEPAGE CORINNE;F;LEPAGE;CORINNE;;539
Présidentielles 2002 - 1er tour;Présidentielles;2002;1;;;32;FONTENAY AUX ROSES;92032;14148;4309;9839;204;9635;LEPAGE CORINNE;F;LEPAGE;CORINNE;;276
Présidentielles 2002 - 1er tour;Présidentielles;2002;1;;;35;LA GARENNE COLOMBES;92035;15006;5167;9839;227;9612;SAINT-JOSSE JEAN;M;SAINT-JOSSE;JEAN;;87
Présidentielles 2002 - 1er tour;Présidentielles;2002;1;;;36;GENNEVILLIERS;92036;18213;6933;11280;303;10977;HUE ROBERT;M;HUE;ROBERT;;1650
Présidentielles 2002 - 1er tour;Présidentielles;2002;1;;;40;ISSY LES MOULINEAUX;92040;32059;9424;22635;510;22125;MADELIN ALAIN;M;MADELIN;ALAIN;;1244
Présidentielles 2002 - 1er tour;Présidentielles;2002;1;;;47;MARNES LA COQUETTE;92047;997;272;725;7;718;MEGRET BRUNO;M;MEGRET;BRUNO;;9
Présidentielles 2002 - 1er tour;Présidentielles;2002;1;;;47;MARNES LA COQUETTE;92047;997;272;725;7;718;MADELIN ALAIN;M;MADELIN;ALAIN;;75
Présidentielles 2002 - 1er tour;Présidentielles;2002;1;;;50;NANTERRE;92050;37590;13303;24287;669;23618;BOUTIN CHRISTINE;F;BOUTIN;CHRISTINE;;202
Présidentielles 2002 - 1er tour;Présidentielles;2002;1;;;62;PUTEAUX;92062;23861;6804;17057;487;16570;MEGRET BRUNO;M;MEGRET;BRUNO;;307
Présidentielles 2002 - 1er tour;Présidentielles;2002;1;;;63;RUEIL MALMAISON;92063;48302;17158;31144;693;30451;BAYROU FRANCOIS;M;BAYROU;FRANCOIS;;3128
Présidentielles 2002 - 1er tour;Présidentielles;2002;1;;;63;RUEIL MALMAISON;92063;48302;17158;31144;693;30451;CHIRAC JACQUES;M;CHIRAC;JACQUES;;7555
Présidentielles 2002 - 1er tour;Présidentielles;2002;1;;;64;SAINT CLOUD;92064;17818;6028;11790;141;11649;MAMERE NOEL;M;MAMERE;NOEL;;454
Présidentielles 2002 - 1er tour;Présidentielles;2002;1;;;71;SCEAUX;92071;12917;3930;8987;154;8833;LE PEN JEAN-MARIE;M;LE PEN;JEAN-MARIE;;725
Présidentielles 2002 - 1er tour;Présidentielles;2002;1;;;72;SEVRES;92072;13367;4140;9227;153;9074;CHEVENEMENT JEAN-PIERRE;M;CHEVENEMENT;JEAN-PIERRE;;609
Présidentielles 2002 - 1er tour;Présidentielles;2002;1;;;75;VANVES;92075;15493;4648;10845;221;10624;HUE ROBERT;M;HUE;ROBERT;;252
Présidentielles 2002 - 1er tour;Présidentielles;2002;1;;;77;VILLE D'AVRAY;92077;7251;2486;4765;70;4695;GLUCKSTEIN DANIEL;M;GLUCKSTEIN;DANIEL;;11
Présidentielles 2002 - 1er tour;Présidentielles;2002;1;;;77;VILLE D'AVRAY;92077;7251;2486;4765;70;4695;TAUBIRA CHRISTIANE;F;TAUBIRA;CHRISTIANE;;82
Présidentielles 2007 - 1er tour;Présidentielles;2007;1;;;4;ASNIERES SUR SEINE;92004;43605;5665;37940;436;37504;LE PEN Jean-Marie;M;LE PEN;Jean-Marie;;2258
Présidentielles 2007 - 1er tour;Présidentielles;2007;1;;;7;BAGNEUX;92007;20438;2809;17629;261;17368;BESANCENOT Olivier;M;BESANCENOT;Olivier;;804
Présidentielles 2007 - 1er tour;Présidentielles;2007;1;;;7;BAGNEUX;92007;20438;2809;17629;261;17368;SARKOZY Nicolas;M;SARKOZY;Nicolas;;3873
Présidentielles 2007 - 1er tour;Présidentielles;2007;1;;;19;CHATENAY MALABRY;92019;17598;2318;15280;229;15051;SARKOZY Nicolas;M;SARKOZY;Nicolas;;4768
Présidentielles 2007 - 1er tour;Présidentielles;2007;1;;;20;CHATILLON;92020;20466;2231;18235;177;18058;BAYROU François;M;BAYROU;François;;4044
Présidentielles 2007 - 1er tour;Présidentielles;2007;1;;;22;CHAVILLE;92022;12743;1700;11043;119;10924;SARKOZY Nicolas;M;SARKOZY;Nicolas;;3852
Présidentielles 2007 - 1er tour;Présidentielles;2007;1;;;25;COLOMBES;92025;44025;7536;36489;501;35988;SCHIVARDI Gérard;M;SCHIVARDI;Gérard;;93
Présidentielles 2007 - 1er tour;Présidentielles;2007;1;;;26;COURBEVOIE;92026;48308;7118;41190;456;40734;BUFFET Marie-George;F;BUFFET;Marie-George;;277
Présidentielles 2007 - 1er tour;Présidentielles;2007;1;;;26;COURBEVOIE;92026;48308;7118;41190;456;40734;BAYROU François;M;BAYROU;François;;9248
Présidentielles 2007 - 1er tour;Présidentielles;2007;1;;;32;FONTENAY AUX ROSES;92032;15234;2027;13207;123;13084;BESANCENOT Olivier;M;BESANCENOT;Olivier;;437
Présidentielles 2007 - 1er tour;Présidentielles;2007;1;;;35;LA GARENNE COLOMBES;92035;16350;1826;14524;117;14407;VOYNET Dominique;F;VOYNET;Dominique;;254
Présidentielles 2007 - 1er tour;Présidentielles;2007;1;;;35;LA GARENNE COLOMBES;92035;16350;1826;14524;117;14407;de VILLIERS Philippe;M;de VILLIERS;Philippe;;202
Présidentielles 2007 - 1er tour;Présidentielles;2007;1;;;35;LA GARENNE COLOMBES;92035;16350;1826;14524;117;14407;NIHOUS Frédéric;M;NIHOUS;Frédéric;;33
Présidentielles 2007 - 1er tour;Présidentielles;2007;1;;;35;LA GARENNE COLOMBES;92035;16350;1826;14524;117;14407;SARKOZY Nicolas;M;SARKOZY;Nicolas;;6173
Présidentielles 2007 - 1er tour;Présidentielles;2007;1;;;46;MALAKOFF;92046;18259;2640;15619;178;15441;VOYNET Dominique;F;VOYNET;Dominique;;261
Présidentielles 2007 - 1er tour;Présidentielles;2007;1;;;47;MARNES LA COQUETTE;92047;1054;91;963;9;954;VOYNET Dominique;F;VOYNET;Dominique;;13
Présidentielles 2007 - 1er tour;Présidentielles;2007;1;;;48;MEUDON;92048;29936;4129;25807;223;25584;VOYNET Dominique;F;VOYNET;Dominique;;377
Présidentielles 2007 - 1er tour;Présidentielles;2007;1;;;48;MEUDON;92048;29936;4129;25807;223;25584;SARKOZY Nicolas;M;SARKOZY;Nicolas;;9324
Présidentielles 2007 - 1er tour;Présidentielles;2007;1;;;60;LE PLESSIS ROBINSON;92060;16571;1989;14582;159;14423;VOYNET Dominique;F;VOYNET;Dominique;;233
Présidentielles 2007 - 1er tour;Présidentielles;2007;1;;;60;LE PLESSIS ROBINSON;92060;16571;1989;14582;159;14423;LE PEN Jean-Marie;M;LE PEN;Jean-Marie;;921
Présidentielles 2007 - 1er tour;Présidentielles;2007;1;;;63;RUEIL MALMAISON;92063;50540;5920;44620;393;44227;LAGUILLER Arlette;F;LAGUILLER;Arlette;;309
Présidentielles 2007 - 1er tour;Présidentielles;2007;1;;;64;SAINT CLOUD;92064;18455;1926;16529;91;16438;LAGUILLER Arlette;F;LAGUILLER;Arlette;;57
Présidentielles 2007 - 1er tour;Présidentielles;2007;1;;;71;SCEAUX;92071;13824;1539;12285;86;12199;BOVÉ José;M;BOVÉ;José;;84
Présidentielles 2007 - 1er tour;Présidentielles;2007;1;;;72;SEVRES;92072;14178;1738;12440;129;12311;BESANCENOT Olivier;M;BESANCENOT;Olivier;;232
Présidentielles 2007 - 1er tour;Présidentielles;2007;1;;;75;VANVES;92075;17139;2129;15010;126;14884;SCHIVARDI Gérard;M;SCHIVARDI;Gérard;;32
Présidentielles 2007 - 1er tour;Présidentielles;2007;1;;;75;VANVES;92075;17139;2129;15010;126;14884;LAGUILLER Arlette;F;LAGUILLER;Arlette;;111
Présidentielles 2007 - 1er tour;Présidentielles;2007;1;;;78;VILLENEUVE LA GARENNE;92078;12897;2898;9999;145;9854;VOYNET Dominique;F;VOYNET;Dominique;;92
Présidentielles 2012 - 1er tour;Présidentielles;2012;1;;;2;ANTONY;92002;40169;7755;32414;674;31740;SARKOZY Nicolas;M;SARKOZY;Nicolas;;9985
Présidentielles 2012 - 1er tour;Présidentielles;2012;1;;;9;BOIS COLOMBES;92009;16746;3612;13134;231;12903;DUPONT-AIGNAN Nicolas;M;DUPONT-AIGNAN;Nicolas;;160
Présidentielles 2012 - 1er tour;Présidentielles;2012;1;;;20;CHATILLON;92020;21656;4298;17358;265;17093;LE PEN Marine;F;LE PEN;Marine;;1562
Présidentielles 2012 - 1er tour;Présidentielles;2012;1;;;20;CHATILLON;92020;21656;4298;17358;265;17093;MÉLENCHON Jean-Luc;M;MÉLENCHON;Jean-Luc;;1890
Présidentielles 2012 - 1er tour;Présidentielles;2012;1;;;24;CLICHY;92024;29226;6786;22440;374;22066;ARTHAUD Nathalie;F;ARTHAUD;Nathalie;;108
Présidentielles 2012 - 1er tour;Présidentielles;2012;1;;;26;COURBEVOIE;92026;50576;11277;39299;681;38618;POUTOU Philippe;M;POUTOU;Philippe;;194
Présidentielles 2012 - 1er tour;Présidentielles;2012;1;;;33;GARCHES;92033;12388;2501;9887;167;9720;CHEMINADE Jacques;M;CHEMINADE;Jacques;;37
Présidentielles 2012 - 1er tour;Présidentielles;2012;1;;;35;LA GARENNE COLOMBES;92035;17300;3509;13791;212;13579;DUPONT-AIGNAN Nicolas;M;DUPONT-AIGNAN;Nicolas;;192
Présidentielles 2012 - 1er tour;Présidentielles;2012;1;;;36;GENNEVILLIERS;92036;20990;5264;15726;342;15384;LE PEN Marine;F;LE PEN;Marine;;1647
Présidentielles 2012 - 1er tour;Présidentielles;2012;1;;;36;GENNEVILLIERS;92036;20990;5264;15726;342;15384;MÉLENCHON Jean-Luc;M;MÉLENCHON;Jean-Luc;;4314
Présidentielles 2012 - 1er tour;Présidentielles;2012;1;;;36;GENNEVILLIERS;92036;20990;5264;15726;342;15384;ARTHAUD Nathalie;F;ARTHAUD;Nathalie;;95
Présidentielles 2012 - 1er tour;Présidentielles;2012;1;;;46;MALAKOFF;92046;18852;4162;14690;207;14483;POUTOU Philippe;M;POUTOU;Philippe;;158
Présidentielles 2012 - 1er tour;Présidentielles;2012;1;;;47;MARNES LA COQUETTE;92047;1082;163;919;8;911;SARKOZY Nicolas;M;SARKOZY;Nicolas;;566
Présidentielles 2012 - 1er tour;Présidentielles;2012;1;;;47;MARNES LA COQUETTE;92047;1082;163;919;8;911;DUPONT-AIGNAN Nicolas;M;DUPONT-AIGNAN;Nicolas;;8
Présidentielles 2012 - 1er tour;Présidentielles;2012;1;;;49;MONTROUGE;92049;27851;5527;22324;289;22035;LE PEN Marine;F;LE PEN;Marine;;1763
Présidentielles 2012 - 1er tour;Présidentielles;2012;1;;;60;LE PLESSIS ROBINSON;92060;18767;3621;15146;260;14886;POUTOU Philippe;M;POUTOU;Philippe;;124
Présidentielles 2012 - 1er tour;Présidentielles;2012;1;;;62;PUTEAUX;92062;28189;5597;22592;470;22122;SARKOZY Nicolas;M;SARKOZY;Nicolas;;7869
Présidentielles 2012 - 1er tour;Présidentielles;2012;1;;;64;SAINT CLOUD;92064;18973;3529;15444;153;15291;JOLY Eva;F;JOLY;Eva;;381
Présidentielles 2012 - 1er tour;Présidentielles;2012;1;;;64;SAINT CLOUD;92064;18973;3529;15444;153;15291;MÉLENCHON Jean-Luc;M;MÉLENCHON;Jean-Luc;;667
Présidentielles 2012 - 1er tour;Présidentielles;2012;1;;;73;SURESNES;92073;26458;5110;21348;425;20923;ARTHAUD Nathalie;F;ARTHAUD;Nathalie;;59
Présidentielles 2012 - 1er tour;Présidentielles;2012;1;;;76;VAUCRESSON;92076;6089;1241;4848;74;4774;DUPONT-AIGNAN Nicolas;M;DUPONT-AIGNAN;Nicolas;;39
Présidentielles 1995 - 1er tour;Présidentielles;1995;1;;;20;CHATILLON;92020;16579;4065;12514;245;12269;VILLIERS DE PHILIPPE;M;VILLIERS DE;PHILIPPE;;387
Présidentielles 1995 - 1er tour;Présidentielles;1995;1;;;22;CHAVILLE;92022;12177;2870;9307;170;9137;LE PEN J.MARIE;M;LE PEN;J.MARIE;;953
Présidentielles 1995 - 1er tour;Présidentielles;1995;1;;;32;FONTENAY AUX ROSES;92032;14917;3559;11358;196;11162;LAGUILLER ARLETTE;F;LAGUILLER;ARLETTE;;615
Présidentielles 1995 - 1er tour;Présidentielles;1995;1;;;35;LA GARENNE COLOMBES;92035;14104;3637;10467;225;10242;BALLADUR EDOUARD;M;BALLADUR;EDOUARD;;1995
Présidentielles 1995 - 1er tour;Présidentielles;1995;1;;;35;LA GARENNE COLOMBES;92035;14104;3637;10467;225;10242;HUE ROBERT;M;HUE;ROBERT;;563
Présidentielles 1995 - 1er tour;Présidentielles;1995;1;;;46;MALAKOFF;92046;19489;5677;13812;258;13554;LAGUILLER ARLETTE;F;LAGUILLER;ARLETTE;;641
Présidentielles 1995 - 1er tour;Présidentielles;1995;1;;;46;MALAKOFF;92046;19489;5677;13812;258;13554;VOYNET DOMINIQUE;F;VOYNET;DOMINIQUE;;508
Présidentielles 1995 - 1er tour;Présidentielles;1995;1;;;46;MALAKOFF;92046;19489;5677;13812;258;13554;CHIRAC JACQUES;M;CHIRAC;JACQUES;;2394
Présidentielles 1995 - 1er tour;Présidentielles;1995;1;;;12;BOULOGNE BILLANCOURT;92012;58255;14334;43921;656;43265;LE PEN J.MARIE;M;LE PEN;J.MARIE;;4103
Présidentielles 1995 - 1er tour;Présidentielles;1995;1;;;2;ANTONY;92002;37894;9274;28620;590;28030;JOSPIN LIONEL;M;JOSPIN;LIONEL;;7312
Présidentielles 1995 - 1er tour;Présidentielles;1995;1;;;73;SURESNES;92073;21968;5851;16117;341;15776;LAGUILLER ARLETTE;F;LAGUILLER;ARLETTE;;759
Présidentielles 1995 - 1er tour;Présidentielles;1995;1;;;64;SAINT CLOUD;92064;18989;5119;13870;179;13691;CHIRAC JACQUES;M;CHIRAC;JACQUES;;4837
Présidentielles 2012 - 2ème tour;Présidentielles;2012;2;;;33;GARCHES;92033;12388;1986;10402;405;9997;SARKOZY Nicolas;M;SARKOZY;Nicolas;;6574
Présidentielles 2012 - 2ème tour;Présidentielles;2012;2;;;76;VAUCRESSON;92076;6099;962;5137;161;4976;SARKOZY Nicolas;M;SARKOZY;Nicolas;;3663
Présidentielles 2007 - 2ème tour;Présidentielles;2007;2;;;23;CLAMART;92023;32581;4261;28320;1121;27199;ROYAL Ségolène;F;ROYAL;Ségolène;;12873
Présidentielles 2007 - 2ème tour;Présidentielles;2007;2;;;25;COLOMBES;92025;44039;7231;36808;1348;35460;SARKOZY Nicolas;M;SARKOZY;Nicolas;;16321
Présidentielles 2007 - 2ème tour;Présidentielles;2007;2;;;50;NANTERRE;92050;42094;6719;35375;1289;34086;SARKOZY Nicolas;M;SARKOZY;Nicolas;;12959
Présidentielles 2007 - 2ème tour;Présidentielles;2007;2;;;71;SCEAUX;92071;13826;1729;12097;468;11629;ROYAL Ségolène;F;ROYAL;Ségolène;;4858
Présidentielles 1995 - 2ème tour;Présidentielles;1995;2;;;2;ANTONY;92002;37894;7164;30730;1437;29293;JOSPIN LIONEL;M;JOSPIN;LIONEL;;13079
Présidentielles 1995 - 2ème tour;Présidentielles;1995;2;;;22;CHAVILLE;92022;12177;2343;9834;459;9375;CHIRAC JACQUES;M;CHIRAC;JACQUES;;5445
Présidentielles 1995 - 2ème tour;Présidentielles;1995;2;;;26;COURBEVOIE;92026;35809;6813;28996;1171;27825;JOSPIN LIONEL;M;JOSPIN;LIONEL;;9727
Législatives 2012 - 1er tour;Législatives;2012;1;5;5ème circonscription;24;CLICHY;92024;29276;13521;15755;274;15481;GITTON Mireille;F;GITTON;Mireille;RDG;873
Législatives 2012 - 1er tour;Législatives;2012;1;1;1ère circonscription;25;COLOMBES;92025;26337;13144;13193;209;12984;MUZEAU Roland;M;MUZEAU;Roland;FG;2275
Législatives 2012 - 1er tour;Législatives;2012;1;3;3ème circonscription;26;COURBEVOIE;92026;42456;16939;25517;317;25200;LASSERRE Jean-André;M;LASSERRE;Jean-André;SOC;8238
Législatives 2012 - 1er tour;Législatives;2012;1;12;12ème circonscription;32;FONTENAY AUX ROSES;92032;15230;5971;9259;85;9174;LE METAYER Jocelyne;F;LE METAYER;Jocelyne;FG;653
Législatives 2012 - 1er tour;Législatives;2012;1;5;5ème circonscription;44;LEVALLOIS PERRET;92044;39546;14667;24879;238;24641;BALKANY Patrick;M;BALKANY;Patrick;UMP;11881
Législatives 2012 - 1er tour;Législatives;2012;1;11;11ème circonscription;46;MALAKOFF;92046;18858;7608;11250;119;11131;SOMMARUGA Julie;F;SOMMARUGA;Julie;SOC;3036
Législatives 2012 - 1er tour;Législatives;2012;1;8;8ème circonscription;48;MEUDON;92048;25002;9709;15293;150;15143;TARDIEU Nicolas;M;TARDIEU;Nicolas;ECO;43
Législatives 2012 - 1er tour;Législatives;2012;1;8;8ème circonscription;48;MEUDON;92048;25002;9709;15293;150;15143;CASTERA Stéphane;M;CASTERA;Stéphane;AUT;96
Législatives 2012 - 1er tour;Législatives;2012;1;10;10ème circonscription;48;MEUDON;92048;5576;2083;3493;26;3467;BERGER Véronique;F;BERGER;Véronique;DVD;52
Législatives 2012 - 1er tour;Législatives;2012;1;11;11ème circonscription;49;MONTROUGE;92049;27889;10680;17209;123;17086;BENHABRI Mehdi;M;BENHABRI;Mehdi;CEN;274
Législatives 2012 - 1er tour;Législatives;2012;1;6;6ème circonscription;51;NEUILLY SUR SEINE;92051;37031;14672;22359;177;22182;BRANNENS Marie;F;BRANNENS;Marie;SOC;2036
Législatives 2012 - 1er tour;Législatives;2012;1;6;6ème circonscription;51;NEUILLY SUR SEINE;92051;37031;14672;22359;177;22182;THEVENET Audric;M;THEVENET;Audric;ECO;59
Législatives 2012 - 1er tour;Législatives;2012;1;6;6ème circonscription;51;NEUILLY SUR SEINE;92051;37031;14672;22359;177;22182;CABRERA Julien;M;CABRERA;Julien;DVD;141
Législatives 2012 - 1er tour;Législatives;2012;1;6;6ème circonscription;62;PUTEAUX;92062;28253;11141;17112;441;16671;LEPIDI Bernard;M;LEPIDI;Bernard;DVD;4143
Législatives 2012 - 1er tour;Législatives;2012;1;4;4ème circonscription;73;SURESNES;92073;26492;10723;15769;302;15467;VINAYAGAMOORTHY Meenuka;F;VINAYAGAMOORTHY;Meenuka;RDG;44
Législatives 2012 - 1er tour;Législatives;2012;1;4;4ème circonscription;73;SURESNES;92073;26492;10723;15769;302;15467;STEBE Yves;M;STEBE;Yves;DVD;131
Législatives 2012 - 1er tour;Législatives;2012;1;10;10ème circonscription;75;VANVES;92075;17559;6347;11212;104;11108;BERGER Véronique;F;BERGER;Véronique;DVD;84
Législatives 2012 - 1er tour;Législatives;2012;1;8;8ème circonscription;77;VILLE D'AVRAY;92077;7169;2468;4701;48;4653;SEGUI Miguel;M;SEGUI;Miguel;EXG;8
Législatives 2012 - 1er tour;Législatives;2012;1;1;1ère circonscription;78;VILLENEUVE LA GARENNE;92078;12349;6903;5446;131;5315;LE GAL Anna;F;LE GAL;Anna;ECO;54
Législatives 2012 - 2ème tour;Législatives;2012;2;13;13ème circonscription;2;ANTONY;92002;40941;14882;26059;771;25288;DEVEDJIAN Patrick;M;DEVEDJIAN;Patrick;UMP;12958
Législatives 2012 - 2ème tour;Législatives;2012;2;11;11ème circonscription;7;BAGNEUX;92007;20609;10213;10396;467;9929;SOMMARUGA Julie;F;SOMMARUGA;Julie;SOC;7176
Législatives 2012 - 2ème tour;Législatives;2012;2;6;6ème circonscription;26;COURBEVOIE;92026;8123;3901;4222;154;4068;FROMANTIN Jean-Christophe;M;FROMANTIN;Jean-Christophe;DVD;1294
Législatives 2012 - 2ème tour;Législatives;2012;2;6;6ème circonscription;51;NEUILLY SUR SEINE;92051;37031;16138;20893;237;20656;FROMANTIN Jean-Christophe;M;FROMANTIN;Jean-Christophe;DVD;14359
Législatives 2012 - 2ème tour;Législatives;2012;2;12;12ème circonscription;60;LE PLESSIS ROBINSON;92060;18785;6011;12774;174;12600;PEMEZEC Philippe;M;PEMEZEC;Philippe;UMP;7722
Législatives 2012 - 2ème tour;Législatives;2012;2;8;8ème circonscription;77;VILLE D'AVRAY;92077;7169;2709;4460;129;4331;LIME-BIFFE Catherine;F;LIME-BIFFE;Catherine;SOC;1563
Législatives 2012 - 1er tour;Législatives;2012;1;13;13ème circonscription;2;ANTONY;92002;40941;15088;25853;361;25492;DE LAMBILLY Gaëtan;M;DE LAMBILLY;Gaëtan;DVD;182
Législatives 2012 - 1er tour;Législatives;2012;1;10;10ème circonscription;12;BOULOGNE BILLANCOURT;92012;6600;2912;3688;126;3562;BUNOT Sandrine;F;BUNOT;Sandrine;FN;271
Législatives 1993 - 1er tour;Législatives;1993;1;10;10ème circonscription;40;ISSY LES MOULINEAUX;92040;29377;9425;19952;648;19304;RIEUPET ANNIE;F;RIEUPET;ANNIE;EXG;270
Législatives 1993 - 1er tour;Législatives;1993;1;1;1ère circonscription;36;GENNEVILLIERS;92036;19185;6818;12367;395;11972;LEOPOLD CHANTAL;F;LEOPOLD;CHANTAL;SOC;859
Législatives 1993 - 1er tour;Législatives;1993;1;10;10ème circonscription;48;MEUDON;92048;4225;1396;2829;92;2737;LARDOUX BRUNO;M;LARDOUX;BRUNO;EXG;20
Législatives 1993 - 1er tour;Législatives;1993;1;8;8ème circonscription;72;SEVRES;92072;13536;3690;9846;336;9510;GODICHEAU PIERRE;M;GODICHEAU;PIERRE;DVD;62
Législatives 1993 - 1er tour;Législatives;1993;1;8;8ème circonscription;76;VAUCRESSON;92076;5515;1574;3941;93;3848;GREGOIRE MAURICE;M;GREGOIRE;MAURICE;DIV;48
Législatives 2002 - 1er tour;Législatives;2002;1;3;3ème circonscription;9;BOIS COLOMBES;92009;16245;6561;9684;288;9396;DORE Patricia;F;DORE;Patricia;ECO;139
Législatives 2002 - 1er tour;Législatives;2002;1;3;3ème circonscription;9;BOIS COLOMBES;92009;16245;6561;9684;288;9396;RAGOT Jean-Louis;M;RAGOT;Jean-Louis;UDFD;1144
Législatives 2002 - 1er tour;Législatives;2002;1;13;13ème circonscription;14;BOURG LA REINE;92014;13381;4391;8990;78;8912;BENLOLO Martine;F;BENLOLO;Martine;EXG;28
Législatives 2002 - 1er tour;Législatives;2002;1;2;2ème circonscription;25;COLOMBES;92025;18336;7144;11192;207;10985;VALLET Guillaume;M;VALLET;Guillaume;DIV;10
Législatives 2002 - 1er tour;Législatives;2002;1;7;7ème circonscription;33;GARCHES;92033;12286;4601;7685;112;7573;OLLIER Patrick;M;OLLIER;Patrick;UMP;4768
Législatives 2002 - 1er tour;Législatives;2002;1;7;7ème circonscription;33;GARCHES;92033;12286;4601;7685;112;7573;FARCIS Dominique;M;FARCIS;Dominique;DVD;53
Législatives 2002 - 1er tour;Législatives;2002;1;5;5ème circonscription;44;LEVALLOIS PERRET;92044;39466;14724;24742;404;24338;DUTHEIL Daniel;M;DUTHEIL;Daniel;EXG;27
Législatives 2002 - 1er tour;Législatives;2002;1;5;5ème circonscription;44;LEVALLOIS PERRET;92044;39466;14724;24742;404;24338;MUZEAU Rémi;M;MUZEAU;Rémi;DVD;1540
Législatives 2002 - 1er tour;Législatives;2002;1;11;11ème circonscription;46;MALAKOFF;92046;18478;7045;11433;204;11229;DADARE Sébastien;M;DADARE;Sébastien;DIV;102
Législatives 2002 - 1er tour;Législatives;2002;1;8;8ème circonscription;47;MARNES LA COQUETTE;92047;1074;316;758;5;753;SUCHARD Sophie;F;SUCHARD;Sophie;EXG;1
Législatives 2002 - 1er tour;Législatives;2002;1;8;8ème circonscription;47;MARNES LA COQUETTE;92047;1074;316;758;5;753;DEQUEANT Annie;F;DEQUEANT;Annie;FN;20
Législatives 2002 - 1er tour;Législatives;2002;1;8;8ème circonscription;48;MEUDON;92048;25427;9683;15744;202;15542;RUSSO Annick;F;RUSSO;Annick;DIV;1
Législatives 2002 - 1er tour;Législatives;2002;1;10;10ème circonscription;48;MEUDON;92048;5066;1864;3202;29;3173;SANTINI André;M;SANTINI;André;MAJ;1456
Législatives 2002 - 1er tour;Législatives;2002;1;4;4ème circonscription;73;SURESNES;92073;24666;8949;15717;206;15511;GOIN Catherine;F;GOIN;Catherine;EXG;34
Législatives 2002 - 1er tour;Législatives;2002;1;10;10ème circonscription;75;VANVES;92075;17351;5929;11422;137;11285;GINISTY Christophe;M;GINISTY;Christophe;UDFD;1402
Législatives 2002 - 1er tour;Législatives;2002;1;10;10ème circonscription;75;VANVES;92075;17351;5929;11422;137;11285;DROUET Valérie;F;DROUET;Valérie;EXD;46
Législatives 2002 - 1er tour;Législatives;2002;1;8;8ème circonscription;76;VAUCRESSON;92076;6076;2206;3870;46;3824;BLANCHARD Luc;M;BLANCHARD;Luc;VEC;98
Législatives 2002 - 1er tour;Législatives;2002;1;8;8ème circonscription;76;VAUCRESSON;92076;6076;2206;3870;46;3824;DEQUEANT Annie;F;DEQUEANT;Annie;FN;111
Législatives 2002 - 1er tour;Législatives;2002;1;8;8ème circonscription;77;VILLE D'AVRAY;92077;7475;2429;5046;60;4986;LEGRAND Pauline;F;LEGRAND;Pauline;EXD;28
Législatives 2002 - 2ème tour;Législatives;2002;2;11;11ème circonscription;46;MALAKOFF;92046;17391;6936;10455;265;10190;JAMBU JANINE;F;JAMBU;JANINE;COM;6738
Législatives 2002 - 2ème tour;Législatives;2002;2;8;8ème circonscription;47;MARNES LA COQUETTE;92047;1000;305;695;30;665;LEVAIN JEAN - MARIE;M;LEVAIN;JEAN - MARIE;PRG;123
Législatives 2002 - 2ème tour;Législatives;2002;2;10;10ème circonscription;48;MEUDON;92048;4041;1628;2413;55;2358;SCHMID LUCILE;F;SCHMID;LUCILE;SOC;976
Législatives 2002 - 2ème tour;Législatives;2002;2;11;11ème circonscription;49;MONTROUGE;92049;23590;9229;14361;389;13972;JAMBU JANINE;F;JAMBU;JANINE;COM;6194
Législatives 2002 - 2ème tour;Législatives;2002;2;8;8ème circonscription;76;VAUCRESSON;92076;5983;2400;3583;112;3471;LEVAIN JEAN - MARIE;M;LEVAIN;JEAN - MARIE;PRG;800
Législatives 1997 - 2ème tour;Législatives;1997;2;13;13ème circonscription;14;BOURG LA REINE;92014;12587;4019;8568;399;8169;DEVEDJIAN PATRICK;M;DEVEDJIAN;PATRICK;RPR;4924
Législatives 1997 - 2ème tour;Législatives;1997;2;1;1ère circonscription;25;COLOMBES;92025;26234;9506;16728;1637;15091;BRUNHES JACQUES;M;BRUNHES;JACQUES;COM;9965
Législatives 1993 - 2ème tour;Législatives;1993;2;3;3ème circonscription;9;BOIS COLOMBES;92009;14392;4776;9616;707;8909;ROUSSEL PIERRE;M;ROUSSEL;PIERRE;SOC;3159
Législatives 1997 - 1er tour;Législatives;1997;1;13;13ème circonscription;2;ANTONY;92002;37772;12082;25690;861;24829;GESLAIN A.MARIE;F;GESLAIN;A.MARIE;COM;1935
Législatives 1997 - 1er tour;Législatives;1997;1;7;7ème circonscription;63;RUEIL MALMAISON;92063;44715;14813;29902;1094;28808;DRIOUT PIERRE;M;DRIOUT;PIERRE;EXD;107
Législatives 1997 - 1er tour;Législatives;1997;1;7;7ème circonscription;64;SAINT CLOUD;92064;18908;7095;11813;417;11396;CAGNIER MAURICE;M;CAGNIER;MAURICE;ECO;179
Législatives 1997 - 1er tour;Législatives;1997;1;13;13ème circonscription;71;SCEAUX;92071;13168;3887;9281;266;9015;SCHNEITER LEONORE;F;SCHNEITER;LEONORE;ECO;151
Législatives 1997 - 1er tour;Législatives;1997;1;4;4ème circonscription;73;SURESNES;92073;20985;7217;13768;441;13327;GARDENT OLIVIER;M;GARDENT;OLIVIER;EXG;51
Législatives 1997 - 1er tour;Législatives;1997;1;4;4ème circonscription;73;SURESNES;92073;20985;7217;13768;441;13327;MEYER M.LAURE;F;MEYER;M.LAURE;SOC;2662
Législatives 1993 - 1er tour;Législatives;1993;1;9;9ème circonscription;12;BOULOGNE BILLANCOURT;92012;53509;17387;36122;1224;34898;POYET FRANCOIS;M;POYET;FRANCOIS;DVD;227
Législatives 1993 - 1er tour;Législatives;1993;1;9;9ème circonscription;12;BOULOGNE BILLANCOURT;92012;53509;17387;36122;1224;34898;CREANGE ROBERT;M;CREANGE;ROBERT;COM;1630
Législatives 1993 - 1er tour;Législatives;1993;1;2;2ème circonscription;4;ASNIERES SUR SEINE;92004;37314;11544;25770;852;24918;LANERET MICHEL;M;LANERET;MICHEL;SOC;3253
Législatives 1993 - 1er tour;Législatives;1993;1;13;13ème circonscription;2;ANTONY;92002;36749;10226;26523;1007;25516;LEFRERE CHRISTIANE;F;LEFRERE;CHRISTIANE;DIV;655
Législatives 1993 - 1er tour;Législatives;1993;1;11;11ème circonscription;7;BAGNEUX;92007;21150;7754;13396;474;12922;BERTINELLI M.JOSE;F;BERTINELLI;M.JOSE;DIV;118
Législatives 1997 - 1er tour;Législatives;1997;1;8;8ème circonscription;22;CHAVILLE;92022;12268;3930;8338;262;8076;JOURNE SILIAN;M;JOURNE;SILIAN;DVD;245
Législatives 1997 - 1er tour;Législatives;1997;1;1;1ère circonscription;25;COLOMBES;92025;26238;10153;16085;513;15572;MUSSAT PHILIPPE;M;MUSSAT;PHILIPPE;EXG;123
Législatives 1997 - 1er tour;Législatives;1997;1;5;5ème circonscription;44;LEVALLOIS PERRET;92044;28281;9315;18966;650;18316;PERCEVAULT RICHARD;M;PERCEVAULT;RICHARD;EXG;311
Législatives 1997 - 1er tour;Législatives;1997;1;11;11ème circonscription;46;MALAKOFF;92046;19124;7233;11891;338;11553;JAMBU JANINE;F;JAMBU;JANINE;COM;4933
Législatives 1997 - 1er tour;Législatives;1997;1;4;4ème circonscription;50;NANTERRE;92050;38533;13799;24734;766;23968;DUPUY CHRISTIAN;M;DUPUY;CHRISTIAN;RPR;5490
Législatives 1997 - 1er tour;Législatives;1997;1;4;4ème circonscription;50;NANTERRE;92050;38533;13799;24734;766;23968;TREPPOZ ROMAIN;M;TREPPOZ;ROMAIN;EXG;122
Législatives 1997 - 1er tour;Législatives;1997;1;3;3ème circonscription;26;COURBEVOIE;92026;35738;12354;23384;653;22731;RONDEPIERRE GILDAS;M;RONDEPIERRE;GILDAS;DVD;28
Législatives 1997 - 1er tour;Législatives;1997;1;1;1ère circonscription;36;GENNEVILLIERS;92036;19277;7226;12051;295;11756;BRETON MICHEL;M;BRETON;MICHEL;EXG;292
Législatives 1997 - 1er tour;Législatives;1997;1;2;2ème circonscription;25;COLOMBES;92025;17603;6110;11493;415;11078;FRAGER DOMINIQUE;M;FRAGER;DOMINIQUE;ECO;2558
Législatives 1997 - 1er tour;Législatives;1997;1;10;10ème circonscription;12;BOULOGNE BILLANCOURT;92012;4529;1717;2812;99;2713;DAUJON XAVIER;M;DAUJON;XAVIER;DVD;70
Législatives 1997 - 1er tour;Législatives;1997;1;2;2ème circonscription;4;ASNIERES SUR SEINE;92004;37154;13729;23425;737;22688;DECHENOIX CYRILLE;M;DECHENOIX;CYRILLE;DVD;525
Législatives 1997 - 1er tour;Législatives;1997;1;13;13ème circonscription;2;ANTONY;92002;37772;12082;25690;861;24829;PEURIERE GERARD;M;PEURIERE;GERARD;ECO;1125
Législatives 1997 - 1er tour;Législatives;1997;1;6;6ème circonscription;62;PUTEAUX;92062;24329;8862;15467;635;14832;ROCHAS SOPHIE;F;ROCHAS;SOPHIE;DVD;164
Législatives 2017 - 1er tour;Législatives;2017;1;1;1ère circonscription;25;COLOMBES;92025;27867;16420;11447;405;11042;BONNEFOND Olivier;M;BONNEFOND;Olivier;DVD;101
Législatives 2017 - 1er tour;Législatives;2017;1;11;11ème circonscription;49;MONTROUGE;92049;28914;12071;16843;175;16668;LEMÉTAIS François;M;LEMÉTAIS;François;DIV;139
Législatives 2017 - 1er tour;Législatives;2017;1;11;11ème circonscription;49;MONTROUGE;92049;28914;12071;16843;175;16668;CUDENNEC Lionel;M;CUDENNEC;Lionel;DIV;78
Législatives 2017 - 1er tour;Législatives;2017;1;11;11ème circonscription;49;MONTROUGE;92049;28914;12071;16843;175;16668;OUJIBOU Saïd;M;OUJIBOU;Saïd;DVD;119
Législatives 2017 - 1er tour;Législatives;2017;1;12;12ème circonscription;20;CHATILLON;92020;22311;9527;12784;186;12598;BUCHOT Clarisse;F;BUCHOT;Clarisse;DIV;26
Législatives 2017 - 1er tour;Législatives;2017;1;12;12ème circonscription;23;CLAMART;92023;35342;15954;19388;238;19150;SÉJOURNÉ Emmanuelle;F;SÉJOURNÉ;Emmanuelle;DLF;240
Législatives 2017 - 1er tour;Législatives;2017;1;12;12ème circonscription;60;LE PLESSIS ROBINSON;92060;19154;7496;11658;130;11528;YVENAT Damien;M;YVENAT;Damien;FN;461
Législatives 2017 - 1er tour;Législatives;2017;1;13;13ème circonscription;19;CHATENAY MALABRY;92019;18752;8166;10586;245;10341;FARCY-BRIANT Laurent;M;FARCY-BRIANT;Laurent;DIV;28
Législatives 2017 - 1er tour;Législatives;2017;1;5;5ème circonscription;24;CLICHY;92024;28620;14628;13992;265;13727;LOEMBA Déborah;F;LOEMBA;Déborah;DIV;21
Législatives 2017 - 1er tour;Législatives;2017;1;11;11ème circonscription;7;BAGNEUX;92007;21911;12424;9487;167;9320;ROSSI Laurianne;F;ROSSI;Laurianne;REM;3048
Législatives 2017 - 1er tour;Législatives;2017;1;9;9ème circonscription;12;BOULOGNE BILLANCOURT;92012;64984;30321;34663;987;33676;GODIN Marie-Laure;F;GODIN;Marie-Laure;DVD;10568
Législatives 2017 - 1er tour;Législatives;2017;1;8;8ème circonscription;76;VAUCRESSON;92076;6187;2474;3713;42;3671;DE SAINT ALBIN Stéphane;M;DE SAINT ALBIN;Stéphane;DVD;44
Législatives 2017 - 1er tour;Législatives;2017;1;8;8ème circonscription;77;VILLE D'AVRAY;92077;7440;2857;4583;44;4539;MAIRE Jacques;M;MAIRE;Jacques;REM;2383
Législatives 2017 - 1er tour;Législatives;2017;1;8;8ème circonscription;76;VAUCRESSON;92076;6187;2474;3713;42;3671;MAIRE Jacques;M;MAIRE;Jacques;REM;1788
Législatives 2017 - 1er tour;Législatives;2017;1;3;3ème circonscription;9;BOIS COLOMBES;92009;17921;7869;10052;437;9615;BRESSY Christophe;M;BRESSY;Christophe;DIV;58
Législatives 2017 - 1er tour;Législatives;2017;1;3;3ème circonscription;26;COURBEVOIE;92026;44322;19890;24432;415;24017;PARRY Jean-Marie;M;PARRY;Jean-Marie;EXG;74
Législatives 2017 - 1er tour;Législatives;2017;1;4;4ème circonscription;50;NANTERRE;92050;47651;26455;21196;432;20764;GIGOT Magalie;F;GIGOT;Magalie;DIV;190
Législatives 2017 - 1er tour;Législatives;2017;1;8;8ème circonscription;72;SEVRES;92072;15144;6343;8801;149;8652;SCHNEIDER Frédéric;M;SCHNEIDER;Frédéric;DIV;30
Législatives 2017 - 1er tour;Législatives;2017;1;8;8ème circonscription;48;MEUDON;92048;25240;11059;14181;174;14007;PASQUELIN Nelly;F;PASQUELIN;Nelly;FI;1340
Législatives 2017 - 1er tour;Législatives;2017;1;7;7ème circonscription;64;SAINT CLOUD;92064;19410;7490;11920;102;11818;BERTHAULT Grégory;M;BERTHAULT;Grégory;ECO;162
Législatives 2017 - 1er tour;Législatives;2017;1;7;7ème circonscription;63;RUEIL MALMAISON;92063;54498;24335;30163;377;29786;LECART Jérôme;M;LECART;Jérôme;DIV;266
Législatives 2017 - 1er tour;Législatives;2017;1;7;7ème circonscription;64;SAINT CLOUD;92064;19410;7490;11920;102;11818;LECART Jérôme;M;LECART;Jérôme;DIV;69
Législatives 2017 - 1er tour;Législatives;2017;1;8;8ème circonscription;22;CHAVILLE;92022;13523;5385;8138;93;8045;EPPLING Robin;M;EPPLING;Robin;DIV;58
Législatives 2017 - 1er tour;Législatives;2017;1;6;6ème circonscription;51;NEUILLY SUR SEINE;92051;37215;15249;21966;119;21847;LE GRIP Constance;F;LE GRIP;Constance;LR;4957
Législatives 2017 - 1er tour;Législatives;2017;1;6;6ème circonscription;62;PUTEAUX;92062;28983;11794;17189;436;16753;DE CHOISY Hugo;M;DE CHOISY;Hugo;DIV;68
Présidentielles 1995 - 2ème tour;Présidentielles;1995;2;;;20;CHATILLON;92020;16579;3299;13280;631;12649;JOSPIN LIONEL;M;JOSPIN;LIONEL;;5757
Présidentielles 1995 - 2ème tour;Présidentielles;1995;2;;;40;ISSY LES MOULINEAUX;92040;30037;6886;23151;1077;22074;JOSPIN LIONEL;M;JOSPIN;LIONEL;;9592
Présidentielles 1995 - 2ème tour;Présidentielles;1995;2;;;47;MARNES LA COQUETTE;92047;1003;153;850;41;809;JOSPIN LIONEL;M;JOSPIN;LIONEL;;148
Présidentielles 1995 - 2ème tour;Présidentielles;1995;2;;;50;NANTERRE;92050;46920;10896;36024;2205;33819;CHIRAC JACQUES;M;CHIRAC;JACQUES;;15370
Présidentielles 1995 - 2ème tour;Présidentielles;1995;2;;;51;NEUILLY SUR SEINE;92051;35905;5995;29910;639;29271;JOSPIN LIONEL;M;JOSPIN;LIONEL;;4132
Présidentielles 1995 - 2ème tour;Présidentielles;1995;2;;;71;SCEAUX;92071;13361;2314;11047;395;10652;JOSPIN LIONEL;M;JOSPIN;LIONEL;;3882
Présidentielles 1995 - 1er tour;Présidentielles;1995;1;;;35;LA GARENNE COLOMBES;92035;14104;3637;10467;225;10242;LAGUILLER ARLETTE;F;LAGUILLER;ARLETTE;;547
Présidentielles 1995 - 1er tour;Présidentielles;1995;1;;;23;CLAMART;92023;31229;8419;22810;457;22353;VILLIERS DE PHILIPPE;M;VILLIERS DE;PHILIPPE;;806
Présidentielles 1995 - 1er tour;Présidentielles;1995;1;;;51;NEUILLY SUR SEINE;92051;35904;7798;28106;261;27845;LAGUILLER ARLETTE;F;LAGUILLER;ARLETTE;;433
Présidentielles 1995 - 1er tour;Présidentielles;1995;1;;;60;LE PLESSIS ROBINSON;92060;13056;3285;9771;199;9572;VOYNET DOMINIQUE;F;VOYNET;DOMINIQUE;;305
Présidentielles 1995 - 1er tour;Présidentielles;1995;1;;;4;ASNIERES SUR SEINE;92004;39050;10288;28762;594;28168;CHEMINADE JACQUES;M;CHEMINADE;JACQUES;;61
Présidentielles 1995 - 1er tour;Présidentielles;1995;1;;;12;BOULOGNE BILLANCOURT;92012;58255;14334;43921;656;43265;JOSPIN LIONEL;M;JOSPIN;LIONEL;;8695
Présidentielles 1995 - 1er tour;Présidentielles;1995;1;;;7;BAGNEUX;92007;20166;5090;15076;308;14768;VILLIERS DE PHILIPPE;M;VILLIERS DE;PHILIPPE;;348
Présidentielles 1995 - 1er tour;Présidentielles;1995;1;;;14;BOURG LA REINE;92014;12770;3430;9340;135;9205;LE PEN J.MARIE;M;LE PEN;J.MARIE;;807
Présidentielles 1995 - 1er tour;Présidentielles;1995;1;;;76;VAUCRESSON;92076;5529;1334;4195;65;4130;VILLIERS DE PHILIPPE;M;VILLIERS DE;PHILIPPE;;186
Présidentielles 1995 - 1er tour;Présidentielles;1995;1;;;72;SEVRES;92072;13745;2869;10876;183;10693;CHEMINADE JACQUES;M;CHEMINADE;JACQUES;;24
Présidentielles 2007 - 1er tour;Présidentielles;2007;1;;;7;BAGNEUX;92007;20438;2809;17629;261;17368;NIHOUS Frédéric;M;NIHOUS;Frédéric;;42
Présidentielles 2007 - 1er tour;Présidentielles;2007;1;;;9;BOIS COLOMBES;92009;16113;2534;13579;152;13427;SARKOZY Nicolas;M;SARKOZY;Nicolas;;5322
Présidentielles 2007 - 1er tour;Présidentielles;2007;1;;;19;CHATENAY MALABRY;92019;17598;2318;15280;229;15051;BOVÉ José;M;BOVÉ;José;;141
Présidentielles 2007 - 1er tour;Présidentielles;2007;1;;;19;CHATENAY MALABRY;92019;17598;2318;15280;229;15051;ROYAL Ségolène;F;ROYAL;Ségolène;;4815
Présidentielles 2007 - 1er tour;Présidentielles;2007;1;;;20;CHATILLON;92020;20466;2231;18235;177;18058;LE PEN Jean-Marie;M;LE PEN;Jean-Marie;;1041
Présidentielles 2007 - 1er tour;Présidentielles;2007;1;;;22;CHAVILLE;92022;12743;1700;11043;119;10924;VOYNET Dominique;F;VOYNET;Dominique;;211
Présidentielles 2007 - 1er tour;Présidentielles;2007;1;;;44;LEVALLOIS PERRET;92044;38708;4734;33974;296;33678;BOVÉ José;M;BOVÉ;José;;177
Présidentielles 2007 - 1er tour;Présidentielles;2007;1;;;46;MALAKOFF;92046;18259;2640;15619;178;15441;SARKOZY Nicolas;M;SARKOZY;Nicolas;;3331
Présidentielles 2007 - 1er tour;Présidentielles;2007;1;;;47;MARNES LA COQUETTE;92047;1054;91;963;9;954;BUFFET Marie-George;F;BUFFET;Marie-George;;2
Présidentielles 2007 - 1er tour;Présidentielles;2007;1;;;62;PUTEAUX;92062;26761;3397;23364;263;23101;BESANCENOT Olivier;M;BESANCENOT;Olivier;;560
Présidentielles 2007 - 1er tour;Présidentielles;2007;1;;;63;RUEIL MALMAISON;92063;50540;5920;44620;393;44227;BESANCENOT Olivier;M;BESANCENOT;Olivier;;958
Présidentielles 2007 - 1er tour;Présidentielles;2007;1;;;71;SCEAUX;92071;13824;1539;12285;86;12199;LE PEN Jean-Marie;M;LE PEN;Jean-Marie;;472
Présidentielles 2007 - 1er tour;Présidentielles;2007;1;;;75;VANVES;92075;17139;2129;15010;126;14884;ROYAL Ségolène;F;ROYAL;Ségolène;;4430
Présidentielles 2007 - 1er tour;Présidentielles;2007;1;;;76;VAUCRESSON;92076;5902;781;5121;42;5079;BOVÉ José;M;BOVÉ;José;;15
Présidentielles 2007 - 1er tour;Présidentielles;2007;1;;;77;VILLE D'AVRAY;92077;7253;672;6581;57;6524;NIHOUS Frédéric;M;NIHOUS;Frédéric;;9
Présidentielles 2007 - 1er tour;Présidentielles;2007;1;;;78;VILLENEUVE LA GARENNE;92078;12897;2898;9999;145;9854;BAYROU François;M;BAYROU;François;;1509
Présidentielles 2007 - 1er tour;Présidentielles;2007;1;;;78;VILLENEUVE LA GARENNE;92078;12897;2898;9999;145;9854;LAGUILLER Arlette;F;LAGUILLER;Arlette;;121
Présidentielles 2017 - 1er tour;Présidentielles;2017;1;;;7;BAGNEUX;92007;21873;5369;16504;428;16076;DUPONT-AIGNAN Nicolas;M;DUPONT-AIGNAN;Nicolas;;474
Présidentielles 2017 - 1er tour;Présidentielles;2017;1;;;7;BAGNEUX;92007;21873;5369;16504;428;16076;POUTOU Philippe;M;POUTOU;Philippe;;211
Présidentielles 2017 - 1er tour;Présidentielles;2017;1;;;19;CHATENAY MALABRY;92019;18708;3336;15372;454;14918;HAMON Benoît;M;HAMON;Benoît;;1168
Présidentielles 2017 - 1er tour;Présidentielles;2017;1;;;20;CHATILLON;92020;22292;3682;18610;351;18259;FILLON François;M;FILLON;François;;4260
Présidentielles 2017 - 1er tour;Présidentielles;2017;1;;;20;CHATILLON;92020;22292;3682;18610;351;18259;LE PEN Marine;F;LE PEN;Marine;;1531
Présidentielles 2017 - 1er tour;Présidentielles;2017;1;;;23;CLAMART;92023;35291;6330;28961;560;28401;HAMON Benoît;M;HAMON;Benoît;;2375
Présidentielles 2017 - 1er tour;Présidentielles;2017;1;;;24;CLICHY;92024;28553;5564;22989;498;22491;MACRON Emmanuel;M;MACRON;Emmanuel;;6939
Présidentielles 2017 - 1er tour;Présidentielles;2017;1;;;24;CLICHY;92024;28553;5564;22989;498;22491;MÉLENCHON Jean-Luc;M;MÉLENCHON;Jean-Luc;;6653
Présidentielles 2017 - 1er tour;Présidentielles;2017;1;;;32;FONTENAY AUX ROSES;92032;16036;3739;12297;218;12078;FILLON François;M;FILLON;François;;2417
Présidentielles 2017 - 1er tour;Présidentielles;2017;1;;;33;GARCHES;92033;12767;1975;10792;194;10598;ASSELINEAU François;M;ASSELINEAU;François;;70
Présidentielles 2017 - 1er tour;Présidentielles;2017;1;;;36;GENNEVILLIERS;92036;22149;5526;16623;490;16133;MACRON Emmanuel;M;MACRON;Emmanuel;;3112
Présidentielles 2017 - 1er tour;Présidentielles;2017;1;;;40;ISSY LES MOULINEAUX;92040;46800;9050;37750;728;37022;ASSELINEAU François;M;ASSELINEAU;François;;357
Présidentielles 2017 - 1er tour;Présidentielles;2017;1;;;40;ISSY LES MOULINEAUX;92040;46800;9050;37750;728;37022;MÉLENCHON Jean-Luc;M;MÉLENCHON;Jean-Luc;;5996
Présidentielles 2017 - 1er tour;Présidentielles;2017;1;;;48;MEUDON;92048;31280;5715;25565;405;25160;ARTHAUD Nathalie;F;ARTHAUD;Nathalie;;97
Présidentielles 2017 - 1er tour;Présidentielles;2017;1;;;49;MONTROUGE;92049;28899;4312;24587;429;24158;POUTOU Philippe;M;POUTOU;Philippe;;177
Présidentielles 2017 - 1er tour;Présidentielles;2017;1;;;51;NEUILLY SUR SEINE;92051;37184;4180;33004;212;32792;ARTHAUD Nathalie;F;ARTHAUD;Nathalie;;30
Présidentielles 2017 - 1er tour;Présidentielles;2017;1;;;60;LE PLESSIS ROBINSON;92060;19141;2947;16194;344;15850;MACRON Emmanuel;M;MACRON;Emmanuel;;4691
Présidentielles 2017 - 1er tour;Présidentielles;2017;1;;;64;SAINT CLOUD;92064;19370;2628;16742;186;16556;HAMON Benoît;M;HAMON;Benoît;;702
Présidentielles 2017 - 1er tour;Présidentielles;2017;1;;;64;SAINT CLOUD;92064;19370;2628;16742;186;16556;LE PEN Marine;F;LE PEN;Marine;;1025
Présidentielles 2017 - 1er tour;Présidentielles;2017;1;;;72;SEVRES;92072;15142;2166;12976;213;12763;HAMON Benoît;M;HAMON;Benoît;;957
Présidentielles 2017 - 1er tour;Présidentielles;2017;1;;;76;VAUCRESSON;92076;6176;835;5341;72;5269;LE PEN Marine;F;LE PEN;Marine;;261
Présidentielles 2012 - 1er tour;Présidentielles;2012;1;;;4;ASNIERES SUR SEINE;92004;45042;9279;35763;516;35247;SARKOZY Nicolas;M;SARKOZY;Nicolas;;11477
Présidentielles 2012 - 1er tour;Présidentielles;2012;1;;;4;ASNIERES SUR SEINE;92004;45042;9279;35763;516;35247;MÉLENCHON Jean-Luc;M;MÉLENCHON;Jean-Luc;;3350
Présidentielles 2012 - 1er tour;Présidentielles;2012;1;;;14;BOURG LA REINE;92014;13300;2381;10919;132;10787;ARTHAUD Nathalie;F;ARTHAUD;Nathalie;;24
Présidentielles 2012 - 1er tour;Présidentielles;2012;1;;;22;CHAVILLE;92022;12768;2527;10241;147;10094;MÉLENCHON Jean-Luc;M;MÉLENCHON;Jean-Luc;;891
Présidentielles 2012 - 1er tour;Présidentielles;2012;1;;;25;COLOMBES;92025;44741;10181;34560;526;34034;MÉLENCHON Jean-Luc;M;MÉLENCHON;Jean-Luc;;4505
Présidentielles 2012 - 1er tour;Présidentielles;2012;1;;;33;GARCHES;92033;12388;2501;9887;167;9720;BAYROU François;M;BAYROU;François;;1111
Présidentielles 2012 - 1er tour;Présidentielles;2012;1;;;35;LA GARENNE COLOMBES;92035;17300;3509;13791;212;13579;JOLY Eva;F;JOLY;Eva;;353
Présidentielles 2012 - 1er tour;Présidentielles;2012;1;;;63;RUEIL MALMAISON;92063;52385;10540;41845;580;41265;LE PEN Marine;F;LE PEN;Marine;;3549
Présidentielles 2012 - 1er tour;Présidentielles;2012;1;;;73;SURESNES;92073;26458;5110;21348;425;20923;DUPONT-AIGNAN Nicolas;M;DUPONT-AIGNAN;Nicolas;;260
Présidentielles 2002 - 1er tour;Présidentielles;2002;1;;;48;MEUDON;92048;28283;9341;18942;321;18621;BESANCENOT OLIVIER;M;BESANCENOT;OLIVIER;;566
Présidentielles 2002 - 1er tour;Présidentielles;2002;1;;;49;MONTROUGE;92049;23382;8142;15240;301;14939;BESANCENOT OLIVIER;M;BESANCENOT;OLIVIER;;563
Présidentielles 2002 - 1er tour;Présidentielles;2002;1;;;50;NANTERRE;92050;37590;13303;24287;669;23618;GLUCKSTEIN DANIEL;M;GLUCKSTEIN;DANIEL;;99
Présidentielles 2002 - 1er tour;Présidentielles;2002;1;;;60;LE PLESSIS ROBINSON;92060;14503;4736;9767;230;9537;CHEVENEMENT JEAN-PIERRE;M;CHEVENEMENT;JEAN-PIERRE;;611
Présidentielles 2002 - 1er tour;Présidentielles;2002;1;;;63;RUEIL MALMAISON;92063;48302;17158;31144;693;30451;MEGRET BRUNO;M;MEGRET;BRUNO;;494
Présidentielles 2002 - 1er tour;Présidentielles;2002;1;;;64;SAINT CLOUD;92064;17818;6028;11790;141;11649;BOUTIN CHRISTINE;F;BOUTIN;CHRISTINE;;333
Présidentielles 2002 - 1er tour;Présidentielles;2002;1;;;71;SCEAUX;92071;12917;3930;8987;154;8833;MEGRET BRUNO;M;MEGRET;BRUNO;;94
Présidentielles 2002 - 1er tour;Présidentielles;2002;1;;;71;SCEAUX;92071;12917;3930;8987;154;8833;TAUBIRA CHRISTIANE;F;TAUBIRA;CHRISTIANE;;201
Présidentielles 2002 - 1er tour;Présidentielles;2002;1;;;75;VANVES;92075;15493;4648;10845;221;10624;GLUCKSTEIN DANIEL;M;GLUCKSTEIN;DANIEL;;37
Présidentielles 2002 - 1er tour;Présidentielles;2002;1;;;75;VANVES;92075;15493;4648;10845;221;10624;LAGUILLER ARLETTE;F;LAGUILLER;ARLETTE;;390
Présidentielles 2002 - 1er tour;Présidentielles;2002;1;;;76;VAUCRESSON;92076;5861;2048;3813;62;3751;TAUBIRA CHRISTIANE;F;TAUBIRA;CHRISTIANE;;63
Présidentielles 2002 - 1er tour;Présidentielles;2002;1;;;77;VILLE D'AVRAY;92077;7251;2486;4765;70;4695;MAMERE NOEL;M;MAMERE;NOEL;;234
Présidentielles 2002 - 1er tour;Présidentielles;2002;1;;;2;ANTONY;92002;36989;11047;25942;517;25425;BAYROU FRANCOIS;M;BAYROU;FRANCOIS;;2300
Présidentielles 2002 - 1er tour;Présidentielles;2002;1;;;7;BAGNEUX;92007;18489;5873;12616;519;12097;TAUBIRA CHRISTIANE;F;TAUBIRA;CHRISTIANE;;843
Présidentielles 2002 - 1er tour;Présidentielles;2002;1;;;9;BOIS COLOMBES;92009;13996;4554;9442;200;9242;MADELIN ALAIN;M;MADELIN;ALAIN;;499
Présidentielles 2002 - 1er tour;Présidentielles;2002;1;;;12;BOULOGNE BILLANCOURT;92012;57382;17570;39812;645;39167;CHIRAC JACQUES;M;CHIRAC;JACQUES;;11468
Présidentielles 2002 - 1er tour;Présidentielles;2002;1;;;14;BOURG LA REINE;92014;12075;3519;8556;149;8407;CHEVENEMENT JEAN-PIERRE;M;CHEVENEMENT;JEAN-PIERRE;;689
Législatives 2017 - 1er tour;Législatives;2017;1;1;1ère circonscription;25;COLOMBES;92025;27867;16420;11447;405;11042;BACHELAY Alexis;M;BACHELAY;Alexis;SOC;1344
Législatives 2017 - 1er tour;Législatives;2017;1;2;2ème circonscription;4;ASNIERES SUR SEINE;92004;48340;22557;25783;414;25369;RUEL-RADIGUE Philippe;M;RUEL-RADIGUE;Philippe;DVG;13
Législatives 2017 - 1er tour;Législatives;2017;1;2;2ème circonscription;4;ASNIERES SUR SEINE;92004;48340;22557;25783;414;25369;GUILLARD Laurent;M;GUILLARD;Laurent;ECO;947
Législatives 2017 - 1er tour;Législatives;2017;1;2;2ème circonscription;4;ASNIERES SUR SEINE;92004;48340;22557;25783;414;25369;RICHARD Julien;M;RICHARD;Julien;ECO;302
Législatives 2017 - 1er tour;Législatives;2017;1;5;5ème circonscription;24;CLICHY;92024;28620;14628;13992;265;13727;MESSATFA Lies;M;MESSATFA;Lies;SOC;1395
Législatives 2017 - 1er tour;Législatives;2017;1;6;6ème circonscription;26;COURBEVOIE;92026;8107;4228;3879;107;3772;DUBAIL Vincent;M;DUBAIL;Vincent;ECO;124
Législatives 2017 - 1er tour;Législatives;2017;1;6;6ème circonscription;51;NEUILLY SUR SEINE;92051;37215;15249;21966;119;21847;FLORIN Samuel;M;FLORIN;Samuel;FI;355
Législatives 2017 - 1er tour;Législatives;2017;1;6;6ème circonscription;51;NEUILLY SUR SEINE;92051;37215;15249;21966;119;21847;LINE Michelle;F;LINE;Michelle;ECO;76
Législatives 2017 - 1er tour;Législatives;2017;1;6;6ème circonscription;62;PUTEAUX;92062;28983;11794;17189;436;16753;BOUGHERARA Zohra;F;BOUGHERARA;Zohra;COM;175
Législatives 2017 - 1er tour;Législatives;2017;1;7;7ème circonscription;63;RUEIL MALMAISON;92063;54498;24335;30163;377;29786;NGUYEN Maryline;F;NGUYEN;Maryline;COM;465
Législatives 2017 - 1er tour;Législatives;2017;1;7;7ème circonscription;63;RUEIL MALMAISON;92063;54498;24335;30163;377;29786;MZOUGHI Olfa;F;MZOUGHI;Olfa;FI;1919
Législatives 2017 - 1er tour;Législatives;2017;1;7;7ème circonscription;63;RUEIL MALMAISON;92063;54498;24335;30163;377;29786;MARILOSSIAN Jacques;M;MARILOSSIAN;Jacques;REM;15065
Législatives 2017 - 1er tour;Législatives;2017;1;8;8ème circonscription;48;MEUDON;92048;25240;11059;14181;174;14007;HÉNIQUE Philippe;M;HÉNIQUE;Philippe;EXG;94
Législatives 2017 - 1er tour;Législatives;2017;1;8;8ème circonscription;77;VILLE D'AVRAY;92077;7440;2857;4583;44;4539;EPPLING Robin;M;EPPLING;Robin;DIV;86
Législatives 2017 - 1er tour;Législatives;2017;1;9;9ème circonscription;12;BOULOGNE BILLANCOURT;92012;64984;30321;34663;987;33676;NIAKATE Aminata;F;NIAKATE;Aminata;ECO;1687
Législatives 2017 - 1er tour;Législatives;2017;1;10;10ème circonscription;40;ISSY LES MOULINEAUX;92040;45375;19009;26366;517;25849;ZAZOUN Messaoud;M;ZAZOUN;Messaoud;DIV;58
Législatives 2017 - 1er tour;Législatives;2017;1;10;10ème circonscription;48;MEUDON;92048;6009;2545;3464;38;3426;COUR Philippine;F;COUR;Philippine;DLF;38
Législatives 2017 - 1er tour;Législatives;2017;1;11;11ème circonscription;7;BAGNEUX;92007;21911;12424;9487;167;9320;DE PABLO Carmelina;F;DE PABLO;Carmelina;ECO;284
Législatives 2017 - 1er tour;Législatives;2017;1;11;11ème circonscription;7;BAGNEUX;92007;21911;12424;9487;167;9320;GUYOMARD Sandra;F;GUYOMARD;Sandra;DIV;110
Législatives 2017 - 1er tour;Législatives;2017;1;11;11ème circonscription;46;MALAKOFF;92046;18448;8148;10300;133;10167;PARAIN Philippe;M;PARAIN;Philippe;UDI;626
Législatives 2017 - 1er tour;Législatives;2017;1;12;12ème circonscription;32;FONTENAY AUX ROSES;92032;16049;7756;8293;93;8200;TEXIER Damien;M;TEXIER;Damien;ECO;62
Législatives 2017 - 1er tour;Législatives;2017;1;12;12ème circonscription;32;FONTENAY AUX ROSES;92032;16049;7756;8293;93;8200;YVENAT Damien;M;YVENAT;Damien;FN;375
Législatives 2017 - 1er tour;Législatives;2017;1;12;12ème circonscription;60;LE PLESSIS ROBINSON;92060;19154;7496;11658;130;11528;BERNARD Yann;M;BERNARD;Yann;EXG;30
Législatives 2017 - 1er tour;Législatives;2017;1;12;12ème circonscription;60;LE PLESSIS ROBINSON;92060;19154;7496;11658;130;11528;SÉJOURNÉ Emmanuelle;F;SÉJOURNÉ;Emmanuelle;DLF;117
Législatives 2017 - 1er tour;Législatives;2017;1;13;13ème circonscription;14;BOURG LA REINE;92014;13736;5356;8380;81;8299;DUMAS Frédérique;F;DUMAS;Frédérique;REM;3839
Législatives 2017 - 1er tour;Législatives;2017;1;13;13ème circonscription;19;CHATENAY MALABRY;92019;18752;8166;10586;245;10341;CUKIERMAN Maurice;M;CUKIERMAN;Maurice;EXG;31
Législatives 2017 - 1er tour;Législatives;2017;1;13;13ème circonscription;19;CHATENAY MALABRY;92019;18752;8166;10586;245;10341;ACHACHE Tristan;M;ACHACHE;Tristan;DIV;7
Législatives 2017 - 2ème tour;Législatives;2017;2;4;4ème circonscription;73;SURESNES;92073;28524;15171;13353;1351;12002;BEDIN Camille;F;BEDIN;Camille;LR;3860
Législatives 2017 - 2ème tour;Législatives;2017;2;8;8ème circonscription;47;MARNES LA COQUETTE;92047;1215;548;667;28;639;MAIRE Jacques;M;MAIRE;Jacques;REM;294
Législatives 2017 - 2ème tour;Législatives;2017;2;10;10ème circonscription;75;VANVES;92075;18506;9482;9024;1014;8010;ATTAL Gabriel;M;ATTAL;Gabriel;REM;5201
Législatives 2017 - 2ème tour;Législatives;2017;2;12;12ème circonscription;60;LE PLESSIS ROBINSON;92060;19154;8662;10492;642;9850;BOURLANGES Jean-Louis;M;BOURLANGES;Jean-Louis;MDM;4228
Législatives 2017 - 2ème tour;Législatives;2017;2;13;13ème circonscription;14;BOURG LA REINE;92014;13736;6580;7156;682;6474;DUMAS Frédérique;F;DUMAS;Frédérique;REM;4117
Législatives 2017 - 1er tour;Législatives;2017;1;3;3ème circonscription;26;COURBEVOIE;92026;44322;19890;24432;415;24017;BRESSY Christophe;M;BRESSY;Christophe;DIV;92
Législatives 2017 - 1er tour;Législatives;2017;1;2;2ème circonscription;4;ASNIERES SUR SEINE;92004;48340;22557;25783;414;25369;M'BAYE Arame;F;M'BAYE;Arame;DVD;17
Législatives 2017 - 1er tour;Législatives;2017;1;3;3ème circonscription;9;BOIS COLOMBES;92009;17921;7869;10052;437;9615;DENIAU Floriane;F;DENIAU;Floriane;FN;334
Législatives 2017 - 1er tour;Législatives;2017;1;3;3ème circonscription;9;BOIS COLOMBES;92009;17921;7869;10052;437;9615;HENNION Christine;F;HENNION;Christine;REM;4525
Législatives 2017 - 1er tour;Législatives;2017;1;2;2ème circonscription;4;ASNIERES SUR SEINE;92004;48340;22557;25783;414;25369;HÉBERT Pierre;M;HÉBERT;Pierre;DVD;239
Législatives 2017 - 1er tour;Législatives;2017;1;3;3ème circonscription;35;LA GARENNE COLOMBES;92035;18829;8238;10591;114;10477;DORE Patricia;F;DORE;Patricia;ECO;53
Législatives 2017 - 1er tour;Législatives;2017;1;4;4ème circonscription;50;NANTERRE;92050;47651;26455;21196;432;20764;STRUMANNE Laurent;M;STRUMANNE;Laurent;EXG;111
Présidentielles 2017 - 1er tour;Présidentielles;2017;1;;;2;ANTONY;92002;41488;6486;35002;776;34226;MACRON Emmanuel;M;MACRON;Emmanuel;;11692
Présidentielles 2017 - 1er tour;Présidentielles;2017;1;;;7;BAGNEUX;92007;21873;5369;16504;428;16076;ASSELINEAU François;M;ASSELINEAU;François;;225
Présidentielles 2017 - 1er tour;Présidentielles;2017;1;;;12;BOULOGNE BILLANCOURT;92012;77303;15227;62076;919;61157;DUPONT-AIGNAN Nicolas;M;DUPONT-AIGNAN;Nicolas;;1191
Présidentielles 2017 - 1er tour;Présidentielles;2017;1;;;14;BOURG LA REINE;92014;13769;2202;11567;212;11355;MACRON Emmanuel;M;MACRON;Emmanuel;;4168
Présidentielles 2017 - 1er tour;Présidentielles;2017;1;;;23;CLAMART;92023;35291;6330;28961;560;28401;MACRON Emmanuel;M;MACRON;Emmanuel;;9192
Présidentielles 2017 - 1er tour;Présidentielles;2017;1;;;32;FONTENAY AUX ROSES;92032;16036;3739;12297;218;12078;POUTOU Philippe;M;POUTOU;Philippe;;117
Présidentielles 2017 - 1er tour;Présidentielles;2017;1;;;40;ISSY LES MOULINEAUX;92040;46800;9050;37750;728;37022;LE PEN Marine;F;LE PEN;Marine;;2490
Présidentielles 2017 - 1er tour;Présidentielles;2017;1;;;44;LEVALLOIS PERRET;92044;41716;6107;35609;511;35098;HAMON Benoît;M;HAMON;Benoît;;1746
Présidentielles 2017 - 1er tour;Présidentielles;2017;1;;;49;MONTROUGE;92049;28899;4312;24587;429;24158;LE PEN Marine;F;LE PEN;Marine;;1674
Présidentielles 2017 - 1er tour;Présidentielles;2017;1;;;60;LE PLESSIS ROBINSON;92060;19141;2947;16194;344;15850;HAMON Benoît;M;HAMON;Benoît;;995
Présidentielles 2017 - 1er tour;Présidentielles;2017;1;;;76;VAUCRESSON;92076;6176;835;5341;72;5269;MÉLENCHON Jean-Luc;M;MÉLENCHON;Jean-Luc;;392
Présidentielles 2012 - 1er tour;Présidentielles;2012;1;;;7;BAGNEUX;92007;20608;4687;15921;281;15640;HOLLANDE François;M;HOLLANDE;François;;6191
Présidentielles 2012 - 1er tour;Présidentielles;2012;1;;;19;CHATENAY MALABRY;92019;17914;3466;14448;325;14123;SARKOZY Nicolas;M;SARKOZY;Nicolas;;3845
Présidentielles 2012 - 1er tour;Présidentielles;2012;1;;;23;CLAMART;92023;34131;6740;27391;417;26974;MÉLENCHON Jean-Luc;M;MÉLENCHON;Jean-Luc;;2965
Présidentielles 2012 - 1er tour;Présidentielles;2012;1;;;23;CLAMART;92023;34131;6740;27391;417;26974;POUTOU Philippe;M;POUTOU;Philippe;;229
Présidentielles 2012 - 1er tour;Présidentielles;2012;1;;;23;CLAMART;92023;34131;6740;27391;417;26974;CHEMINADE Jacques;M;CHEMINADE;Jacques;;68
Présidentielles 2012 - 1er tour;Présidentielles;2012;1;;;24;CLICHY;92024;29226;6786;22440;374;22066;POUTOU Philippe;M;POUTOU;Philippe;;184
Présidentielles 2012 - 1er tour;Présidentielles;2012;1;;;25;COLOMBES;92025;44741;10181;34560;526;34034;DUPONT-AIGNAN Nicolas;M;DUPONT-AIGNAN;Nicolas;;474
Présidentielles 2012 - 1er tour;Présidentielles;2012;1;;;33;GARCHES;92033;12388;2501;9887;167;9720;LE PEN Marine;F;LE PEN;Marine;;791
Présidentielles 2012 - 1er tour;Présidentielles;2012;1;;;35;LA GARENNE COLOMBES;92035;17300;3509;13791;212;13579;CHEMINADE Jacques;M;CHEMINADE;Jacques;;27
Présidentielles 2012 - 1er tour;Présidentielles;2012;1;;;44;LEVALLOIS PERRET;92044;39497;7296;32201;438;31763;BAYROU François;M;BAYROU;François;;3283
Présidentielles 2012 - 1er tour;Présidentielles;2012;1;;;48;MEUDON;92048;30572;6341;24231;318;23913;CHEMINADE Jacques;M;CHEMINADE;Jacques;;57
Présidentielles 2012 - 1er tour;Présidentielles;2012;1;;;62;PUTEAUX;92062;28189;5597;22592;470;22122;JOLY Eva;F;JOLY;Eva;;629
Présidentielles 2012 - 1er tour;Présidentielles;2012;1;;;62;PUTEAUX;92062;28189;5597;22592;470;22122;ARTHAUD Nathalie;F;ARTHAUD;Nathalie;;54
Présidentielles 2012 - 1er tour;Présidentielles;2012;1;;;64;SAINT CLOUD;92064;18973;3529;15444;153;15291;HOLLANDE François;M;HOLLANDE;François;;2863
Présidentielles 2012 - 1er tour;Présidentielles;2012;1;;;76;VAUCRESSON;92076;6089;1241;4848;74;4774;JOLY Eva;F;JOLY;Eva;;134
Présidentielles 2012 - 1er tour;Présidentielles;2012;1;;;77;VILLE D'AVRAY;92077;7132;1060;6072;80;5992;LE PEN Marine;F;LE PEN;Marine;;318
Présidentielles 2012 - 2ème tour;Présidentielles;2012;2;;;20;CHATILLON;92020;21672;3615;18057;732;17325;SARKOZY Nicolas;M;SARKOZY;Nicolas;;7722
Présidentielles 2012 - 2ème tour;Présidentielles;2012;2;;;24;CLICHY;92024;29241;6073;23168;958;22210;HOLLANDE François;M;HOLLANDE;François;;14867
Présidentielles 2012 - 2ème tour;Présidentielles;2012;2;;;36;GENNEVILLIERS;92036;20990;4770;16220;758;15462;SARKOZY Nicolas;M;SARKOZY;Nicolas;;3612
Présidentielles 2012 - 2ème tour;Présidentielles;2012;2;;;63;RUEIL MALMAISON;92063;52387;8351;44036;1727;42309;HOLLANDE François;M;HOLLANDE;François;;18298
Présidentielles 2017 - 2ème tour;Présidentielles;2017;2;;;49;MONTROUGE;92049;28903;5913;22990;1855;21135;MACRON Emmanuel;M;MACRON;Emmanuel;;18545
Législatives 2007 - 1er tour;Législatives;2007;1;2;2ème circonscription;4;ASNIERES SUR SEINE;92004;44110;17783;26327;312;26015;FRAGER Dominique;M;FRAGER;Dominique;VEC;630
Législatives 2007 - 1er tour;Législatives;2007;1;13;13ème circonscription;2;ANTONY;92002;39807;13942;25865;456;25409;GOURDOL Aimée;F;GOURDOL;Aimée;DVG;141
Législatives 2007 - 1er tour;Législatives;2007;1;12;12ème circonscription;32;FONTENAY AUX ROSES;92032;15468;5605;9863;84;9779;SCHMITT Jean-Pierre;M;SCHMITT;Jean-Pierre;FN;225
Législatives 2007 - 1er tour;Législatives;2007;1;1;1ère circonscription;36;GENNEVILLIERS;92036;20048;9522;10526;189;10337;DARRACQ Michel;M;DARRACQ;Michel;DIV;0
Législatives 2007 - 1er tour;Législatives;2007;1;1;1ère circonscription;36;GENNEVILLIERS;92036;20048;9522;10526;189;10337;JEAN Yves;M;JEAN;Yves;DVD;25
Législatives 2007 - 1er tour;Législatives;2007;1;2;2ème circonscription;25;COLOMBES;92025;18336;7144;11192;207;10985;ETCHEBERRY Michèle;F;ETCHEBERRY;Michèle;SOC;2693
Législatives 2007 - 1er tour;Législatives;2007;1;1;1ère circonscription;25;COLOMBES;92025;26192;12273;13919;366;13553;VIGNON Véronique;F;VIGNON;Véronique;UMP;4343
Législatives 2007 - 1er tour;Législatives;2007;1;3;3ème circonscription;26;COURBEVOIE;92026;49151;19345;29806;541;29265;HERBIN Annick;F;HERBIN;Annick;COM;359
Législatives 2007 - 1er tour;Législatives;2007;1;8;8ème circonscription;47;MARNES LA COQUETTE;92047;1074;316;758;5;753;SUCHARD Sophie;F;SUCHARD;Sophie;EXG;1
Législatives 2007 - 1er tour;Législatives;2007;1;8;8ème circonscription;48;MEUDON;92048;25427;9683;15744;202;15542;GUILLET Jean-Jacques;M;GUILLET;Jean-Jacques;UMP;7135
Législatives 2007 - 1er tour;Législatives;2007;1;8;8ème circonscription;22;CHAVILLE;92022;12928;4682;8246;120;8126;SUCHARD Sophie;F;SUCHARD;Sophie;EXG;38
Législatives 2007 - 1er tour;Législatives;2007;1;11;11ème circonscription;49;MONTROUGE;92049;26595;9698;16897;213;16684;TEIXEIRA Dominique;M;TEIXEIRA;Dominique;EXG;45
Législatives 2007 - 1er tour;Législatives;2007;1;4;4ème circonscription;50;NANTERRE;92050;42631;18721;23910;314;23596;FRAYSSE Jacqueline;F;FRAYSSE;Jacqueline;COM;8192
Législatives 2007 - 1er tour;Législatives;2007;1;10;10ème circonscription;48;MEUDON;92048;5066;1864;3202;29;3173;HOCINI Malek;M;HOCINI;Malek;DIV;20
Législatives 2007 - 1er tour;Législatives;2007;1;12;12ème circonscription;60;LE PLESSIS ROBINSON;92060;16776;5588;11188;123;11065;DIAZ GOMEZ Elisabeth;F;DIAZ GOMEZ;Elisabeth;DIV;2
Législatives 2007 - 1er tour;Législatives;2007;1;6;6ème circonscription;51;NEUILLY SUR SEINE;92051;39134;14738;24396;185;24211;STRAUSS Anne-Christine;F;STRAUSS;Anne-Christine;FN;640
Législatives 2007 - 1er tour;Législatives;2007;1;12;12ème circonscription;60;LE PLESSIS ROBINSON;92060;16776;5588;11188;123;11065;DELOM Christian;M;DELOM;Christian;UDFD;892
Législatives 2007 - 1er tour;Législatives;2007;1;13;13ème circonscription;19;CHATENAY MALABRY;92019;17835;6584;11251;211;11040;HOLLEBEKE Dominique;F;HOLLEBEKE;Dominique;MPF;95
Législatives 2007 - 1er tour;Législatives;2007;1;13;13ème circonscription;19;CHATENAY MALABRY;92019;17835;6584;11251;211;11040;IORIO Catherine;F;IORIO;Catherine;FN;285
Législatives 2007 - 1er tour;Législatives;2007;1;10;10ème circonscription;12;BOULOGNE BILLANCOURT;92012;5551;2367;3184;78;3106;ARIPA Alain;M;ARIPA;Alain;MPF;54
Législatives 2007 - 1er tour;Législatives;2007;1;13;13ème circonscription;14;BOURG LA REINE;92014;13381;4391;8990;78;8912;CANET Michèle;F;CANET;Michèle;SOC;2087
Présidentielles 2002 - 1er tour;Présidentielles;2002;1;;;4;ASNIERES SUR SEINE;92004;35702;11271;24431;515;23916;LEPAGE CORINNE;F;LEPAGE;CORINNE;;594
Présidentielles 2002 - 1er tour;Présidentielles;2002;1;;;7;BAGNEUX;92007;18489;5873;12616;519;12097;LEPAGE CORINNE;F;LEPAGE;CORINNE;;188
Présidentielles 2002 - 1er tour;Présidentielles;2002;1;;;12;BOULOGNE BILLANCOURT;92012;57382;17570;39812;645;39167;GLUCKSTEIN DANIEL;M;GLUCKSTEIN;DANIEL;;60
Présidentielles 2002 - 1er tour;Présidentielles;2002;1;;;19;CHATENAY MALABRY;92019;15965;4483;11482;241;11241;MADELIN ALAIN;M;MADELIN;ALAIN;;461
Présidentielles 2002 - 1er tour;Présidentielles;2002;1;;;20;CHATILLON;92020;18067;5487;12580;295;12285;TAUBIRA CHRISTIANE;F;TAUBIRA;CHRISTIANE;;465
Présidentielles 2002 - 1er tour;Présidentielles;2002;1;;;22;CHAVILLE;92022;12122;3826;8296;162;8134;SAINT-JOSSE JEAN;M;SAINT-JOSSE;JEAN;;64
Présidentielles 2002 - 1er tour;Présidentielles;2002;1;;;23;CLAMART;92023;31130;10977;20153;427;19726;GLUCKSTEIN DANIEL;M;GLUCKSTEIN;DANIEL;;90
Présidentielles 2002 - 1er tour;Présidentielles;2002;1;;;23;CLAMART;92023;31130;10977;20153;427;19726;BOUTIN CHRISTINE;F;BOUTIN;CHRISTINE;;240
Présidentielles 2002 - 1er tour;Présidentielles;2002;1;;;24;CLICHY;92024;24491;8395;16096;399;15697;JOSPIN LIONEL;M;JOSPIN;LIONEL;;3111
Présidentielles 2002 - 1er tour;Présidentielles;2002;1;;;25;COLOMBES;92025;39608;13654;25954;571;25383;CHIRAC JACQUES;M;CHIRAC;JACQUES;;4697
Présidentielles 2002 - 1er tour;Présidentielles;2002;1;;;25;COLOMBES;92025;39608;13654;25954;571;25383;JOSPIN LIONEL;M;JOSPIN;LIONEL;;4498
Présidentielles 2002 - 1er tour;Présidentielles;2002;1;;;40;ISSY LES MOULINEAUX;92040;32059;9424;22635;510;22125;LAGUILLER ARLETTE;F;LAGUILLER;ARLETTE;;873
Présidentielles 2002 - 1er tour;Présidentielles;2002;1;;;47;MARNES LA COQUETTE;92047;997;272;725;7;718;LEPAGE CORINNE;F;LEPAGE;CORINNE;;25
Présidentielles 2002 - 1er tour;Présidentielles;2002;1;;;47;MARNES LA COQUETTE;92047;997;272;725;7;718;LAGUILLER ARLETTE;F;LAGUILLER;ARLETTE;;10
Présidentielles 2002 - 1er tour;Présidentielles;2002;1;;;48;MEUDON;92048;28283;9341;18942;321;18621;BAYROU FRANCOIS;M;BAYROU;FRANCOIS;;2115
Présidentielles 2002 - 1er tour;Présidentielles;2002;1;;;49;MONTROUGE;92049;23382;8142;15240;301;14939;MADELIN ALAIN;M;MADELIN;ALAIN;;672
Présidentielles 2002 - 1er tour;Présidentielles;2002;1;;;50;NANTERRE;92050;37590;13303;24287;669;23618;CHIRAC JACQUES;M;CHIRAC;JACQUES;;3530
Présidentielles 2002 - 1er tour;Présidentielles;2002;1;;;51;NEUILLY SUR SEINE;92051;34066;10108;23958;309;23649;GLUCKSTEIN DANIEL;M;GLUCKSTEIN;DANIEL;;11
Présidentielles 2002 - 1er tour;Présidentielles;2002;1;;;63;RUEIL MALMAISON;92063;48302;17158;31144;693;30451;JOSPIN LIONEL;M;JOSPIN;LIONEL;;4749
Présidentielles 2002 - 1er tour;Présidentielles;2002;1;;;64;SAINT CLOUD;92064;17818;6028;11790;141;11649;LEPAGE CORINNE;F;LEPAGE;CORINNE;;344
Présidentielles 2002 - 1er tour;Présidentielles;2002;1;;;64;SAINT CLOUD;92064;17818;6028;11790;141;11649;LAGUILLER ARLETTE;F;LAGUILLER;ARLETTE;;189
Présidentielles 2002 - 1er tour;Présidentielles;2002;1;;;71;SCEAUX;92071;12917;3930;8987;154;8833;MAMERE NOEL;M;MAMERE;NOEL;;501
Présidentielles 2002 - 1er tour;Présidentielles;2002;1;;;75;VANVES;92075;15493;4648;10845;221;10624;CHEVENEMENT JEAN-PIERRE;M;CHEVENEMENT;JEAN-PIERRE;;781
Présidentielles 2002 - 1er tour;Présidentielles;2002;1;;;76;VAUCRESSON;92076;5861;2048;3813;62;3751;HUE ROBERT;M;HUE;ROBERT;;27
Présidentielles 2007 - 1er tour;Présidentielles;2007;1;;;4;ASNIERES SUR SEINE;92004;43605;5665;37940;436;37504;de VILLIERS Philippe;M;de VILLIERS;Philippe;;443
Présidentielles 2007 - 1er tour;Présidentielles;2007;1;;;7;BAGNEUX;92007;20438;2809;17629;261;17368;BOVÉ José;M;BOVÉ;José;;252
Présidentielles 2007 - 1er tour;Présidentielles;2007;1;;;14;BOURG LA REINE;92014;13108;1436;11672;90;11582;VOYNET Dominique;F;VOYNET;Dominique;;203
Présidentielles 2007 - 1er tour;Présidentielles;2007;1;;;23;CLAMART;92023;32539;3879;28660;293;28367;NIHOUS Frédéric;M;NIHOUS;Frédéric;;68
Présidentielles 2007 - 1er tour;Présidentielles;2007;1;;;24;CLICHY;92024;28539;4472;24067;245;23822;LAGUILLER Arlette;F;LAGUILLER;Arlette;;214
Présidentielles 2007 - 1er tour;Présidentielles;2007;1;;;25;COLOMBES;92025;44025;7536;36489;501;35988;LE PEN Jean-Marie;M;LE PEN;Jean-Marie;;2228
Présidentielles 2007 - 1er tour;Présidentielles;2007;1;;;26;COURBEVOIE;92026;48308;7118;41190;456;40734;BESANCENOT Olivier;M;BESANCENOT;Olivier;;722
Présidentielles 2007 - 1er tour;Présidentielles;2007;1;;;26;COURBEVOIE;92026;48308;7118;41190;456;40734;BOVÉ José;M;BOVÉ;José;;234
Présidentielles 2007 - 1er tour;Présidentielles;2007;1;;;33;GARCHES;92033;11957;1346;10611;106;10505;BUFFET Marie-George;F;BUFFET;Marie-George;;58
Présidentielles 2007 - 1er tour;Présidentielles;2007;1;;;35;LA GARENNE COLOMBES;92035;16350;1826;14524;117;14407;BESANCENOT Olivier;M;BESANCENOT;Olivier;;323
Présidentielles 2007 - 1er tour;Présidentielles;2007;1;;;36;GENNEVILLIERS;92036;19890;3536;16354;259;16095;NIHOUS Frédéric;M;NIHOUS;Frédéric;;38
Présidentielles 2007 - 1er tour;Présidentielles;2007;1;;;40;ISSY LES MOULINEAUX;92040;37966;4920;33046;365;32681;BESANCENOT Olivier;M;BESANCENOT;Olivier;;788
Présidentielles 2007 - 1er tour;Présidentielles;2007;1;;;44;LEVALLOIS PERRET;92044;38708;4734;33974;296;33678;SCHIVARDI Gérard;M;SCHIVARDI;Gérard;;43
Présidentielles 2007 - 1er tour;Présidentielles;2007;1;;;47;MARNES LA COQUETTE;92047;1054;91;963;9;954;ROYAL Ségolène;F;ROYAL;Ségolène;;118
Présidentielles 2007 - 1er tour;Présidentielles;2007;1;;;48;MEUDON;92048;29936;4129;25807;223;25584;de VILLIERS Philippe;M;de VILLIERS;Philippe;;345
Présidentielles 2007 - 1er tour;Présidentielles;2007;1;;;49;MONTROUGE;92049;26299;3093;23206;219;22987;VOYNET Dominique;F;VOYNET;Dominique;;401
Présidentielles 2007 - 1er tour;Présidentielles;2007;1;;;63;RUEIL MALMAISON;92063;50540;5920;44620;393;44227;SARKOZY Nicolas;M;SARKOZY;Nicolas;;18326
Présidentielles 2007 - 1er tour;Présidentielles;2007;1;;;73;SURESNES;92073;24255;2600;21655;272;21383;VOYNET Dominique;F;VOYNET;Dominique;;326
Présidentielles 2007 - 1er tour;Présidentielles;2007;1;;;76;VAUCRESSON;92076;5902;781;5121;42;5079;VOYNET Dominique;F;VOYNET;Dominique;;68
Présidentielles 2007 - 1er tour;Présidentielles;2007;1;;;76;VAUCRESSON;92076;5902;781;5121;42;5079;LAGUILLER Arlette;F;LAGUILLER;Arlette;;14
Présidentielles 2007 - 1er tour;Présidentielles;2007;1;;;78;VILLENEUVE LA GARENNE;92078;12897;2898;9999;145;9854;SCHIVARDI Gérard;M;SCHIVARDI;Gérard;;17
Présidentielles 2007 - 1er tour;Présidentielles;2007;1;;;78;VILLENEUVE LA GARENNE;92078;12897;2898;9999;145;9854;NIHOUS Frédéric;M;NIHOUS;Frédéric;;17
Présidentielles 1995 - 1er tour;Présidentielles;1995;1;;;48;MEUDON;92048;29714;7851;21863;352;21511;LE PEN J.MARIE;M;LE PEN;J.MARIE;;2077
Présidentielles 1995 - 1er tour;Présidentielles;1995;1;;;50;NANTERRE;92050;46920;11548;35372;736;34636;CHIRAC JACQUES;M;CHIRAC;JACQUES;;6510
Présidentielles 1995 - 1er tour;Présidentielles;1995;1;;;51;NEUILLY SUR SEINE;92051;35904;7798;28106;261;27845;LE PEN J.MARIE;M;LE PEN;J.MARIE;;2138
Présidentielles 1995 - 1er tour;Présidentielles;1995;1;;;62;PUTEAUX;92062;24192;6165;18027;379;17648;JOSPIN LIONEL;M;JOSPIN;LIONEL;;3871
Présidentielles 1995 - 1er tour;Présidentielles;1995;1;;;73;SURESNES;92073;21968;5851;16117;341;15776;CHIRAC JACQUES;M;CHIRAC;JACQUES;;4340
Présidentielles 1995 - 1er tour;Présidentielles;1995;1;;;77;VILLE D'AVRAY;92077;7139;1490;5649;74;5575;BALLADUR EDOUARD;M;BALLADUR;EDOUARD;;1598
Présidentielles 1995 - 1er tour;Présidentielles;1995;1;;;78;VILLENEUVE LA GARENNE;92078;11588;3130;8458;196;8262;LAGUILLER ARLETTE;F;LAGUILLER;ARLETTE;;451
Présidentielles 1995 - 1er tour;Présidentielles;1995;1;;;4;ASNIERES SUR SEINE;92004;39050;10288;28762;594;28168;VOYNET DOMINIQUE;F;VOYNET;DOMINIQUE;;869
Présidentielles 1995 - 1er tour;Présidentielles;1995;1;;;4;ASNIERES SUR SEINE;92004;39050;10288;28762;594;28168;JOSPIN LIONEL;M;JOSPIN;LIONEL;;6164
Présidentielles 1995 - 1er tour;Présidentielles;1995;1;;;47;MARNES LA COQUETTE;92047;1003;227;776;11;765;CHIRAC JACQUES;M;CHIRAC;JACQUES;;284
Présidentielles 1995 - 1er tour;Présidentielles;1995;1;;;46;MALAKOFF;92046;19489;5677;13812;258;13554;JOSPIN LIONEL;M;JOSPIN;LIONEL;;3200
Présidentielles 2007 - 2ème tour;Présidentielles;2007;2;;;46;MALAKOFF;92046;18269;2915;15354;551;14803;SARKOZY Nicolas;M;SARKOZY;Nicolas;;5467
Présidentielles 1995 - 1er tour;Présidentielles;1995;1;;;20;CHATILLON;92020;16579;4065;12514;245;12269;LAGUILLER ARLETTE;F;LAGUILLER;ARLETTE;;652
Présidentielles 1995 - 1er tour;Présidentielles;1995;1;;;20;CHATILLON;92020;16579;4065;12514;245;12269;LE PEN J.MARIE;M;LE PEN;J.MARIE;;1393
Présidentielles 1995 - 1er tour;Présidentielles;1995;1;;;32;FONTENAY AUX ROSES;92032;14917;3559;11358;196;11162;BALLADUR EDOUARD;M;BALLADUR;EDOUARD;;1978
Présidentielles 1995 - 2ème tour;Présidentielles;1995;2;;;35;LA GARENNE COLOMBES;92035;14104;3230;10874;544;10330;JOSPIN LIONEL;M;JOSPIN;LIONEL;;6292
Présidentielles 1995 - 2ème tour;Présidentielles;1995;2;;;77;VILLE D'AVRAY;92077;7137;1035;6102;154;5948;CHIRAC JACQUES;M;CHIRAC;JACQUES;;4439
Présidentielles 1995 - 1er tour;Présidentielles;1995;1;;;26;COURBEVOIE;92026;35812;8064;27748;468;27280;LAGUILLER ARLETTE;F;LAGUILLER;ARLETTE;;1218
Présidentielles 1995 - 1er tour;Présidentielles;1995;1;;;24;CLICHY;92024;24688;6820;17868;364;17504;CHIRAC JACQUES;M;CHIRAC;JACQUES;;3827
Législatives 1993 - 2ème tour;Législatives;1993;2;12;12ème circonscription;20;CHATILLON;92020;15705;4600;11105;678;10427;FOUCHER J.PIERRE;M;FOUCHER;J.PIERRE;UDF;6039
Législatives 1997 - 1er tour;Législatives;1997;1;13;13ème circonscription;2;ANTONY;92002;37772;12082;25690;861;24829;SCHNEITER LEONORE;F;SCHNEITER;LEONORE;ECO;369
Législatives 1997 - 1er tour;Législatives;1997;1;13;13ème circonscription;2;ANTONY;92002;37772;12082;25690;861;24829;MARTIN ANNICK;F;MARTIN;ANNICK;FRN;2806
Législatives 1997 - 1er tour;Législatives;1997;1;9;9ème circonscription;12;BOULOGNE BILLANCOURT;92012;53287;18902;34385;948;33437;DUTHU M.FRANCOISE;F;DUTHU;M.FRANCOISE;ECO;1000
Législatives 1997 - 1er tour;Législatives;1997;1;12;12ème circonscription;20;CHATILLON;92020;16406;5234;11172;367;10805;PEYRONNEAU GASTON;M;PEYRONNEAU;GASTON;COM;875
Législatives 1997 - 1er tour;Législatives;1997;1;1;1ère circonscription;36;GENNEVILLIERS;92036;19277;7226;12051;295;11756;MUSSAT PHILIPPE;M;MUSSAT;PHILIPPE;EXG;125
Législatives 1997 - 1er tour;Législatives;1997;1;5;5ème circonscription;24;CLICHY;92024;23725;8942;14783;486;14297;LAMY LAURENCE;F;LAMY;LAURENCE;DVD;132
Législatives 1997 - 1er tour;Législatives;1997;1;1;1ère circonscription;25;COLOMBES;92025;26238;10153;16085;513;15572;ROUAT ALAIN;M;ROUAT;ALAIN;ECO;721
Législatives 1997 - 1er tour;Législatives;1997;1;3;3ème circonscription;35;LA GARENNE COLOMBES;92035;13992;5163;8829;294;8535;GALICIER BEATRICE;F;GALICIER;BEATRICE;COM;482
Législatives 1997 - 1er tour;Législatives;1997;1;3;3ème circonscription;35;LA GARENNE COLOMBES;92035;13992;5163;8829;294;8535;KOSSOWSKI JACQUES;M;KOSSOWSKI;JACQUES;DVD;1834
Législatives 1997 - 1er tour;Législatives;1997;1;7;7ème circonscription;33;GARCHES;92033;11323;3745;7578;290;7288;CAGNIER MAURICE;M;CAGNIER;MAURICE;ECO;136
Législatives 1997 - 1er tour;Législatives;1997;1;8;8ème circonscription;47;MARNES LA COQUETTE;92047;985;289;696;19;677;MARKOVITCH ISABELLE;F;MARKOVITCH;ISABELLE;DVD;0
Législatives 1997 - 1er tour;Législatives;1997;1;8;8ème circonscription;48;MEUDON;92048;24248;8136;16112;629;15483;MULLERIS KONOPNICKI A.PAULE;F;MULLERIS KONOPNICKI;A.PAULE;ECO;956
Législatives 1997 - 1er tour;Législatives;1997;1;11;11ème circonscription;46;MALAKOFF;92046;19124;7233;11891;338;11553;BOURGES BRIGITTE;F;BOURGES;BRIGITTE;EXG;317
Législatives 1997 - 1er tour;Législatives;1997;1;8;8ème circonscription;48;MEUDON;92048;24248;8136;16112;629;15483;ETILE L.CHRISTOPHE;M;ETILE;L.CHRISTOPHE;DVD;135
Législatives 1993 - 1er tour;Législatives;1993;1;7;7ème circonscription;63;RUEIL MALMAISON;92063;42219;12104;30115;1049;29066;GENSANNE MARIE;F;GENSANNE;MARIE;DIV;641
Législatives 1993 - 1er tour;Législatives;1993;1;7;7ème circonscription;63;RUEIL MALMAISON;92063;42219;12104;30115;1049;29066;BURQ DANIEL;M;BURQ;DANIEL;GEC;3321
Législatives 1993 - 1er tour;Législatives;1993;1;4;4ème circonscription;73;SURESNES;92073;21292;6457;14835;522;14313;DEMERCASTEL CHRISTIAN;M;DEMERCASTEL;CHRISTIAN;VEC;1169
Législatives 1993 - 1er tour;Législatives;1993;1;10;10ème circonscription;40;ISSY LES MOULINEAUX;92040;29377;9425;19952;648;19304;BITON MARLENE;F;BITON;MARLENE;SOC;2770
Législatives 1993 - 1er tour;Législatives;1993;1;13;13ème circonscription;14;BOURG LA REINE;92014;12754;4085;8669;303;8366;GAZZOLA DANIEL;M;GAZZOLA;DANIEL;FRN;942
Législatives 1997 - 1er tour;Législatives;1997;1;8;8ème circonscription;72;SEVRES;92072;13776;4413;9363;352;9011;ARIA D DANIELA;F;ARIA D;DANIELA;DIV;0
Législatives 1997 - 1er tour;Législatives;1997;1;13;13ème circonscription;71;SCEAUX;92071;13168;3887;9281;266;9015;MARTIN ANNICK;F;MARTIN;ANNICK;FRN;910
Législatives 1997 - 1er tour;Législatives;1997;1;6;6ème circonscription;51;NEUILLY SUR SEINE;92051;35571;12347;23224;570;22654;LIGONIE B.XAVIER;M;LIGONIE;B.XAVIER;FRN;2246
Législatives 1997 - 1er tour;Législatives;1997;1;11;11ème circonscription;49;MONTROUGE;92049;21975;7943;14032;388;13644;SABATIE FRANCOISE;F;SABATIE;FRANCOISE;DVG;22
Législatives 1997 - 1er tour;Législatives;1997;1;10;10ème circonscription;48;MEUDON;92048;4118;1375;2743;67;2676;BERTRAND GINETTE;F;BERTRAND;GINETTE;DVD;77
Législatives 1997 - 1er tour;Législatives;1997;1;10;10ème circonscription;48;MEUDON;92048;4118;1375;2743;67;2676;DENIAU RAYMOND;M;DENIAU;RAYMOND;EXG;33
Législatives 1997 - 1er tour;Législatives;1997;1;10;10ème circonscription;48;MEUDON;92048;4118;1375;2743;67;2676;LOUSTAU AXEL;M;LOUSTAU;AXEL;FRN;299
Législatives 1997 - 1er tour;Législatives;1997;1;7;7ème circonscription;63;RUEIL MALMAISON;92063;44715;14813;29902;1094;28808;CABOT DOMINIQUE;M;CABOT;DOMINIQUE;DIV;227
Législatives 1997 - 1er tour;Législatives;1997;1;4;4ème circonscription;73;SURESNES;92073;20985;7217;13768;441;13327;SCHAUB STEPHANE;M;SCHAUB;STEPHANE;DVD;164
Législatives 1997 - 2ème tour;Législatives;1997;2;9;9ème circonscription;12;BOULOGNE BILLANCOURT;92012;53287;17619;35668;1296;34372;BAGUET P.CHRISTOPHE;M;BAGUET;P.CHRISTOPHE;UDF;23464
Législatives 1997 - 2ème tour;Législatives;1997;2;2;2ème circonscription;4;ASNIERES SUR SEINE;92004;37154;12512;24642;1420;23222;FRAGER DOMINIQUE;M;FRAGER;DOMINIQUE;ECO;9674
Législatives 1997 - 1er tour;Législatives;1997;1;10;10ème circonscription;75;VANVES;92075;15446;4682;10764;329;10435;JANVIER FREDERIC;M;JANVIER;FREDERIC;EXD;100
Législatives 2002 - 1er tour;Législatives;2002;1;12;12ème circonscription;20;CHATILLON;92020;20661;7083;13578;137;13441;CHABRAN Isabelle;F;CHABRAN;Isabelle;VEC;510
Législatives 2002 - 1er tour;Législatives;2002;1;12;12ème circonscription;20;CHATILLON;92020;20661;7083;13578;137;13441;SCHMITT Jean-Pierre;M;SCHMITT;Jean-Pierre;FN;347
Législatives 2002 - 1er tour;Législatives;2002;1;8;8ème circonscription;22;CHAVILLE;92022;12928;4682;8246;120;8126;GONNET Nicolas;M;GONNET;Nicolas;COM;182
Législatives 2002 - 1er tour;Législatives;2002;1;2;2ème circonscription;25;COLOMBES;92025;18336;7144;11192;207;10985;JOUBERT Valérie;F;JOUBERT;Valérie;EXG;185
Législatives 2002 - 1er tour;Législatives;2002;1;2;2ème circonscription;25;COLOMBES;92025;18336;7144;11192;207;10985;AESCHLIMANN Manuel;M;AESCHLIMANN;Manuel;UMP;5185
Législatives 2002 - 1er tour;Législatives;2002;1;2;2ème circonscription;25;COLOMBES;92025;18336;7144;11192;207;10985;SEMOUN Jean-Jacques;M;SEMOUN;Jean-Jacques;DVD;50
Législatives 2002 - 1er tour;Législatives;2002;1;2;2ème circonscription;25;COLOMBES;92025;18336;7144;11192;207;10985;MASSOL Hubert;M;MASSOL;Hubert;EXD;48
Législatives 2002 - 1er tour;Législatives;2002;1;3;3ème circonscription;26;COURBEVOIE;92026;49151;19345;29806;541;29265;ROYON Francine;F;ROYON;Francine;EXG;467
Législatives 2002 - 1er tour;Législatives;2002;1;3;3ème circonscription;26;COURBEVOIE;92026;49151;19345;29806;541;29265;DERAMBARSH Arash;M;DERAMBARSH;Arash;DVD;538
Législatives 2002 - 1er tour;Législatives;2002;1;12;12ème circonscription;32;FONTENAY AUX ROSES;92032;15468;5605;9863;84;9779;DIAZ GOMEZ Elisabeth;F;DIAZ GOMEZ;Elisabeth;DIV;0
Législatives 2002 - 1er tour;Législatives;2002;1;1;1ère circonscription;36;GENNEVILLIERS;92036;20048;9522;10526;189;10337;SARRE Philippe;M;SARRE;Philippe;SOC;1298
Législatives 2002 - 1er tour;Législatives;2002;1;1;1ère circonscription;36;GENNEVILLIERS;92036;20048;9522;10526;189;10337;BINDER Sylvain;M;BINDER;Sylvain;DIV;40
Législatives 2002 - 1er tour;Législatives;2002;1;10;10ème circonscription;48;MEUDON;92048;5066;1864;3202;29;3173;ALEZARD Lysiane;F;ALEZARD;Lysiane;COM;69
Législatives 2002 - 1er tour;Législatives;2002;1;10;10ème circonscription;48;MEUDON;92048;5066;1864;3202;29;3173;DROUET Valérie;F;DROUET;Valérie;EXD;9
Législatives 2002 - 1er tour;Législatives;2002;1;6;6ème circonscription;51;NEUILLY SUR SEINE;92051;39134;14738;24396;185;24211;MINARDI Gaëtan;M;MINARDI;Gaëtan;EXG;27
Législatives 2017 - 1er tour;Législatives;2017;1;6;6ème circonscription;26;COURBEVOIE;92026;8107;4228;3879;107;3772;ETZENBACH Nathalie;F;ETZENBACH;Nathalie;DVD;148
Législatives 2017 - 1er tour;Législatives;2017;1;6;6ème circonscription;26;COURBEVOIE;92026;8107;4228;3879;107;3772;MARCEL Françoise;F;MARCEL;Françoise;EXG;16
Législatives 2017 - 1er tour;Législatives;2017;1;3;3ème circonscription;9;BOIS COLOMBES;92009;17921;7869;10052;437;9615;DENOO Emilia;F;DENOO;Emilia;DIV;106
Législatives 2017 - 1er tour;Législatives;2017;1;11;11ème circonscription;46;MALAKOFF;92046;18448;8148;10300;133;10167;SERRE Wilfried;M;SERRE;Wilfried;DVD;17
Législatives 2017 - 1er tour;Législatives;2017;1;12;12ème circonscription;23;CLAMART;92023;35342;15954;19388;238;19150;TEXIER Damien;M;TEXIER;Damien;ECO;179
Législatives 2017 - 1er tour;Législatives;2017;1;12;12ème circonscription;60;LE PLESSIS ROBINSON;92060;19154;7496;11658;130;11528;TEXIER Damien;M;TEXIER;Damien;ECO;72
Législatives 2017 - 1er tour;Législatives;2017;1;12;12ème circonscription;60;LE PLESSIS ROBINSON;92060;19154;7496;11658;130;11528;ASCOUET Florence;F;ASCOUET;Florence;DIV;74
Législatives 2017 - 1er tour;Législatives;2017;1;13;13ème circonscription;14;BOURG LA REINE;92014;13736;5356;8380;81;8299;ACHACHE Tristan;M;ACHACHE;Tristan;DIV;8
Législatives 2017 - 1er tour;Législatives;2017;1;13;13ème circonscription;71;SCEAUX;92071;15078;6395;8683;84;8599;PINÇON-CHARLOT Monique;F;PINÇON-CHARLOT;Monique;DVG;284
Législatives 2017 - 2ème tour;Législatives;2017;2;6;6ème circonscription;26;COURBEVOIE;92026;8107;4853;3254;361;2893;ZAMECZKOWSKI Laurent;M;ZAMECZKOWSKI;Laurent;REM;1789
Législatives 2017 - 2ème tour;Législatives;2017;2;7;7ème circonscription;63;RUEIL MALMAISON;92063;54503;28384;26119;1539;24580;MARILOSSIAN Jacques;M;MARILOSSIAN;Jacques;REM;15012
Législatives 2017 - 1er tour;Législatives;2017;1;8;8ème circonscription;22;CHAVILLE;92022;13523;5385;8138;93;8045;ROURE Françoise;F;ROURE;Françoise;RDG;381
Législatives 2017 - 1er tour;Législatives;2017;1;8;8ème circonscription;22;CHAVILLE;92022;13523;5385;8138;93;8045;PASQUELIN Nelly;F;PASQUELIN;Nelly;FI;813
Législatives 2017 - 1er tour;Législatives;2017;1;7;7ème circonscription;64;SAINT CLOUD;92064;19410;7490;11920;102;11818;MZOUGHI Olfa;F;MZOUGHI;Olfa;FI;435
Législatives 2017 - 1er tour;Législatives;2017;1;7;7ème circonscription;33;GARCHES;92033;12777;5514;7263;115;7148;GUERY Jérôme;M;GUERY;Jérôme;EXD;53
Législatives 2017 - 1er tour;Législatives;2017;1;1;1ère circonscription;78;VILLENEUVE LA GARENNE;92078;12445;8430;4015;143;3872;TOUMI Délia;F;TOUMI;Délia;ECO;60
Législatives 2017 - 1er tour;Législatives;2017;1;2;2ème circonscription;25;COLOMBES;92025;19668;8354;11314;229;11085;LAURENT Hadrien;M;LAURENT;Hadrien;RDG;72
Législatives 2017 - 1er tour;Législatives;2017;1;2;2ème circonscription;25;COLOMBES;92025;19668;8354;11314;229;11085;M'BAYE Arame;F;M'BAYE;Arame;DVD;5
Législatives 2017 - 1er tour;Législatives;2017;1;8;8ème circonscription;76;VAUCRESSON;92076;6187;2474;3713;42;3671;EPPLING Robin;M;EPPLING;Robin;DIV;59
Législatives 2017 - 1er tour;Législatives;2017;1;8;8ème circonscription;22;CHAVILLE;92022;13523;5385;8138;93;8045;PAILLARD Christophe;M;PAILLARD;Christophe;DVD;28
Législatives 2017 - 1er tour;Législatives;2017;1;8;8ème circonscription;22;CHAVILLE;92022;13523;5385;8138;93;8045;DUBOIS Renaud;M;DUBOIS;Renaud;ECO;415
Législatives 2017 - 1er tour;Législatives;2017;1;6;6ème circonscription;51;NEUILLY SUR SEINE;92051;37215;15249;21966;119;21847;ZAMECZKOWSKI Laurent;M;ZAMECZKOWSKI;Laurent;REM;8622
Législatives 2017 - 1er tour;Législatives;2017;1;10;10ème circonscription;48;MEUDON;92048;6009;2545;3464;38;3426;COUVENT Pauline;F;COUVENT;Pauline;ECO;188
Présidentielles 1995 - 1er tour;Présidentielles;1995;1;;;2;ANTONY;92002;37894;9274;28620;590;28030;LAGUILLER ARLETTE;F;LAGUILLER;ARLETTE;;1418
Présidentielles 1995 - 1er tour;Présidentielles;1995;1;;;2;ANTONY;92002;37894;9274;28620;590;28030;HUE ROBERT;M;HUE;ROBERT;;2065
Présidentielles 2002 - 1er tour;Présidentielles;2002;1;;;2;ANTONY;92002;36989;11047;25942;517;25425;MADELIN ALAIN;M;MADELIN;ALAIN;;1253
Présidentielles 2002 - 1er tour;Présidentielles;2002;1;;;4;ASNIERES SUR SEINE;92004;35702;11271;24431;515;23916;BESANCENOT OLIVIER;M;BESANCENOT;OLIVIER;;694
Présidentielles 2002 - 1er tour;Présidentielles;2002;1;;;9;BOIS COLOMBES;92009;13996;4554;9442;200;9242;LEPAGE CORINNE;F;LEPAGE;CORINNE;;244
Présidentielles 2002 - 1er tour;Présidentielles;2002;1;;;12;BOULOGNE BILLANCOURT;92012;57382;17570;39812;645;39167;MAMERE NOEL;M;MAMERE;NOEL;;1858
Présidentielles 2002 - 1er tour;Présidentielles;2002;1;;;22;CHAVILLE;92022;12122;3826;8296;162;8134;MEGRET BRUNO;M;MEGRET;BRUNO;;126
Présidentielles 2002 - 1er tour;Présidentielles;2002;1;;;22;CHAVILLE;92022;12122;3826;8296;162;8134;GLUCKSTEIN DANIEL;M;GLUCKSTEIN;DANIEL;;32
Présidentielles 2002 - 1er tour;Présidentielles;2002;1;;;22;CHAVILLE;92022;12122;3826;8296;162;8134;BAYROU FRANCOIS;M;BAYROU;FRANCOIS;;845
Présidentielles 2002 - 1er tour;Présidentielles;2002;1;;;25;COLOMBES;92025;39608;13654;25954;571;25383;HUE ROBERT;M;HUE;ROBERT;;1349
Présidentielles 2002 - 1er tour;Présidentielles;2002;1;;;26;COURBEVOIE;92026;39941;11959;27982;520;27462;CHEVENEMENT JEAN-PIERRE;M;CHEVENEMENT;JEAN-PIERRE;;1868
Présidentielles 2002 - 1er tour;Présidentielles;2002;1;;;33;GARCHES;92033;11708;3920;7788;137;7651;BAYROU FRANCOIS;M;BAYROU;FRANCOIS;;795
Présidentielles 2002 - 1er tour;Présidentielles;2002;1;;;33;GARCHES;92033;11708;3920;7788;137;7651;MADELIN ALAIN;M;MADELIN;ALAIN;;630
Présidentielles 2002 - 1er tour;Présidentielles;2002;1;;;35;LA GARENNE COLOMBES;92035;15006;5167;9839;227;9612;JOSPIN LIONEL;M;JOSPIN;LIONEL;;1394
Présidentielles 2002 - 1er tour;Présidentielles;2002;1;;;36;GENNEVILLIERS;92036;18213;6933;11280;303;10977;BAYROU FRANCOIS;M;BAYROU;FRANCOIS;;293
Présidentielles 2002 - 1er tour;Présidentielles;2002;1;;;36;GENNEVILLIERS;92036;18213;6933;11280;303;10977;MAMERE NOEL;M;MAMERE;NOEL;;794
Présidentielles 2002 - 1er tour;Présidentielles;2002;1;;;40;ISSY LES MOULINEAUX;92040;32059;9424;22635;510;22125;GLUCKSTEIN DANIEL;M;GLUCKSTEIN;DANIEL;;87
Présidentielles 2002 - 1er tour;Présidentielles;2002;1;;;44;LEVALLOIS PERRET;92044;33618;9640;23978;575;23403;BAYROU FRANCOIS;M;BAYROU;FRANCOIS;;2180
Présidentielles 2002 - 1er tour;Présidentielles;2002;1;;;44;LEVALLOIS PERRET;92044;33618;9640;23978;575;23403;CHEVENEMENT JEAN-PIERRE;M;CHEVENEMENT;JEAN-PIERRE;;1357
Présidentielles 2002 - 1er tour;Présidentielles;2002;1;;;46;MALAKOFF;92046;17268;6020;11248;271;10977;TAUBIRA CHRISTIANE;F;TAUBIRA;CHRISTIANE;;496
Présidentielles 2002 - 1er tour;Présidentielles;2002;1;;;46;MALAKOFF;92046;17268;6020;11248;271;10977;SAINT-JOSSE JEAN;M;SAINT-JOSSE;JEAN;;86
Présidentielles 2002 - 1er tour;Présidentielles;2002;1;;;47;MARNES LA COQUETTE;92047;997;272;725;7;718;JOSPIN LIONEL;M;JOSPIN;LIONEL;;67
Présidentielles 2002 - 1er tour;Présidentielles;2002;1;;;48;MEUDON;92048;28283;9341;18942;321;18621;LE PEN JEAN-MARIE;M;LE PEN;JEAN-MARIE;;2017
Présidentielles 2002 - 1er tour;Présidentielles;2002;1;;;49;MONTROUGE;92049;23382;8142;15240;301;14939;MEGRET BRUNO;M;MEGRET;BRUNO;;250
Présidentielles 2002 - 1er tour;Présidentielles;2002;1;;;51;NEUILLY SUR SEINE;92051;34066;10108;23958;309;23649;LAGUILLER ARLETTE;F;LAGUILLER;ARLETTE;;167
Présidentielles 2002 - 1er tour;Présidentielles;2002;1;;;64;SAINT CLOUD;92064;17818;6028;11790;141;11649;GLUCKSTEIN DANIEL;M;GLUCKSTEIN;DANIEL;;13
Présidentielles 2002 - 1er tour;Présidentielles;2002;1;;;73;SURESNES;92073;22099;7156;14943;329;14614;BOUTIN CHRISTINE;F;BOUTIN;CHRISTINE;;198
Présidentielles 2002 - 1er tour;Présidentielles;2002;1;;;75;VANVES;92075;15493;4648;10845;221;10624;MADELIN ALAIN;M;MADELIN;ALAIN;;539
Présidentielles 2002 - 1er tour;Présidentielles;2002;1;;;77;VILLE D'AVRAY;92077;7251;2486;4765;70;4695;LAGUILLER ARLETTE;F;LAGUILLER;ARLETTE;;67
Présidentielles 2007 - 1er tour;Présidentielles;2007;1;;;2;ANTONY;92002;39316;4695;34621;413;34208;BESANCENOT Olivier;M;BESANCENOT;Olivier;;862
Présidentielles 2007 - 1er tour;Présidentielles;2007;1;;;7;BAGNEUX;92007;20438;2809;17629;261;17368;BUFFET Marie-George;F;BUFFET;Marie-George;;1030
Présidentielles 2007 - 1er tour;Présidentielles;2007;1;;;9;BOIS COLOMBES;92009;16113;2534;13579;152;13427;VOYNET Dominique;F;VOYNET;Dominique;;217
Présidentielles 2007 - 1er tour;Présidentielles;2007;1;;;12;BOULOGNE BILLANCOURT;92012;64709;7685;57024;546;56478;SCHIVARDI Gérard;M;SCHIVARDI;Gérard;;50
Présidentielles 2007 - 1er tour;Présidentielles;2007;1;;;12;BOULOGNE BILLANCOURT;92012;64709;7685;57024;546;56478;ROYAL Ségolène;F;ROYAL;Ségolène;;11273
Présidentielles 2007 - 1er tour;Présidentielles;2007;1;;;14;BOURG LA REINE;92014;13108;1436;11672;90;11582;BUFFET Marie-George;F;BUFFET;Marie-George;;156
Présidentielles 2007 - 1er tour;Présidentielles;2007;1;;;14;BOURG LA REINE;92014;13108;1436;11672;90;11582;ROYAL Ségolène;F;ROYAL;Ségolène;;3086
Présidentielles 2007 - 1er tour;Présidentielles;2007;1;;;20;CHATILLON;92020;20466;2231;18235;177;18058;BUFFET Marie-George;F;BUFFET;Marie-George;;322
Présidentielles 2007 - 1er tour;Présidentielles;2007;1;;;23;CLAMART;92023;32539;3879;28660;293;28367;LE PEN Jean-Marie;M;LE PEN;Jean-Marie;;1712
Présidentielles 2007 - 1er tour;Présidentielles;2007;1;;;24;CLICHY;92024;28539;4472;24067;245;23822;BUFFET Marie-George;F;BUFFET;Marie-George;;364
Présidentielles 2007 - 1er tour;Présidentielles;2007;1;;;32;FONTENAY AUX ROSES;92032;15234;2027;13207;123;13084;BOVÉ José;M;BOVÉ;José;;114
Présidentielles 2007 - 1er tour;Présidentielles;2007;1;;;32;FONTENAY AUX ROSES;92032;15234;2027;13207;123;13084;LE PEN Jean-Marie;M;LE PEN;Jean-Marie;;667
Présidentielles 2007 - 1er tour;Présidentielles;2007;1;;;33;GARCHES;92033;11957;1346;10611;106;10505;LAGUILLER Arlette;F;LAGUILLER;Arlette;;56
Présidentielles 2007 - 1er tour;Présidentielles;2007;1;;;49;MONTROUGE;92049;26299;3093;23206;219;22987;ROYAL Ségolène;F;ROYAL;Ségolène;;7143
Présidentielles 2007 - 1er tour;Présidentielles;2007;1;;;51;NEUILLY SUR SEINE;92051;37647;4032;33615;154;33461;BOVÉ José;M;BOVÉ;José;;50
Présidentielles 2007 - 1er tour;Présidentielles;2007;1;;;62;PUTEAUX;92062;26761;3397;23364;263;23101;LAGUILLER Arlette;F;LAGUILLER;Arlette;;181
Présidentielles 2007 - 1er tour;Présidentielles;2007;1;;;76;VAUCRESSON;92076;5902;781;5121;42;5079;LE PEN Jean-Marie;M;LE PEN;Jean-Marie;;239
Présidentielles 2007 - 1er tour;Présidentielles;2007;1;;;77;VILLE D'AVRAY;92077;7253;672;6581;57;6524;ROYAL Ségolène;F;ROYAL;Ségolène;;1019
Présidentielles 1995 - 1er tour;Présidentielles;1995;1;;;20;CHATILLON;92020;16579;4065;12514;245;12269;BALLADUR EDOUARD;M;BALLADUR;EDOUARD;;2042
Présidentielles 1995 - 1er tour;Présidentielles;1995;1;;;24;CLICHY;92024;24688;6820;17868;364;17504;CHEMINADE JACQUES;M;CHEMINADE;JACQUES;;38
Présidentielles 1995 - 1er tour;Présidentielles;1995;1;;;32;FONTENAY AUX ROSES;92032;14917;3559;11358;196;11162;CHEMINADE JACQUES;M;CHEMINADE;JACQUES;;26
Présidentielles 1995 - 1er tour;Présidentielles;1995;1;;;47;MARNES LA COQUETTE;92047;1003;227;776;11;765;LE PEN J.MARIE;M;LE PEN;J.MARIE;;63
Présidentielles 1995 - 1er tour;Présidentielles;1995;1;;;49;MONTROUGE;92049;22293;5924;16369;314;16055;CHIRAC JACQUES;M;CHIRAC;JACQUES;;4009
Présidentielles 1995 - 1er tour;Présidentielles;1995;1;;;49;MONTROUGE;92049;22293;5924;16369;314;16055;LAGUILLER ARLETTE;F;LAGUILLER;ARLETTE;;865
Présidentielles 1995 - 1er tour;Présidentielles;1995;1;;;63;RUEIL MALMAISON;92063;44438;10571;33867;718;33149;CHIRAC JACQUES;M;CHIRAC;JACQUES;;9092
Présidentielles 1995 - 1er tour;Présidentielles;1995;1;;;78;VILLENEUVE LA GARENNE;92078;11588;3130;8458;196;8262;JOSPIN LIONEL;M;JOSPIN;LIONEL;;1940
Présidentielles 2002 - 2ème tour;Présidentielles;2002;2;;;47;MARNES LA COQUETTE;92047;998;127;871;19;852;CHIRAC JACQUES;M;CHIRAC;JACQUES;;729
Présidentielles 2002 - 2ème tour;Présidentielles;2002;2;;;72;SEVRES;92072;13374;2151;11223;295;10928;CHIRAC JACQUES;M;CHIRAC;JACQUES;;9859
Présidentielles 1995 - 2ème tour;Présidentielles;1995;2;;;14;BOURG LA REINE;92014;12770;2754;10016;404;9612;CHIRAC JACQUES;M;CHIRAC;JACQUES;;5930
Présidentielles 1995 - 2ème tour;Présidentielles;1995;2;;;24;CLICHY;92024;24688;6360;18328;900;17428;JOSPIN LIONEL;M;JOSPIN;LIONEL;;8762
Présidentielles 1995 - 2ème tour;Présidentielles;1995;2;;;71;SCEAUX;92071;13361;2314;11047;395;10652;CHIRAC JACQUES;M;CHIRAC;JACQUES;;6770
Législatives 2007 - 1er tour;Législatives;2007;1;1;1ère circonscription;78;VILLENEUVE LA GARENNE;92078;13038;7211;5827;131;5696;DARRACQ Michel;M;DARRACQ;Michel;DIV;0
Législatives 2007 - 2ème tour;Législatives;2007;2;12;12ème circonscription;20;CHATILLON;92020;20661;7902;12759;273;12486;KALTENBACH Philippe;M;KALTENBACH;Philippe;SOC;6028
Législatives 2007 - 1er tour;Législatives;2007;1;1;1ère circonscription;78;VILLENEUVE LA GARENNE;92078;13038;7211;5827;131;5696;LE GAL Anna;F;LE GAL;Anna;ECO;64
Législatives 2007 - 2ème tour;Législatives;2007;2;4;4ème circonscription;73;SURESNES;92073;24666;10165;14501;476;14025;FRAYSSE Jacqueline;F;FRAYSSE;Jacqueline;COM;5405
Présidentielles 2017 - 1er tour;Présidentielles;2017;1;;;14;BOURG LA REINE;92014;13769;2202;11567;212;11355;DUPONT-AIGNAN Nicolas;M;DUPONT-AIGNAN;Nicolas;;292
Présidentielles 2017 - 1er tour;Présidentielles;2017;1;;;19;CHATENAY MALABRY;92019;18708;3336;15372;454;14918;DUPONT-AIGNAN Nicolas;M;DUPONT-AIGNAN;Nicolas;;511
Présidentielles 2017 - 1er tour;Présidentielles;2017;1;;;20;CHATILLON;92020;22292;3682;18610;351;18259;ASSELINEAU François;M;ASSELINEAU;François;;184
Présidentielles 2017 - 1er tour;Présidentielles;2017;1;;;22;CHAVILLE;92022;13493;2042;11451;183;11267;ARTHAUD Nathalie;F;ARTHAUD;Nathalie;;33
Présidentielles 2017 - 1er tour;Présidentielles;2017;1;;;23;CLAMART;92023;35291;6330;28961;560;28401;ASSELINEAU François;M;ASSELINEAU;François;;296
Présidentielles 2017 - 1er tour;Présidentielles;2017;1;;;33;GARCHES;92033;12767;1975;10792;194;10598;MÉLENCHON Jean-Luc;M;MÉLENCHON;Jean-Luc;;1016
Présidentielles 2017 - 1er tour;Présidentielles;2017;1;;;36;GENNEVILLIERS;92036;22149;5526;16623;490;16133;ARTHAUD Nathalie;F;ARTHAUD;Nathalie;;105
Présidentielles 2017 - 1er tour;Présidentielles;2017;1;;;40;ISSY LES MOULINEAUX;92040;46800;9050;37750;728;37022;FILLON François;M;FILLON;François;;9798
Présidentielles 2017 - 1er tour;Présidentielles;2017;1;;;46;MALAKOFF;92046;18434;3186;15248;268;14979;MÉLENCHON Jean-Luc;M;MÉLENCHON;Jean-Luc;;4916
Présidentielles 2017 - 1er tour;Présidentielles;2017;1;;;49;MONTROUGE;92049;28899;4312;24587;429;24158;CHEMINADE Jacques;M;CHEMINADE;Jacques;;34
Présidentielles 2017 - 1er tour;Présidentielles;2017;1;;;51;NEUILLY SUR SEINE;92051;37184;4180;33004;212;32792;ASSELINEAU François;M;ASSELINEAU;François;;101
Présidentielles 2017 - 1er tour;Présidentielles;2017;1;;;51;NEUILLY SUR SEINE;92051;37184;4180;33004;212;32792;DUPONT-AIGNAN Nicolas;M;DUPONT-AIGNAN;Nicolas;;380
Présidentielles 2017 - 1er tour;Présidentielles;2017;1;;;51;NEUILLY SUR SEINE;92051;37184;4180;33004;212;32792;LE PEN Marine;F;LE PEN;Marine;;1183
Présidentielles 2017 - 1er tour;Présidentielles;2017;1;;;62;PUTEAUX;92062;28950;4530;24420;549;23871;FILLON François;M;FILLON;François;;6677
Présidentielles 2017 - 1er tour;Présidentielles;2017;1;;;62;PUTEAUX;92062;28950;4530;24420;549;23871;HAMON Benoît;M;HAMON;Benoît;;1551
Présidentielles 2017 - 1er tour;Présidentielles;2017;1;;;63;RUEIL MALMAISON;92063;54426;9298;45128;713;44414;CHEMINADE Jacques;M;CHEMINADE;Jacques;;95
Présidentielles 2017 - 1er tour;Présidentielles;2017;1;;;64;SAINT CLOUD;92064;19370;2628;16742;186;16556;ASSELINEAU François;M;ASSELINEAU;François;;121
Présidentielles 2017 - 1er tour;Présidentielles;2017;1;;;64;SAINT CLOUD;92064;19370;2628;16742;186;16556;POUTOU Philippe;M;POUTOU;Philippe;;59
Présidentielles 2017 - 1er tour;Présidentielles;2017;1;;;71;SCEAUX;92071;15052;2914;12138;145;11993;POUTOU Philippe;M;POUTOU;Philippe;;59
Présidentielles 2017 - 1er tour;Présidentielles;2017;1;;;75;VANVES;92075;18500;3228;15272;248;15024;LE PEN Marine;F;LE PEN;Marine;;945
Présidentielles 2012 - 1er tour;Présidentielles;2012;1;;;2;ANTONY;92002;40169;7755;32414;674;31740;HOLLANDE François;M;HOLLANDE;François;;9877
Présidentielles 2012 - 1er tour;Présidentielles;2012;1;;;7;BAGNEUX;92007;20608;4687;15921;281;15640;POUTOU Philippe;M;POUTOU;Philippe;;175
Présidentielles 2012 - 1er tour;Présidentielles;2012;1;;;20;CHATILLON;92020;21656;4298;17358;265;17093;CHEMINADE Jacques;M;CHEMINADE;Jacques;;43
Présidentielles 2012 - 1er tour;Présidentielles;2012;1;;;23;CLAMART;92023;34131;6740;27391;417;26974;LE PEN Marine;F;LE PEN;Marine;;2665
Présidentielles 2012 - 1er tour;Présidentielles;2012;1;;;35;LA GARENNE COLOMBES;92035;17300;3509;13791;212;13579;HOLLANDE François;M;HOLLANDE;François;;3492
Présidentielles 2012 - 1er tour;Présidentielles;2012;1;;;40;ISSY LES MOULINEAUX;92040;41994;9488;32506;521;31985;LE PEN Marine;F;LE PEN;Marine;;2487
Présidentielles 2012 - 1er tour;Présidentielles;2012;1;;;46;MALAKOFF;92046;18852;4162;14690;207;14483;HOLLANDE François;M;HOLLANDE;François;;5292
Présidentielles 2012 - 1er tour;Présidentielles;2012;1;;;48;MEUDON;92048;30572;6341;24231;318;23913;JOLY Eva;F;JOLY;Eva;;755
Présidentielles 2012 - 1er tour;Présidentielles;2012;1;;;49;MONTROUGE;92049;27851;5527;22324;289;22035;HOLLANDE François;M;HOLLANDE;François;;7840
Présidentielles 2012 - 1er tour;Présidentielles;2012;1;;;63;RUEIL MALMAISON;92063;52385;10540;41845;580;41265;ARTHAUD Nathalie;F;ARTHAUD;Nathalie;;109
Présidentielles 2012 - 1er tour;Présidentielles;2012;1;;;64;SAINT CLOUD;92064;18973;3529;15444;153;15291;CHEMINADE Jacques;M;CHEMINADE;Jacques;;30
Présidentielles 2012 - 1er tour;Présidentielles;2012;1;;;78;VILLENEUVE LA GARENNE;92078;12332;3328;9004;225;8779;ARTHAUD Nathalie;F;ARTHAUD;Nathalie;;42
Présidentielles 2017 - 2ème tour;Présidentielles;2017;2;;;22;CHAVILLE;92022;13493;2674;10819;949;9870;LE PEN Marine;F;LE PEN;Marine;;1414
Présidentielles 2012 - 2ème tour;Présidentielles;2012;2;;;25;COLOMBES;92025;44746;8475;36271;1433;34838;HOLLANDE François;M;HOLLANDE;François;;20382
Présidentielles 2012 - 2ème tour;Présidentielles;2012;2;;;44;LEVALLOIS PERRET;92044;39523;6219;33304;1154;32150;SARKOZY Nicolas;M;SARKOZY;Nicolas;;20359
Présidentielles 2012 - 2ème tour;Présidentielles;2012;2;;;72;SEVRES;92072;14855;2358;12497;522;11975;HOLLANDE François;M;HOLLANDE;François;;5769
Présidentielles 2012 - 2ème tour;Présidentielles;2012;2;;;72;SEVRES;92072;14855;2358;12497;522;11975;SARKOZY Nicolas;M;SARKOZY;Nicolas;;6206
Présidentielles 2007 - 2ème tour;Présidentielles;2007;2;;;19;CHATENAY MALABRY;92019;17599;2412;15187;633;14554;SARKOZY Nicolas;M;SARKOZY;Nicolas;;6874
Présidentielles 2007 - 2ème tour;Présidentielles;2007;2;;;75;VANVES;92075;17143;2248;14895;572;14323;SARKOZY Nicolas;M;SARKOZY;Nicolas;;7061
Législatives 2007 - 1er tour;Législatives;2007;1;2;2ème circonscription;4;ASNIERES SUR SEINE;92004;44110;17783;26327;312;26015;TRUPIN Laurent;M;TRUPIN;Laurent;UDFD;2648
Législatives 2007 - 1er tour;Législatives;2007;1;12;12ème circonscription;60;LE PLESSIS ROBINSON;92060;16776;5588;11188;123;11065;ANTZENBERGER Philippe;M;ANTZENBERGER;Philippe;EXG;191
Législatives 2007 - 1er tour;Législatives;2007;1;10;10ème circonscription;40;ISSY LES MOULINEAUX;92040;38520;14017;24503;359;24144;VENTURINI Jean-Michel;M;VENTURINI;Jean-Michel;DIV;20
Législatives 2007 - 1er tour;Législatives;2007;1;10;10ème circonscription;40;ISSY LES MOULINEAUX;92040;38520;14017;24503;359;24144;GINISTY Christophe;M;GINISTY;Christophe;UDFD;3256
Législatives 2007 - 1er tour;Législatives;2007;1;10;10ème circonscription;40;ISSY LES MOULINEAUX;92040;38520;14017;24503;359;24144;ALEZARD Lysiane;F;ALEZARD;Lysiane;COM;447
Législatives 2007 - 1er tour;Législatives;2007;1;3;3ème circonscription;35;LA GARENNE COLOMBES;92035;16552;5947;10605;101;10504;CARILLON Rémi;M;CARILLON;Rémi;FN;329
Législatives 2007 - 1er tour;Législatives;2007;1;3;3ème circonscription;26;COURBEVOIE;92026;49151;19345;29806;541;29265;BARNONCEL Michel;M;BARNONCEL;Michel;VEC;882
Législatives 2007 - 1er tour;Législatives;2007;1;9;9ème circonscription;12;BOULOGNE BILLANCOURT;92012;60773;22422;38351;535;37816;BOLLIET Marie-Pierre;F;BOLLIET;Marie-Pierre;DIV;30
Législatives 2007 - 1er tour;Législatives;2007;1;13;13ème circonscription;14;BOURG LA REINE;92014;13381;4391;8990;78;8912;HOLLEBEKE Dominique;F;HOLLEBEKE;Dominique;MPF;126
Législatives 2007 - 1er tour;Législatives;2007;1;9;9ème circonscription;12;BOULOGNE BILLANCOURT;92012;60773;22422;38351;535;37816;COTTEN Christian;M;COTTEN;Christian;DIV;199
Législatives 2007 - 1er tour;Législatives;2007;1;10;10ème circonscription;12;BOULOGNE BILLANCOURT;92012;5551;2367;3184;78;3106;ALEZARD Lysiane;F;ALEZARD;Lysiane;COM;104
Législatives 2007 - 1er tour;Législatives;2007;1;13;13ème circonscription;14;BOURG LA REINE;92014;13381;4391;8990;78;8912;LEPEUVE Stéphane;M;LEPEUVE;Stéphane;EXG;170
Législatives 2007 - 1er tour;Législatives;2007;1;13;13ème circonscription;14;BOURG LA REINE;92014;13381;4391;8990;78;8912;BENLOLO Martine;F;BENLOLO;Martine;EXG;28
Législatives 2007 - 1er tour;Législatives;2007;1;8;8ème circonscription;22;CHAVILLE;92022;12928;4682;8246;120;8126;RUSSO Annick;F;RUSSO;Annick;DIV;8
Législatives 2007 - 1er tour;Législatives;2007;1;2;2ème circonscription;25;COLOMBES;92025;18336;7144;11192;207;10985;FRAGER Dominique;M;FRAGER;Dominique;VEC;468
Législatives 2007 - 1er tour;Législatives;2007;1;1;1ère circonscription;25;COLOMBES;92025;26192;12273;13919;366;13553;MUZEAU Roland;M;MUZEAU;Roland;COM;2003
Législatives 2007 - 1er tour;Législatives;2007;1;7;7ème circonscription;63;RUEIL MALMAISON;92063;51481;18902;32579;337;32242;TERRAZZONI Valérie;F;TERRAZZONI;Valérie;DIV;178
Législatives 2007 - 1er tour;Législatives;2007;1;7;7ème circonscription;63;RUEIL MALMAISON;92063;51481;18902;32579;337;32242;PIJOAN David;M;PIJOAN;David;EXG;505
Législatives 2007 - 1er tour;Législatives;2007;1;7;7ème circonscription;63;RUEIL MALMAISON;92063;51481;18902;32579;337;32242;CROS André;M;CROS;André;UDFD;3951
Législatives 2007 - 1er tour;Législatives;2007;1;7;7ème circonscription;64;SAINT CLOUD;92064;19115;6812;12303;93;12210;NAERT Jeannine;F;NAERT;Jeannine;FN;503
Législatives 2007 - 1er tour;Législatives;2007;1;8;8ème circonscription;72;SEVRES;92072;14460;5279;9181;151;9030;BLANCHARD Luc;M;BLANCHARD;Luc;VEC;462
Législatives 1993 - 1er tour;Législatives;1993;1;3;3ème circonscription;35;LA GARENNE COLOMBES;92035;13664;4290;9374;347;9027;ROUSSEL PIERRE;M;ROUSSEL;PIERRE;SOC;1692
Législatives 1993 - 1er tour;Législatives;1993;1;2;2ème circonscription;25;COLOMBES;92025;18324;5870;12454;434;12020;TAITTINGER FRANTZ;M;TAITTINGER;FRANTZ;DVD;1493
Législatives 1993 - 1er tour;Législatives;1993;1;8;8ème circonscription;77;VILLE D'AVRAY;92077;7199;1786;5413;149;5264;JASSERAND BERNARD;M;JASSERAND;BERNARD;COM;112
Législatives 1993 - 1er tour;Législatives;1993;1;8;8ème circonscription;76;VAUCRESSON;92076;5515;1574;3941;93;3848;GODICHEAU PIERRE;M;GODICHEAU;PIERRE;DVD;34
Législatives 1993 - 1er tour;Législatives;1993;1;8;8ème circonscription;76;VAUCRESSON;92076;5515;1574;3941;93;3848;NICOLAS PATRICK;M;NICOLAS;PATRICK;DVD;16
Législatives 1993 - 1er tour;Législatives;1993;1;8;8ème circonscription;77;VILLE D'AVRAY;92077;7199;1786;5413;149;5264;WOLF HENRY;M;WOLF;HENRY;UDF;1460
Législatives 1993 - 1er tour;Législatives;1993;1;5;5ème circonscription;24;CLICHY;92024;25172;9290;15882;514;15368;PERCEVAULT RICHARD;M;PERCEVAULT;RICHARD;EXG;229
Législatives 1993 - 1er tour;Législatives;1993;1;1;1ère circonscription;25;COLOMBES;92025;26594;9512;17082;693;16389;LEOPOLD CHANTAL;F;LEOPOLD;CHANTAL;SOC;1220
Législatives 1993 - 1er tour;Législatives;1993;1;1;1ère circonscription;78;VILLENEUVE LA GARENNE;92078;11604;4168;7436;212;7224;RANAIVOSON BRIGITTE;F;RANAIVOSON;BRIGITTE;DIV;111
Législatives 1993 - 2ème tour;Législatives;1993;2;13;13ème circonscription;14;BOURG LA REINE;92014;12748;4405;8343;506;7837;DEVEDJIAN PATRICK;M;DEVEDJIAN;PATRICK;RPR;4976
Législatives 1993 - 1er tour;Législatives;1993;1;8;8ème circonscription;77;VILLE D'AVRAY;92077;7199;1786;5413;149;5264;BRISSAUD SOPHIE;F;BRISSAUD;SOPHIE;FRN;449
Législatives 1993 - 2ème tour;Législatives;1993;2;3;3ème circonscription;9;BOIS COLOMBES;92009;14392;4776;9616;707;8909;HABY J.YVES;M;HABY;J.YVES;UDF;5750
Législatives 1993 - 1er tour;Législatives;1993;1;8;8ème circonscription;76;VAUCRESSON;92076;5515;1574;3941;93;3848;SUCHIER ANDRE;M;SUCHIER;ANDRE;DIV;66
Législatives 1993 - 1er tour;Législatives;1993;1;10;10ème circonscription;75;VANVES;92075;15286;4324;10962;394;10568;SANTINI ANDRE;M;SANTINI;ANDRE;UDF;4879
Législatives 1993 - 1er tour;Législatives;1993;1;8;8ème circonscription;72;SEVRES;92072;13536;3690;9846;336;9510;FIEVET ALAIN;M;FIEVET;ALAIN;SOC;100
Législatives 1993 - 1er tour;Législatives;1993;1;2;2ème circonscription;4;ASNIERES SUR SEINE;92004;37314;11544;25770;852;24918;TAITTINGER FRANTZ;M;TAITTINGER;FRANTZ;DVD;5157
Législatives 1993 - 1er tour;Législatives;1993;1;7;7ème circonscription;63;RUEIL MALMAISON;92063;42219;12104;30115;1049;29066;PACOURET J.RAYMOND;M;PACOURET;J.RAYMOND;COM;1678
Législatives 1993 - 1er tour;Législatives;1993;1;8;8ème circonscription;22;CHAVILLE;92022;12345;3904;8441;296;8145;FIEVET ALAIN;M;FIEVET;ALAIN;SOC;88
Législatives 1993 - 1er tour;Législatives;1993;1;10;10ème circonscription;40;ISSY LES MOULINEAUX;92040;29377;9425;19952;648;19304;WALLE JOCELYNE;F;WALLE;JOCELYNE;DIV;302
Législatives 1993 - 1er tour;Législatives;1993;1;8;8ème circonscription;48;MEUDON;92048;25126;7628;17498;529;16969;JASSERAND BERNARD;M;JASSERAND;BERNARD;COM;1102
Législatives 1997 - 1er tour;Législatives;1997;1;2;2ème circonscription;4;ASNIERES SUR SEINE;92004;37154;13729;23425;737;22688;LAIGLE CATHERINE;F;LAIGLE;CATHERINE;COM;1396
Législatives 2012 - 1er tour;Législatives;2012;1;13;13ème circonscription;2;ANTONY;92002;40941;15088;25853;361;25492;CASSIA Paul;M;CASSIA;Paul;CEN;912
Législatives 2012 - 1er tour;Législatives;2012;1;11;11ème circonscription;7;BAGNEUX;92007;20609;9648;10961;145;10816;ROUILLAC Jean-Paul;M;ROUILLAC;Jean-Paul;EXG;17
Législatives 2012 - 1er tour;Législatives;2012;1;11;11ème circonscription;7;BAGNEUX;92007;20609;9648;10961;145;10816;LE DEVEHAT Jean-Luc;M;LE DEVEHAT;Jean-Luc;EXG;33
Législatives 2012 - 1er tour;Législatives;2012;1;3;3ème circonscription;9;BOIS COLOMBES;92009;16783;6763;10020;331;9689;LE GUENNIOU Anne;F;LE GUENNIOU;Anne;VEC;438
Législatives 2012 - 1er tour;Législatives;2012;1;3;3ème circonscription;9;BOIS COLOMBES;92009;16783;6763;10020;331;9689;FRATELLIA Jacques;M;FRATELLIA;Jacques;AUT;49
Législatives 2012 - 1er tour;Législatives;2012;1;3;3ème circonscription;9;BOIS COLOMBES;92009;16783;6763;10020;331;9689;DENIAU Floriane;F;DENIAU;Floriane;FN;593
Législatives 2012 - 1er tour;Législatives;2012;1;9;9ème circonscription;12;BOULOGNE BILLANCOURT;92012;61020;24579;36441;340;36101;PINEAU Dorothée;F;PINEAU;Dorothée;DVD;1691
Législatives 2012 - 1er tour;Législatives;2012;1;12;12ème circonscription;20;CHATILLON;92020;21681;8265;13416;122;13294;PEMEZEC Philippe;M;PEMEZEC;Philippe;UMP;4942
Législatives 2012 - 1er tour;Législatives;2012;1;2;2ème circonscription;25;COLOMBES;92025;18458;7115;11343;114;11229;POURBAGHER Francis;M;POURBAGHER;Francis;DVD;144
Législatives 2012 - 1er tour;Législatives;2012;1;3;3ème circonscription;35;LA GARENNE COLOMBES;92035;17314;7036;10278;79;10199;GOURDOL Aimée;F;GOURDOL;Aimée;DVG;81
Législatives 2012 - 1er tour;Législatives;2012;1;1;1ère circonscription;36;GENNEVILLIERS;92036;20795;10523;10272;192;10080;MUZEAU Roland;M;MUZEAU;Roland;FG;5174
Législatives 2012 - 1er tour;Législatives;2012;1;5;5ème circonscription;44;LEVALLOIS PERRET;92044;39546;14667;24879;238;24641;ATLANI Alexis;M;ATLANI;Alexis;AUT;135
Législatives 2012 - 1er tour;Législatives;2012;1;5;5ème circonscription;44;LEVALLOIS PERRET;92044;39546;14667;24879;238;24641;MORVAN François;M;MORVAN;François;DVD;121
Législatives 2012 - 1er tour;Législatives;2012;1;8;8ème circonscription;47;MARNES LA COQUETTE;92047;1085;330;755;2;753;SALA Emmanuel;M;SALA;Emmanuel;DVD;11
Législatives 2012 - 1er tour;Législatives;2012;1;8;8ème circonscription;48;MEUDON;92048;25002;9709;15293;150;15143;SEGUI Miguel;M;SEGUI;Miguel;EXG;55
Législatives 2012 - 1er tour;Législatives;2012;1;8;8ème circonscription;48;MEUDON;92048;25002;9709;15293;150;15143;SALA Emmanuel;M;SALA;Emmanuel;DVD;82
Législatives 2012 - 1er tour;Législatives;2012;1;4;4ème circonscription;50;NANTERRE;92050;44344;21046;23298;337;22961;FRAYSSE Jacqueline;F;FRAYSSE;Jacqueline;FG;9144
Législatives 2012 - 1er tour;Législatives;2012;1;7;7ème circonscription;64;SAINT CLOUD;92064;19029;7431;11598;97;11501;LAPORTE Lucia;F;LAPORTE;Lucia;FN;955
Législatives 2012 - 1er tour;Législatives;2012;1;8;8ème circonscription;72;SEVRES;92072;14861;5785;9076;101;8975;SALA Emmanuel;M;SALA;Emmanuel;DVD;59
Législatives 2012 - 1er tour;Législatives;2012;1;8;8ème circonscription;76;VAUCRESSON;92076;6093;2463;3630;39;3591;GUILLET Jean-Jacques;M;GUILLET;Jean-Jacques;UMP;1787
Législatives 2012 - 1er tour;Législatives;2012;1;8;8ème circonscription;76;VAUCRESSON;92076;6093;2463;3630;39;3591;SALA Emmanuel;M;SALA;Emmanuel;DVD;30
Législatives 2012 - 1er tour;Législatives;2012;1;8;8ème circonscription;77;VILLE D'AVRAY;92077;7169;2468;4701;48;4653;VIERA Lydia;F;VIERA;Lydia;ECO;7
Législatives 2002 - 1er tour;Législatives;2002;1;13;13ème circonscription;2;ANTONY;92002;39807;13942;25865;456;25409;BASTIDE Anne;F;BASTIDE;Anne;ECO;45
Législatives 2002 - 1er tour;Législatives;2002;1;13;13ème circonscription;14;BOURG LA REINE;92014;13381;4391;8990;78;8912;IORIO Catherine;F;IORIO;Catherine;FN;263
Législatives 2002 - 1er tour;Législatives;2002;1;13;13ème circonscription;19;CHATENAY MALABRY;92019;17835;6584;11251;211;11040;BENLOLO Martine;F;BENLOLO;Martine;EXG;47
Législatives 2002 - 1er tour;Législatives;2002;1;8;8ème circonscription;22;CHAVILLE;92022;12928;4682;8246;120;8126;FILLOUX Delphine;F;FILLOUX;Delphine;DIV;94
Législatives 2002 - 1er tour;Législatives;2002;1;8;8ème circonscription;22;CHAVILLE;92022;12928;4682;8246;120;8126;GUILLET Jean-Jacques;M;GUILLET;Jean-Jacques;UMP;3634
Législatives 2002 - 1er tour;Législatives;2002;1;8;8ème circonscription;22;CHAVILLE;92022;12928;4682;8246;120;8126;LEGRAND Pauline;F;LEGRAND;Pauline;EXD;41
Législatives 2017 - 1er tour;Législatives;2017;1;1;1ère circonscription;36;GENNEVILLIERS;92036;22174;13223;8951;243;8708;CLAUX Bertille;F;CLAUX;Bertille;UDI;0
Législatives 2017 - 1er tour;Législatives;2017;1;1;1ère circonscription;36;GENNEVILLIERS;92036;22174;13223;8951;243;8708;BRETON Michel;M;BRETON;Michel;EXG;90
Législatives 2017 - 1er tour;Législatives;2017;1;6;6ème circonscription;51;NEUILLY SUR SEINE;92051;37215;15249;21966;119;21847;CHEVIGNARD Grégoire;M;CHEVIGNARD;Grégoire;DIV;34
Législatives 2017 - 1er tour;Législatives;2017;1;6;6ème circonscription;62;PUTEAUX;92062;28983;11794;17189;436;16753;CHEVIGNARD Grégoire;M;CHEVIGNARD;Grégoire;DIV;94
Législatives 2017 - 1er tour;Législatives;2017;1;5;5ème circonscription;24;CLICHY;92024;28620;14628;13992;265;13727;MONJOU Jean-Jacques;M;MONJOU;Jean-Jacques;DVD;79
Législatives 2017 - 1er tour;Législatives;2017;1;4;4ème circonscription;50;NANTERRE;92050;47651;26455;21196;432;20764;LE BAUT Anne;F;LE BAUT;Anne;EXD;67
Législatives 2017 - 1er tour;Législatives;2017;1;2;2ème circonscription;25;COLOMBES;92025;19668;8354;11314;229;11085;PRADIER Liliane;F;PRADIER;Liliane;FN;510
Législatives 2017 - 1er tour;Législatives;2017;1;3;3ème circonscription;26;COURBEVOIE;92026;44322;19890;24432;415;24017;SPIRI Jean;M;SPIRI;Jean;LR;6523
Législatives 2017 - 1er tour;Législatives;2017;1;11;11ème circonscription;46;MALAKOFF;92046;18448;8148;10300;133;10167;RAMONET Pascal;M;RAMONET;Pascal;DIV;1
Législatives 2017 - 1er tour;Législatives;2017;1;11;11ème circonscription;46;MALAKOFF;92046;18448;8148;10300;133;10167;ROSSI Laurianne;F;ROSSI;Laurianne;REM;3410
Législatives 2017 - 1er tour;Législatives;2017;1;12;12ème circonscription;23;CLAMART;92023;35342;15954;19388;238;19150;BERNARD Yann;M;BERNARD;Yann;EXG;72
Législatives 2017 - 1er tour;Législatives;2017;1;12;12ème circonscription;32;FONTENAY AUX ROSES;92032;16049;7756;8293;93;8200;BUCHOT Clarisse;F;BUCHOT;Clarisse;DIV;10
Législatives 2017 - 1er tour;Législatives;2017;1;12;12ème circonscription;32;FONTENAY AUX ROSES;92032;16049;7756;8293;93;8200;CAMARA Makhtar;M;CAMARA;Makhtar;DVD;14
Législatives 2017 - 1er tour;Législatives;2017;1;12;12ème circonscription;60;LE PLESSIS ROBINSON;92060;19154;7496;11658;130;11528;BOURLANGES Jean-Louis;M;BOURLANGES;Jean-Louis;MDM;3865
Législatives 2017 - 1er tour;Législatives;2017;1;13;13ème circonscription;14;BOURG LA REINE;92014;13736;5356;8380;81;8299;PINÇON-CHARLOT Monique;F;PINÇON-CHARLOT;Monique;DVG;462
Législatives 2017 - 2ème tour;Législatives;2017;2;6;6ème circonscription;62;PUTEAUX;92062;28983;13852;15131;1602;13529;ZAMECZKOWSKI Laurent;M;ZAMECZKOWSKI;Laurent;REM;7464
Législatives 2017 - 2ème tour;Législatives;2017;2;13;13ème circonscription;19;CHATENAY MALABRY;92019;18752;9486;9266;806;8460;SIFFREDI Georges;M;SIFFREDI;Georges;LR;3951
Législatives 2017 - 1er tour;Législatives;2017;1;10;10ème circonscription;40;ISSY LES MOULINEAUX;92040;45375;19009;26366;517;25849;COSTE Jeremy;M;COSTE;Jeremy;UDI;5968
Législatives 2017 - 1er tour;Législatives;2017;1;10;10ème circonscription;48;MEUDON;92048;6009;2545;3464;38;3426;VIGNON Anne-Violaine;F;VIGNON;Anne-Violaine;DVD;51
Législatives 2017 - 1er tour;Législatives;2017;1;7;7ème circonscription;63;RUEIL MALMAISON;92063;54498;24335;30163;377;29786;HANNOUF Noureddine;M;HANNOUF;Noureddine;DVD;132
Législatives 2017 - 1er tour;Législatives;2017;1;7;7ème circonscription;63;RUEIL MALMAISON;92063;54498;24335;30163;377;29786;BERTHAULT Grégory;M;BERTHAULT;Grégory;ECO;446
Législatives 2017 - 1er tour;Législatives;2017;1;8;8ème circonscription;47;MARNES LA COQUETTE;92047;1215;451;764;4;760;ROURE Françoise;F;ROURE;Françoise;RDG;5
Législatives 2017 - 1er tour;Législatives;2017;1;8;8ème circonscription;22;CHAVILLE;92022;13523;5385;8138;93;8045;MEROUCHI Sandra;F;MEROUCHI;Sandra;DIV;61
Législatives 2017 - 1er tour;Législatives;2017;1;1;1ère circonscription;78;VILLENEUVE LA GARENNE;92078;12445;8430;4015;143;3872;BEN M'BAREK Hassan;M;BEN M'BAREK;Hassan;DIV;11
Présidentielles 1995 - 1er tour;Présidentielles;1995;1;;;22;CHAVILLE;92022;12177;2870;9307;170;9137;CHIRAC JACQUES;M;CHIRAC;JACQUES;;2270
Présidentielles 1995 - 1er tour;Présidentielles;1995;1;;;23;CLAMART;92023;31229;8419;22810;457;22353;JOSPIN LIONEL;M;JOSPIN;LIONEL;;5549
Présidentielles 1995 - 1er tour;Présidentielles;1995;1;;;33;GARCHES;92033;11689;2941;8748;172;8576;VILLIERS DE PHILIPPE;M;VILLIERS DE;PHILIPPE;;377
Présidentielles 1995 - 1er tour;Présidentielles;1995;1;;;33;GARCHES;92033;11689;2941;8748;172;8576;CHIRAC JACQUES;M;CHIRAC;JACQUES;;2766
Présidentielles 1995 - 1er tour;Présidentielles;1995;1;;;33;GARCHES;92033;11689;2941;8748;172;8576;JOSPIN LIONEL;M;JOSPIN;LIONEL;;1607
Présidentielles 1995 - 1er tour;Présidentielles;1995;1;;;35;LA GARENNE COLOMBES;92035;14104;3637;10467;225;10242;LE PEN J.MARIE;M;LE PEN;J.MARIE;;1301
Présidentielles 1995 - 1er tour;Présidentielles;1995;1;;;36;GENNEVILLIERS;92036;19543;5563;13980;326;13654;HUE ROBERT;M;HUE;ROBERT;;3236
Présidentielles 1995 - 1er tour;Présidentielles;1995;1;;;48;MEUDON;92048;29714;7851;21863;352;21511;HUE ROBERT;M;HUE;ROBERT;;1345
Présidentielles 1995 - 1er tour;Présidentielles;1995;1;;;50;NANTERRE;92050;46920;11548;35372;736;34636;LE PEN J.MARIE;M;LE PEN;J.MARIE;;5186
Présidentielles 1995 - 1er tour;Présidentielles;1995;1;;;73;SURESNES;92073;21968;5851;16117;341;15776;VILLIERS DE PHILIPPE;M;VILLIERS DE;PHILIPPE;;496
Présidentielles 1995 - 1er tour;Présidentielles;1995;1;;;73;SURESNES;92073;21968;5851;16117;341;15776;HUE ROBERT;M;HUE;ROBERT;;1150
Présidentielles 1995 - 1er tour;Présidentielles;1995;1;;;78;VILLENEUVE LA GARENNE;92078;11588;3130;8458;196;8262;BALLADUR EDOUARD;M;BALLADUR;EDOUARD;;1049
Présidentielles 1995 - 2ème tour;Présidentielles;1995;2;;;7;BAGNEUX;92007;20165;4704;15461;949;14512;CHIRAC JACQUES;M;CHIRAC;JACQUES;;6291
Présidentielles 1995 - 2ème tour;Présidentielles;1995;2;;;23;CLAMART;92023;31217;7177;24040;1175;22865;JOSPIN LIONEL;M;JOSPIN;LIONEL;;10093
Présidentielles 1995 - 2ème tour;Présidentielles;1995;2;;;25;COLOMBES;92025;44851;10790;34061;1956;32105;JOSPIN LIONEL;M;JOSPIN;LIONEL;;15463
Présidentielles 1995 - 2ème tour;Présidentielles;1995;2;;;77;VILLE D'AVRAY;92077;7137;1035;6102;154;5948;JOSPIN LIONEL;M;JOSPIN;LIONEL;;1509
Présidentielles 1995 - 1er tour;Présidentielles;1995;1;;;14;BOURG LA REINE;92014;12770;3430;9340;135;9205;CHEMINADE JACQUES;M;CHEMINADE;JACQUES;;23
Présidentielles 1995 - 1er tour;Présidentielles;1995;1;;;7;BAGNEUX;92007;20166;5090;15076;308;14768;CHIRAC JACQUES;M;CHIRAC;JACQUES;;2804
Législatives 2007 - 1er tour;Législatives;2007;1;6;6ème circonscription;51;NEUILLY SUR SEINE;92051;39134;14738;24396;185;24211;GRANGER Marie;M;GRANGER;Marie;DIV;0
Législatives 2007 - 1er tour;Législatives;2007;1;4;4ème circonscription;73;SURESNES;92073;24666;8949;15717;206;15511;MEYER Marie-Laure;F;MEYER;Marie-Laure;SOC;2360
Législatives 2007 - 1er tour;Législatives;2007;1;8;8ème circonscription;76;VAUCRESSON;92076;6076;2206;3870;46;3824;BEZAULT Christine;F;BEZAULT;Christine;DIV;20
Législatives 2007 - 2ème tour;Législatives;2007;2;4;4ème circonscription;50;NANTERRE;92050;42631;19355;23276;593;22683;DUPUY Christian;M;DUPUY;Christian;UMP;8103
Législatives 2007 - 2ème tour;Législatives;2007;2;10;10ème circonscription;48;MEUDON;92048;5066;2270;2796;58;2738;SCHMID Lucille;F;SCHMID;Lucille;SOC;1164
Législatives 2007 - 1er tour;Législatives;2007;1;13;13ème circonscription;2;ANTONY;92002;39807;13942;25865;456;25409;BRAULT Chantal;F;BRAULT;Chantal;UDFD;3497
Législatives 2007 - 1er tour;Législatives;2007;1;10;10ème circonscription;12;BOULOGNE BILLANCOURT;92012;5551;2367;3184;78;3106;SANTINI André;M;SANTINI;André;MAJ;1313
Législatives 2007 - 1er tour;Législatives;2007;1;3;3ème circonscription;9;BOIS COLOMBES;92009;16245;6561;9684;288;9396;KOSSOWSKI Jacques;M;KOSSOWSKI;Jacques;UMP;4917
Législatives 2007 - 1er tour;Législatives;2007;1;1;1ère circonscription;36;GENNEVILLIERS;92036;20048;9522;10526;189;10337;GUICHARD Isabelle;F;GUICHARD;Isabelle;EXG;203
Législatives 2007 - 1er tour;Législatives;2007;1;8;8ème circonscription;47;MARNES LA COQUETTE;92047;1074;316;758;5;753;GONNET Nicolas;M;GONNET;Nicolas;COM;5
Législatives 2007 - 1er tour;Législatives;2007;1;5;5ème circonscription;44;LEVALLOIS PERRET;92044;39466;14724;24742;404;24338;CATOIRE Gilles;M;CATOIRE;Gilles;SOC;3860
Législatives 2007 - 1er tour;Législatives;2007;1;12;12ème circonscription;23;CLAMART;92023;32916;11487;21429;154;21275;KALTENBACH Philippe;M;KALTENBACH;Philippe;SOC;6919
Législatives 2007 - 1er tour;Législatives;2007;1;12;12ème circonscription;23;CLAMART;92023;32916;11487;21429;154;21275;SCHMITT Jean-Pierre;M;SCHMITT;Jean-Pierre;FN;492
Législatives 2007 - 1er tour;Législatives;2007;1;12;12ème circonscription;23;CLAMART;92023;32916;11487;21429;154;21275;ZANOLIN Ludovic;F;ZANOLIN;Ludovic;COM;383
Législatives 2007 - 1er tour;Législatives;2007;1;12;12ème circonscription;32;FONTENAY AUX ROSES;92032;15468;5605;9863;84;9779;KALTENBACH Philippe;M;KALTENBACH;Philippe;SOC;3254
Législatives 2007 - 1er tour;Législatives;2007;1;12;12ème circonscription;32;FONTENAY AUX ROSES;92032;15468;5605;9863;84;9779;ZANOLIN Ludovic;F;ZANOLIN;Ludovic;COM;417
Législatives 2007 - 1er tour;Législatives;2007;1;3;3ème circonscription;35;LA GARENNE COLOMBES;92035;16552;5947;10605;101;10504;ROYON Francine;F;ROYON;Francine;EXG;208
Législatives 2007 - 1er tour;Législatives;2007;1;8;8ème circonscription;47;MARNES LA COQUETTE;92047;1074;316;758;5;753;LEHIDEUX Bernard;M;LEHIDEUX;Bernard;UDFD;66
Législatives 2007 - 1er tour;Législatives;2007;1;11;11ème circonscription;49;MONTROUGE;92049;26595;9698;16897;213;16684;DE PABLO Carmelina;F;DE PABLO;Carmelina;VEC;705
Législatives 2007 - 1er tour;Législatives;2007;1;11;11ème circonscription;49;MONTROUGE;92049;26595;9698;16897;213;16684;DADARE Sébastien;M;DADARE;Sébastien;DIV;236
Législatives 2007 - 1er tour;Législatives;2007;1;11;11ème circonscription;49;MONTROUGE;92049;26595;9698;16897;213;16684;PICARD Catherine;F;PICARD;Catherine;SOC;4738
Législatives 2007 - 1er tour;Législatives;2007;1;8;8ème circonscription;72;SEVRES;92072;14460;5279;9181;151;9030;LEHIDEUX Bernard;M;LEHIDEUX;Bernard;UDFD;1205
Législatives 2007 - 1er tour;Législatives;2007;1;13;13ème circonscription;71;SCEAUX;92071;14129;4679;9450;74;9376;GOURDOL Aimée;F;GOURDOL;Aimée;DVG;51
Législatives 2007 - 1er tour;Législatives;2007;1;8;8ème circonscription;72;SEVRES;92072;14460;5279;9181;151;9030;ROY Caroline;F;ROY;Caroline;RDG;2144
Législatives 2007 - 1er tour;Législatives;2007;1;2;2ème circonscription;25;COLOMBES;92025;18336;7144;11192;207;10985;JOUBERT Valérie;F;JOUBERT;Valérie;EXG;185
Présidentielles 2002 - 1er tour;Présidentielles;2002;1;;;2;ANTONY;92002;36989;11047;25942;517;25425;BESANCENOT OLIVIER;M;BESANCENOT;OLIVIER;;847
Présidentielles 2002 - 1er tour;Présidentielles;2002;1;;;4;ASNIERES SUR SEINE;92004;35702;11271;24431;515;23916;HUE ROBERT;M;HUE;ROBERT;;476
Présidentielles 2002 - 1er tour;Présidentielles;2002;1;;;7;BAGNEUX;92007;18489;5873;12616;519;12097;GLUCKSTEIN DANIEL;M;GLUCKSTEIN;DANIEL;;79
Présidentielles 2002 - 1er tour;Présidentielles;2002;1;;;9;BOIS COLOMBES;92009;13996;4554;9442;200;9242;MEGRET BRUNO;M;MEGRET;BRUNO;;164
Présidentielles 2002 - 1er tour;Présidentielles;2002;1;;;9;BOIS COLOMBES;92009;13996;4554;9442;200;9242;LE PEN JEAN-MARIE;M;LE PEN;JEAN-MARIE;;1239
Présidentielles 2002 - 1er tour;Présidentielles;2002;1;;;12;BOULOGNE BILLANCOURT;92012;57382;17570;39812;645;39167;MEGRET BRUNO;M;MEGRET;BRUNO;;508
Présidentielles 2002 - 1er tour;Présidentielles;2002;1;;;12;BOULOGNE BILLANCOURT;92012;57382;17570;39812;645;39167;HUE ROBERT;M;HUE;ROBERT;;617
Présidentielles 2002 - 1er tour;Présidentielles;2002;1;;;19;CHATENAY MALABRY;92019;15965;4483;11482;241;11241;CHIRAC JACQUES;M;CHIRAC;JACQUES;;2362
Présidentielles 2002 - 1er tour;Présidentielles;2002;1;;;19;CHATENAY MALABRY;92019;15965;4483;11482;241;11241;MAMERE NOEL;M;MAMERE;NOEL;;716
Présidentielles 2002 - 1er tour;Présidentielles;2002;1;;;19;CHATENAY MALABRY;92019;15965;4483;11482;241;11241;LAGUILLER ARLETTE;F;LAGUILLER;ARLETTE;;505
Présidentielles 2002 - 1er tour;Présidentielles;2002;1;;;22;CHAVILLE;92022;12122;3826;8296;162;8134;LAGUILLER ARLETTE;F;LAGUILLER;ARLETTE;;270
Présidentielles 2002 - 1er tour;Présidentielles;2002;1;;;24;CLICHY;92024;24491;8395;16096;399;15697;TAUBIRA CHRISTIANE;F;TAUBIRA;CHRISTIANE;;905
Présidentielles 2002 - 1er tour;Présidentielles;2002;1;;;24;CLICHY;92024;24491;8395;16096;399;15697;HUE ROBERT;M;HUE;ROBERT;;439
Présidentielles 2002 - 1er tour;Présidentielles;2002;1;;;33;GARCHES;92033;11708;3920;7788;137;7651;LEPAGE CORINNE;F;LEPAGE;CORINNE;;223
Présidentielles 2002 - 1er tour;Présidentielles;2002;1;;;35;LA GARENNE COLOMBES;92035;15006;5167;9839;227;9612;GLUCKSTEIN DANIEL;M;GLUCKSTEIN;DANIEL;;17
Présidentielles 2002 - 1er tour;Présidentielles;2002;1;;;36;GENNEVILLIERS;92036;18213;6933;11280;303;10977;LEPAGE CORINNE;F;LEPAGE;CORINNE;;117
Présidentielles 2002 - 1er tour;Présidentielles;2002;1;;;46;MALAKOFF;92046;17268;6020;11248;271;10977;CHEVENEMENT JEAN-PIERRE;M;CHEVENEMENT;JEAN-PIERRE;;723
Présidentielles 2002 - 1er tour;Présidentielles;2002;1;;;48;MEUDON;92048;28283;9341;18942;321;18621;MAMERE NOEL;M;MAMERE;NOEL;;1207
Présidentielles 2002 - 1er tour;Présidentielles;2002;1;;;50;NANTERRE;92050;37590;13303;24287;669;23618;BAYROU FRANCOIS;M;BAYROU;FRANCOIS;;1390
Présidentielles 2002 - 1er tour;Présidentielles;2002;1;;;50;NANTERRE;92050;37590;13303;24287;669;23618;HUE ROBERT;M;HUE;ROBERT;;2240
Présidentielles 2002 - 1er tour;Présidentielles;2002;1;;;51;NEUILLY SUR SEINE;92051;34066;10108;23958;309;23649;CHEVENEMENT JEAN-PIERRE;M;CHEVENEMENT;JEAN-PIERRE;;930
Présidentielles 2002 - 1er tour;Présidentielles;2002;1;;;60;LE PLESSIS ROBINSON;92060;14503;4736;9767;230;9537;JOSPIN LIONEL;M;JOSPIN;LIONEL;;1561
Présidentielles 2002 - 1er tour;Présidentielles;2002;1;;;60;LE PLESSIS ROBINSON;92060;14503;4736;9767;230;9537;MADELIN ALAIN;M;MADELIN;ALAIN;;443
Présidentielles 2002 - 1er tour;Présidentielles;2002;1;;;62;PUTEAUX;92062;23861;6804;17057;487;16570;GLUCKSTEIN DANIEL;M;GLUCKSTEIN;DANIEL;;52
Présidentielles 2002 - 1er tour;Présidentielles;2002;1;;;71;SCEAUX;92071;12917;3930;8987;154;8833;SAINT-JOSSE JEAN;M;SAINT-JOSSE;JEAN;;46
Présidentielles 2002 - 1er tour;Présidentielles;2002;1;;;71;SCEAUX;92071;12917;3930;8987;154;8833;BOUTIN CHRISTINE;F;BOUTIN;CHRISTINE;;143
Présidentielles 2002 - 1er tour;Présidentielles;2002;1;;;77;VILLE D'AVRAY;92077;7251;2486;4765;70;4695;BOUTIN CHRISTINE;F;BOUTIN;CHRISTINE;;132
Présidentielles 2012 - 1er tour;Présidentielles;2012;1;;;2;ANTONY;92002;40169;7755;32414;674;31740;MÉLENCHON Jean-Luc;M;MÉLENCHON;Jean-Luc;;3356
Présidentielles 2012 - 1er tour;Présidentielles;2012;1;;;12;BOULOGNE BILLANCOURT;92012;67579;13310;54269;818;53451;DUPONT-AIGNAN Nicolas;M;DUPONT-AIGNAN;Nicolas;;643
Présidentielles 2012 - 1er tour;Présidentielles;2012;1;;;14;BOURG LA REINE;92014;13300;2381;10919;132;10787;HOLLANDE François;M;HOLLANDE;François;;3475
Présidentielles 2012 - 1er tour;Présidentielles;2012;1;;;22;CHAVILLE;92022;12768;2527;10241;147;10094;JOLY Eva;F;JOLY;Eva;;326
Présidentielles 2012 - 1er tour;Présidentielles;2012;1;;;32;FONTENAY AUX ROSES;92032;15217;3289;11928;161;11767;DUPONT-AIGNAN Nicolas;M;DUPONT-AIGNAN;Nicolas;;210
Présidentielles 2012 - 1er tour;Présidentielles;2012;1;;;32;FONTENAY AUX ROSES;92032;15217;3289;11928;161;11767;HOLLANDE François;M;HOLLANDE;François;;4152
Présidentielles 2012 - 1er tour;Présidentielles;2012;1;;;33;GARCHES;92033;12388;2501;9887;167;9720;POUTOU Philippe;M;POUTOU;Philippe;;30
Présidentielles 2012 - 1er tour;Présidentielles;2012;1;;;35;LA GARENNE COLOMBES;92035;17300;3509;13791;212;13579;MÉLENCHON Jean-Luc;M;MÉLENCHON;Jean-Luc;;1129
Présidentielles 2012 - 1er tour;Présidentielles;2012;1;;;35;LA GARENNE COLOMBES;92035;17300;3509;13791;212;13579;POUTOU Philippe;M;POUTOU;Philippe;;88
Présidentielles 2012 - 1er tour;Présidentielles;2012;1;;;40;ISSY LES MOULINEAUX;92040;41994;9488;32506;521;31985;BAYROU François;M;BAYROU;François;;4090
Présidentielles 2012 - 1er tour;Présidentielles;2012;1;;;40;ISSY LES MOULINEAUX;92040;41994;9488;32506;521;31985;DUPONT-AIGNAN Nicolas;M;DUPONT-AIGNAN;Nicolas;;452
Présidentielles 2012 - 1er tour;Présidentielles;2012;1;;;44;LEVALLOIS PERRET;92044;39497;7296;32201;438;31763;SARKOZY Nicolas;M;SARKOZY;Nicolas;;15112
Présidentielles 2012 - 1er tour;Présidentielles;2012;1;;;44;LEVALLOIS PERRET;92044;39497;7296;32201;438;31763;CHEMINADE Jacques;M;CHEMINADE;Jacques;;58
Présidentielles 2012 - 1er tour;Présidentielles;2012;1;;;46;MALAKOFF;92046;18852;4162;14690;207;14483;JOLY Eva;F;JOLY;Eva;;485
Présidentielles 2012 - 1er tour;Présidentielles;2012;1;;;49;MONTROUGE;92049;27851;5527;22324;289;22035;MÉLENCHON Jean-Luc;M;MÉLENCHON;Jean-Luc;;2556
Présidentielles 2012 - 1er tour;Présidentielles;2012;1;;;50;NANTERRE;92050;44307;10435;33872;654;33218;BAYROU François;M;BAYROU;François;;2509
Présidentielles 2012 - 1er tour;Présidentielles;2012;1;;;60;LE PLESSIS ROBINSON;92060;18767;3621;15146;260;14886;HOLLANDE François;M;HOLLANDE;François;;4141
Présidentielles 2012 - 1er tour;Présidentielles;2012;1;;;64;SAINT CLOUD;92064;18973;3529;15444;153;15291;ARTHAUD Nathalie;F;ARTHAUD;Nathalie;;20
Présidentielles 2012 - 1er tour;Présidentielles;2012;1;;;71;SCEAUX;92071;14355;2941;11414;118;11296;BAYROU François;M;BAYROU;François;;1584
Présidentielles 2012 - 1er tour;Présidentielles;2012;1;;;72;SEVRES;92072;14837;2876;11961;219;11742;POUTOU Philippe;M;POUTOU;Philippe;;59
Présidentielles 2012 - 1er tour;Présidentielles;2012;1;;;73;SURESNES;92073;26458;5110;21348;425;20923;CHEMINADE Jacques;M;CHEMINADE;Jacques;;57
Présidentielles 2012 - 1er tour;Présidentielles;2012;1;;;73;SURESNES;92073;26458;5110;21348;425;20923;HOLLANDE François;M;HOLLANDE;François;;6174
Présidentielles 2012 - 1er tour;Présidentielles;2012;1;;;77;VILLE D'AVRAY;92077;7132;1060;6072;80;5992;BAYROU François;M;BAYROU;François;;841
Présidentielles 2007 - 1er tour;Présidentielles;2007;1;;;12;BOULOGNE BILLANCOURT;92012;64709;7685;57024;546;56478;LAGUILLER Arlette;F;LAGUILLER;Arlette;;237
Présidentielles 2007 - 1er tour;Présidentielles;2007;1;;;20;CHATILLON;92020;20466;2231;18235;177;18058;LAGUILLER Arlette;F;LAGUILLER;Arlette;;174
Présidentielles 2007 - 1er tour;Présidentielles;2007;1;;;23;CLAMART;92023;32539;3879;28660;293;28367;SCHIVARDI Gérard;M;SCHIVARDI;Gérard;;74
Présidentielles 2007 - 1er tour;Présidentielles;2007;1;;;23;CLAMART;92023;32539;3879;28660;293;28367;ROYAL Ségolène;F;ROYAL;Ségolène;;7772
Présidentielles 2007 - 1er tour;Présidentielles;2007;1;;;36;GENNEVILLIERS;92036;19890;3536;16354;259;16095;BUFFET Marie-George;F;BUFFET;Marie-George;;1168
Présidentielles 2007 - 1er tour;Présidentielles;2007;1;;;36;GENNEVILLIERS;92036;19890;3536;16354;259;16095;de VILLIERS Philippe;M;de VILLIERS;Philippe;;186
Présidentielles 2007 - 1er tour;Présidentielles;2007;1;;;40;ISSY LES MOULINEAUX;92040;37966;4920;33046;365;32681;BUFFET Marie-George;F;BUFFET;Marie-George;;379
Présidentielles 2007 - 1er tour;Présidentielles;2007;1;;;46;MALAKOFF;92046;18259;2640;15619;178;15441;SCHIVARDI Gérard;M;SCHIVARDI;Gérard;;50
Présidentielles 2007 - 1er tour;Présidentielles;2007;1;;;46;MALAKOFF;92046;18259;2640;15619;178;15441;LE PEN Jean-Marie;M;LE PEN;Jean-Marie;;1008
Présidentielles 2007 - 1er tour;Présidentielles;2007;1;;;48;MEUDON;92048;29936;4129;25807;223;25584;BAYROU François;M;BAYROU;François;;5983
Présidentielles 2007 - 1er tour;Présidentielles;2007;1;;;49;MONTROUGE;92049;26299;3093;23206;219;22987;SARKOZY Nicolas;M;SARKOZY;Nicolas;;6960
Présidentielles 2007 - 1er tour;Présidentielles;2007;1;;;50;NANTERRE;92050;42083;6117;35966;477;35489;BUFFET Marie-George;F;BUFFET;Marie-George;;1635
Présidentielles 2007 - 1er tour;Présidentielles;2007;1;;;51;NEUILLY SUR SEINE;92051;37647;4032;33615;154;33461;BUFFET Marie-George;F;BUFFET;Marie-George;;65
Présidentielles 2007 - 1er tour;Présidentielles;2007;1;;;71;SCEAUX;92071;13824;1539;12285;86;12199;ROYAL Ségolène;F;ROYAL;Ségolène;;2981
Présidentielles 2007 - 1er tour;Présidentielles;2007;1;;;73;SURESNES;92073;24255;2600;21655;272;21383;ROYAL Ségolène;F;ROYAL;Ségolène;;5202
Présidentielles 2007 - 1er tour;Présidentielles;2007;1;;;75;VANVES;92075;17139;2129;15010;126;14884;BOVÉ José;M;BOVÉ;José;;120
Présidentielles 2017 - 1er tour;Présidentielles;2017;1;;;4;ASNIERES SUR SEINE;92004;48227;8578;39649;807;38842;FILLON François;M;FILLON;François;;10343
Présidentielles 2017 - 1er tour;Présidentielles;2017;1;;;4;ASNIERES SUR SEINE;92004;48227;8578;39649;807;38842;POUTOU Philippe;M;POUTOU;Philippe;;264
Présidentielles 2017 - 1er tour;Présidentielles;2017;1;;;9;BOIS COLOMBES;92009;17896;3242;14654;318;14336;ARTHAUD Nathalie;F;ARTHAUD;Nathalie;;30
Présidentielles 2017 - 1er tour;Présidentielles;2017;1;;;19;CHATENAY MALABRY;92019;18708;3336;15372;454;14918;ARTHAUD Nathalie;F;ARTHAUD;Nathalie;;33
Présidentielles 2017 - 1er tour;Présidentielles;2017;1;;;19;CHATENAY MALABRY;92019;18708;3336;15372;454;14918;LASSALLE Jean;M;LASSALLE;Jean;;105
Présidentielles 2017 - 1er tour;Présidentielles;2017;1;;;24;CLICHY;92024;28553;5564;22989;498;22491;ARTHAUD Nathalie;F;ARTHAUD;Nathalie;;122
Présidentielles 2017 - 1er tour;Présidentielles;2017;1;;;24;CLICHY;92024;28553;5564;22989;498;22491;CHEMINADE Jacques;M;CHEMINADE;Jacques;;54
Présidentielles 2017 - 1er tour;Présidentielles;2017;1;;;32;FONTENAY AUX ROSES;92032;16036;3739;12297;218;12078;HAMON Benoît;M;HAMON;Benoît;;1130
Présidentielles 2017 - 1er tour;Présidentielles;2017;1;;;33;GARCHES;92033;12767;1975;10792;194;10598;LE PEN Marine;F;LE PEN;Marine;;758
Présidentielles 2017 - 1er tour;Présidentielles;2017;1;;;36;GENNEVILLIERS;92036;22149;5526;16623;490;16133;POUTOU Philippe;M;POUTOU;Philippe;;195
Présidentielles 2017 - 1er tour;Présidentielles;2017;1;;;47;MARNES LA COQUETTE;92047;1215;171;1044;5;1039;MÉLENCHON Jean-Luc;M;MÉLENCHON;Jean-Luc;;71
Présidentielles 2017 - 1er tour;Présidentielles;2017;1;;;48;MEUDON;92048;31280;5715;25565;405;25160;HAMON Benoît;M;HAMON;Benoît;;1977
Présidentielles 2017 - 1er tour;Présidentielles;2017;1;;;50;NANTERRE;92050;47568;10655;36913;884;36029;HAMON Benoît;M;HAMON;Benoît;;3189
Présidentielles 2017 - 1er tour;Présidentielles;2017;1;;;51;NEUILLY SUR SEINE;92051;37184;4180;33004;212;32792;LASSALLE Jean;M;LASSALLE;Jean;;104
Présidentielles 2017 - 1er tour;Présidentielles;2017;1;;;51;NEUILLY SUR SEINE;92051;37184;4180;33004;212;32792;MACRON Emmanuel;M;MACRON;Emmanuel;;7784
Présidentielles 2017 - 1er tour;Présidentielles;2017;1;;;60;LE PLESSIS ROBINSON;92060;19141;2947;16194;344;15850;FILLON François;M;FILLON;François;;4137
Présidentielles 2017 - 1er tour;Présidentielles;2017;1;;;62;PUTEAUX;92062;28950;4530;24420;549;23871;LASSALLE Jean;M;LASSALLE;Jean;;159
Présidentielles 2017 - 1er tour;Présidentielles;2017;1;;;72;SEVRES;92072;15142;2166;12976;213;12763;ARTHAUD Nathalie;F;ARTHAUD;Nathalie;;22
Présidentielles 2017 - 1er tour;Présidentielles;2017;1;;;73;SURESNES;92073;28497;4342;24155;520;23635;MÉLENCHON Jean-Luc;M;MÉLENCHON;Jean-Luc;;3922
Présidentielles 2017 - 1er tour;Présidentielles;2017;1;;;75;VANVES;92075;18500;3228;15272;248;15024;ASSELINEAU François;M;ASSELINEAU;François;;140
Présidentielles 2002 - 2ème tour;Présidentielles;2002;2;;;9;BOIS COLOMBES;92009;13990;2517;11473;383;11090;CHIRAC JACQUES;M;CHIRAC;JACQUES;;9719
Présidentielles 2002 - 2ème tour;Présidentielles;2002;2;;;24;CLICHY;92024;24496;5437;19059;740;18319;CHIRAC JACQUES;M;CHIRAC;JACQUES;;15640
Présidentielles 2002 - 2ème tour;Présidentielles;2002;2;;;26;COURBEVOIE;92026;40056;7007;33049;974;32075;CHIRAC JACQUES;M;CHIRAC;JACQUES;;28226
Présidentielles 2002 - 2ème tour;Présidentielles;2002;2;;;47;MARNES LA COQUETTE;92047;998;127;871;19;852;LE PEN JEAN-MARIE;M;LE PEN;JEAN-MARIE;;123
Présidentielles 2002 - 2ème tour;Présidentielles;2002;2;;;63;RUEIL MALMAISON;92063;48284;10250;38034;1205;36829;LE PEN JEAN-MARIE;M;LE PEN;JEAN-MARIE;;4184
Présidentielles 2007 - 2ème tour;Présidentielles;2007;2;;;50;NANTERRE;92050;42094;6719;35375;1289;34086;ROYAL Ségolène;F;ROYAL;Ségolène;;21127
Législatives 1997 - 1er tour;Législatives;1997;1;8;8ème circonscription;47;MARNES LA COQUETTE;92047;985;289;696;19;677;MULLERIS KONOPNICKI A.PAULE;F;MULLERIS KONOPNICKI;A.PAULE;ECO;30
Présidentielles 2017 - 2ème tour;Présidentielles;2017;2;;;14;BOURG LA REINE;92014;13769;2887;10882;941;9941;MACRON Emmanuel;M;MACRON;Emmanuel;;8725
Présidentielles 2017 - 2ème tour;Présidentielles;2017;2;;;25;COLOMBES;92025;47455;11924;35531;3380;32151;MACRON Emmanuel;M;MACRON;Emmanuel;;27130
Législatives 1993 - 2ème tour;Législatives;1993;2;2;2ème circonscription;25;COLOMBES;92025;18318;7739;10579;2093;8486;TAITTINGER FRANTZ;M;TAITTINGER;FRANTZ;DVD;3678
Présidentielles 2012 - 2ème tour;Présidentielles;2012;2;;;75;VANVES;92075;17516;2584;14932;567;14365;HOLLANDE François;M;HOLLANDE;François;;8107
Législatives 1997 - 1er tour;Législatives;1997;1;11;11ème circonscription;7;BAGNEUX;92007;20284;7388;12896;374;12522;GARO MICHELE;F;GARO;MICHELE;EXG;73
Législatives 1993 - 1er tour;Législatives;1993;1;5;5ème circonscription;24;CLICHY;92024;25172;9290;15882;514;15368;LUNEAU FRANCOISE;F;LUNEAU;FRANCOISE;DIV;305
Législatives 1997 - 1er tour;Législatives;1997;1;7;7ème circonscription;63;RUEIL MALMAISON;92063;44715;14813;29902;1094;28808;PACOURET J.RAYMOND;M;PACOURET;J.RAYMOND;COM;1566
Législatives 1993 - 1er tour;Législatives;1993;1;8;8ème circonscription;47;MARNES LA COQUETTE;92047;1006;246;760;21;739;LAURENT AMSALLEM EDDY;M;LAURENT AMSALLEM;EDDY;DIV;3
Législatives 1993 - 1er tour;Législatives;1993;1;7;7ème circonscription;63;RUEIL MALMAISON;92063;42219;12104;30115;1049;29066;TRON ROGER;M;TRON;ROGER;DVD;443
Législatives 1997 - 1er tour;Législatives;1997;1;6;6ème circonscription;62;PUTEAUX;92062;24329;8862;15467;635;14832;GRANGER J.MICHEL;M;GRANGER;J.MICHEL;DVD;2
Législatives 1993 - 1er tour;Législatives;1993;1;2;2ème circonscription;25;COLOMBES;92025;18324;5870;12454;434;12020;MATET EVELYNE;F;MATET;EVELYNE;DIV;156
Législatives 1997 - 1er tour;Législatives;1997;1;1;1ère circonscription;25;COLOMBES;92025;26238;10153;16085;513;15572;MERRA RICHARD;M;MERRA;RICHARD;EXG;226
Législatives 1993 - 1er tour;Législatives;1993;1;3;3ème circonscription;35;LA GARENNE COLOMBES;92035;13664;4290;9374;347;9027;MARSAULT PHILIPPE;M;MARSAULT;PHILIPPE;EXG;152
Législatives 1997 - 1er tour;Législatives;1997;1;6;6ème circonscription;51;NEUILLY SUR SEINE;92051;35571;12347;23224;570;22654;GIRONDE DE OLIVIER;M;GIRONDE DE;OLIVIER;ECO;675
Législatives 1993 - 1er tour;Législatives;1993;1;4;4ème circonscription;50;NANTERRE;92050;38007;11484;26523;795;25728;DEBAILLE NATHALIE;F;DEBAILLE;NATHALIE;FRN;3223
Législatives 1997 - 1er tour;Législatives;1997;1;12;12ème circonscription;60;LE PLESSIS ROBINSON;92060;13002;3860;9142;204;8938;LECOMTE HERVE;M;LECOMTE;HERVE;EXG;55
Législatives 1993 - 1er tour;Législatives;1993;1;10;10ème circonscription;12;BOULOGNE BILLANCOURT;92012;4523;1581;2942;133;2809;RIEUPET ANNIE;F;RIEUPET;ANNIE;EXG;68
Législatives 1997 - 1er tour;Législatives;1997;1;1;1ère circonscription;78;VILLENEUVE LA GARENNE;92078;11471;4645;6826;211;6615;MICHON SYLVAIN;M;MICHON;SYLVAIN;EXG;56
Législatives 1993 - 1er tour;Législatives;1993;1;8;8ème circonscription;72;SEVRES;92072;13536;3690;9846;336;9510;LAURENT AMSALLEM EDDY;M;LAURENT AMSALLEM;EDDY;DIV;88
Législatives 1997 - 1er tour;Législatives;1997;1;8;8ème circonscription;77;VILLE D'AVRAY;92077;7112;2283;4829;139;4690;ETILE L.CHRISTOPHE;M;ETILE;L.CHRISTOPHE;DVD;144
Législatives 1993 - 1er tour;Législatives;1993;1;4;4ème circonscription;73;SURESNES;92073;21292;6457;14835;522;14313;AMEIL BERTRAND;M;AMEIL;BERTRAND;DVD;187
Législatives 2012 - 1er tour;Législatives;2012;1;11;11ème circonscription;7;BAGNEUX;92007;20609;9648;10961;145;10816;AMIABLE Marie-Hélène;F;AMIABLE;Marie-Hélène;FG;4612
Législatives 1993 - 2ème tour;Législatives;1993;2;8;8ème circonscription;47;MARNES LA COQUETTE;92047;1006;431;575;119;456;GUILLET J.JACQUES;M;GUILLET;J.JACQUES;RPR;456
Législatives 2002 - 1er tour;Législatives;2002;1;2;2ème circonscription;4;ASNIERES SUR SEINE;92004;44110;17783;26327;312;26015;JOUBERT Valérie;F;JOUBERT;Valérie;EXG;597
Législatives 2012 - 1er tour;Législatives;2012;1;12;12ème circonscription;23;CLAMART;92023;34173;13440;20733;193;20540;LE METAYER Jocelyne;F;LE METAYER;Jocelyne;FG;1438
Législatives 2002 - 1er tour;Législatives;2002;1;11;11ème circonscription;7;BAGNEUX;92007;20520;8538;11982;178;11804;SAUVANAUD Juliette;F;SAUVANAUD;Juliette;EXG;68
Législatives 2012 - 1er tour;Législatives;2012;1;2;2ème circonscription;25;COLOMBES;92025;18458;7115;11343;114;11229;L'HUILLIER Guillaume;M;L'HUILLIER;Guillaume;FN;804
Législatives 2002 - 1er tour;Législatives;2002;1;13;13ème circonscription;19;CHATENAY MALABRY;92019;17835;6584;11251;211;11040;FIE Dominique;M;FIE;Dominique;COM;268
Législatives 2012 - 1er tour;Législatives;2012;1;3;3ème circonscription;26;COURBEVOIE;92026;42456;16939;25517;317;25200;LE GUENNIOU Anne;F;LE GUENNIOU;Anne;VEC;768
Législatives 2002 - 1er tour;Législatives;2002;1;12;12ème circonscription;20;CHATILLON;92020;20661;7083;13578;137;13441;DELOM Christian;M;DELOM;Christian;UDFD;1501
Législatives 2012 - 1er tour;Législatives;2012;1;6;6ème circonscription;26;COURBEVOIE;92026;8123;3742;4381;140;4241;THEVENET Audric;M;THEVENET;Audric;ECO;33
Législatives 2002 - 1er tour;Législatives;2002;1;12;12ème circonscription;23;CLAMART;92023;32916;11487;21429;154;21275;CHABRAN Isabelle;F;CHABRAN;Isabelle;VEC;962
Législatives 2012 - 1er tour;Législatives;2012;1;12;12ème circonscription;32;FONTENAY AUX ROSES;92032;15230;5971;9259;85;9174;GERMAIN Jean-Marc;M;GERMAIN;Jean-Marc;SOC;3882
Législatives 2002 - 1er tour;Législatives;2002;1;5;5ème circonscription;24;CLICHY;92024;28799;12380;16419;297;16122;CATOIRE Gilles;M;CATOIRE;Gilles;SOC;5671
Législatives 2012 - 1er tour;Législatives;2012;1;7;7ème circonscription;33;GARCHES;92033;12412;5093;7319;98;7221;BARRE Camille;F;BARRE;Camille;FG;144
Législatives 2002 - 1er tour;Législatives;2002;1;12;12ème circonscription;32;FONTENAY AUX ROSES;92032;15468;5605;9863;84;9779;SCHMITT Jean-Pierre;M;SCHMITT;Jean-Pierre;FN;225
Législatives 2012 - 1er tour;Législatives;2012;1;5;5ème circonscription;44;LEVALLOIS PERRET;92044;39546;14667;24879;238;24641;FOURNIER Alain;M;FOURNIER;Alain;VEC;489
Législatives 2002 - 1er tour;Législatives;2002;1;3;3ème circonscription;35;LA GARENNE COLOMBES;92035;16552;5947;10605;101;10504;CHAGNON Louis;M;CHAGNON;Louis;MPF;117
Législatives 2012 - 1er tour;Législatives;2012;1;11;11ème circonscription;46;MALAKOFF;92046;18858;7608;11250;119;11131;SAUVANAUD Juliette;F;SAUVANAUD;Juliette;EXG;49
Législatives 2002 - 1er tour;Législatives;2002;1;4;4ème circonscription;50;NANTERRE;92050;42631;18721;23910;314;23596;FRAYSSE Jacqueline;F;FRAYSSE;Jacqueline;COM;8192
Législatives 2012 - 1er tour;Législatives;2012;1;8;8ème circonscription;47;MARNES LA COQUETTE;92047;1085;330;755;2;753;CASTERA Stéphane;M;CASTERA;Stéphane;AUT;5
Législatives 2002 - 1er tour;Législatives;2002;1;6;6ème circonscription;51;NEUILLY SUR SEINE;92051;39134;14738;24396;185;24211;GRANGER Marie;M;GRANGER;Marie;DIV;0
Législatives 2012 - 1er tour;Législatives;2012;1;10;10ème circonscription;48;MEUDON;92048;5576;2083;3493;26;3467;HESSE Frédéric;M;HESSE;Frédéric;AUT;0
Législatives 2002 - 1er tour;Législatives;2002;1;7;7ème circonscription;63;RUEIL MALMAISON;92063;51481;18902;32579;337;32242;PIJOAN David;M;PIJOAN;David;EXG;505
Législatives 2012 - 1er tour;Législatives;2012;1;6;6ème circonscription;62;PUTEAUX;92062;28253;11141;17112;441;16671;GAUJARD Caroline;F;GAUJARD;Caroline;EXG;56
Législatives 2002 - 1er tour;Législatives;2002;1;10;10ème circonscription;75;VANVES;92075;17351;5929;11422;137;11285;TERRET Eugène;M;TERRET;Eugène;FN;303
Législatives 2012 - 1er tour;Législatives;2012;1;13;13ème circonscription;71;SCEAUX;92071;14395;5253;9142;70;9072;DEVEDJIAN Patrick;M;DEVEDJIAN;Patrick;UMP;3735
Législatives 2002 - 1er tour;Législatives;2002;1;8;8ème circonscription;77;VILLE D'AVRAY;92077;7475;2429;5046;60;4986;LUCET Francis;M;LUCET;Francis;EXG;7
Législatives 1997 - 1er tour;Législatives;1997;1;10;10ème circonscription;40;ISSY LES MOULINEAUX;92040;30164;10899;19265;543;18722;BERTRAND GINETTE;F;BERTRAND;GINETTE;DVD;455
Législatives 1997 - 1er tour;Législatives;1997;1;2;2ème circonscription;4;ASNIERES SUR SEINE;92004;37154;13729;23425;737;22688;TAITTINGER FRANTZ;M;TAITTINGER;FRANTZ;RPR;8100
Législatives 1997 - 1er tour;Législatives;1997;1;5;5ème circonscription;44;LEVALLOIS PERRET;92044;28281;9315;18966;650;18316;LIMOUSIN MICHEL;M;LIMOUSIN;MICHEL;COM;961
Législatives 1997 - 1er tour;Législatives;1997;1;7;7ème circonscription;33;GARCHES;92033;11323;3745;7578;290;7288;SUJEVIC J.GABRIEL;M;SUJEVIC;J.GABRIEL;DVD;0
Législatives 2012 - 2ème tour;Législatives;2012;2;7;7ème circonscription;64;SAINT CLOUD;92064;19029;8583;10446;347;10099;OLLIER Patrick;M;OLLIER;Patrick;UMP;7069
Législatives 1997 - 1er tour;Législatives;1997;1;10;10ème circonscription;12;BOULOGNE BILLANCOURT;92012;4529;1717;2812;99;2713;SANTINI ANDRE;M;SANTINI;ANDRE;UDF;846
Législatives 2002 - 2ème tour;Législatives;2002;2;12;12ème circonscription;60;LE PLESSIS ROBINSON;92060;14602;5016;9586;213;9373;BAVAY FRANCINE;F;BAVAY;FRANCINE;VEC;3623
Législatives 1997 - 1er tour;Législatives;1997;1;3;3ème circonscription;26;COURBEVOIE;92026;35738;12354;23384;653;22731;LEROY BUREL CORINNE;F;LEROY BUREL;CORINNE;ECO;901
Présidentielles 1995 - 2ème tour;Présidentielles;1995;2;;;49;MONTROUGE;92049;22293;5222;17071;788;16283;CHIRAC JACQUES;M;CHIRAC;JACQUES;;8721
Présidentielles 1995 - 2ème tour;Présidentielles;1995;2;;;64;SAINT CLOUD;92064;18989;4088;14901;486;14415;CHIRAC JACQUES;M;CHIRAC;JACQUES;;10808
Présidentielles 2002 - 2ème tour;Présidentielles;2002;2;;;7;BAGNEUX;92007;18493;3762;14731;600;14131;CHIRAC JACQUES;M;CHIRAC;JACQUES;;12286
Présidentielles 2002 - 2ème tour;Présidentielles;2002;2;;;9;BOIS COLOMBES;92009;13990;2517;11473;383;11090;LE PEN JEAN-MARIE;M;LE PEN;JEAN-MARIE;;1371
Présidentielles 2002 - 2ème tour;Présidentielles;2002;2;;;26;COURBEVOIE;92026;40056;7007;33049;974;32075;LE PEN JEAN-MARIE;M;LE PEN;JEAN-MARIE;;3849
Présidentielles 2002 - 2ème tour;Présidentielles;2002;2;;;44;LEVALLOIS PERRET;92044;33618;5548;28070;800;27270;LE PEN JEAN-MARIE;M;LE PEN;JEAN-MARIE;;3117
Présidentielles 2002 - 2ème tour;Présidentielles;2002;2;;;73;SURESNES;92073;22099;4188;17911;579;17332;CHIRAC JACQUES;M;CHIRAC;JACQUES;;15276
Présidentielles 1995 - 1er tour;Présidentielles;1995;1;;;78;VILLENEUVE LA GARENNE;92078;11588;3130;8458;196;8262;LE PEN J.MARIE;M;LE PEN;J.MARIE;;1759
Présidentielles 1995 - 1er tour;Présidentielles;1995;1;;;78;VILLENEUVE LA GARENNE;92078;11588;3130;8458;196;8262;HUE ROBERT;M;HUE;ROBERT;;812
Législatives 1993 - 1er tour;Législatives;1993;1;13;13ème circonscription;2;ANTONY;92002;36749;10226;26523;1007;25516;GAZZOLA DANIEL;M;GAZZOLA;DANIEL;FRN;2892
Législatives 1993 - 1er tour;Législatives;1993;1;8;8ème circonscription;47;MARNES LA COQUETTE;92047;1006;246;760;21;739;GREGOIRE MAURICE;M;GREGOIRE;MAURICE;DIV;3
Législatives 1993 - 1er tour;Législatives;1993;1;11;11ème circonscription;46;MALAKOFF;92046;19559;6951;12608;416;12192;RAKETITCH RAOUL;M;RAKETITCH;RAOUL;FRN;1210
Législatives 1993 - 1er tour;Législatives;1993;1;13;13ème circonscription;71;SCEAUX;92071;13127;3574;9553;306;9247;LEFRERE CHRISTIANE;F;LEFRERE;CHRISTIANE;DIV;188
Législatives 1993 - 1er tour;Législatives;1993;1;6;6ème circonscription;62;PUTEAUX;92062;23271;6636;16635;697;15938;LE PEN M.CAROLINE;F;LE PEN;M.CAROLINE;FRN;2263
Législatives 1993 - 1er tour;Législatives;1993;1;12;12ème circonscription;60;LE PLESSIS ROBINSON;92060;13118;4266;8852;315;8537;GRIELEN ALAIN;M;GRIELEN;ALAIN;MAJ;68
Législatives 1993 - 1er tour;Législatives;1993;1;8;8ème circonscription;76;VAUCRESSON;92076;5515;1574;3941;93;3848;LAURENT AMSALLEM EDDY;M;LAURENT AMSALLEM;EDDY;DIV;19
Législatives 1993 - 1er tour;Législatives;1993;1;13;13ème circonscription;14;BOURG LA REINE;92014;12754;4085;8669;303;8366;ROSNER ADRIAN;M;ROSNER;ADRIAN;GEC;912
Législatives 1993 - 1er tour;Législatives;1993;1;13;13ème circonscription;19;CHATENAY MALABRY;92019;17809;6223;11586;435;11151;DEVEDJIAN PATRICK;M;DEVEDJIAN;PATRICK;RPR;4301
Législatives 1993 - 1er tour;Législatives;1993;1;5;5ème circonscription;24;CLICHY;92024;25172;9290;15882;514;15368;BALKANY PATRICK;M;BALKANY;PATRICK;RPR;5011
Législatives 1993 - 1er tour;Législatives;1993;1;12;12ème circonscription;23;CLAMART;92023;30899;9896;21003;704;20299;GRIELEN ALAIN;M;GRIELEN;ALAIN;MAJ;249
Législatives 1993 - 1er tour;Législatives;1993;1;10;10ème circonscription;40;ISSY LES MOULINEAUX;92040;29377;9425;19952;648;19304;DORLIN MICHEL;M;DORLIN;MICHEL;FRN;1936
Législatives 1993 - 1er tour;Législatives;1993;1;5;5ème circonscription;44;LEVALLOIS PERRET;92044;27392;7486;19906;624;19282;SCHMAUS GUY;M;SCHMAUS;GUY;COM;1224
Législatives 1993 - 1er tour;Législatives;1993;1;7;7ème circonscription;33;GARCHES;92033;11440;3330;8110;328;7782;MICHAELY GUY;M;MICHAELY;GUY;EXD;38
Législatives 1993 - 2ème tour;Législatives;1993;2;12;12ème circonscription;32;FONTENAY AUX ROSES;92032;15096;5121;9975;559;9416;FOUCHER J.PIERRE;M;FOUCHER;J.PIERRE;UDF;5239
Législatives 2017 - 1er tour;Législatives;2017;1;1;1ère circonscription;36;GENNEVILLIERS;92036;22174;13223;8951;243;8708;BACHELAY Alexis;M;BACHELAY;Alexis;SOC;530
Législatives 2017 - 1er tour;Législatives;2017;1;1;1ère circonscription;36;GENNEVILLIERS;92036;22174;13223;8951;243;8708;ARIAS Jacques;M;ARIAS;Jacques;ECO;12
Législatives 2017 - 1er tour;Législatives;2017;1;7;7ème circonscription;64;SAINT CLOUD;92064;19410;7490;11920;102;11818;CAZENEUVE Pierre;M;CAZENEUVE;Pierre;DIV;624
Législatives 2017 - 1er tour;Législatives;2017;1;8;8ème circonscription;22;CHAVILLE;92022;13523;5385;8138;93;8045;SCHNEIDER Frédéric;M;SCHNEIDER;Frédéric;DIV;46
Législatives 2017 - 1er tour;Législatives;2017;1;8;8ème circonscription;22;CHAVILLE;92022;13523;5385;8138;93;8045;DE SAINT ALBIN Stéphane;M;DE SAINT ALBIN;Stéphane;DVD;268
Législatives 2017 - 1er tour;Législatives;2017;1;8;8ème circonscription;47;MARNES LA COQUETTE;92047;1215;451;764;4;760;MACHILLOT Alexandre;M;MACHILLOT;Alexandre;DIV;12
Législatives 2017 - 1er tour;Législatives;2017;1;8;8ème circonscription;48;MEUDON;92048;25240;11059;14181;174;14007;PAILLARD Christophe;M;PAILLARD;Christophe;DVD;40
Législatives 2017 - 1er tour;Législatives;2017;1;8;8ème circonscription;72;SEVRES;92072;15144;6343;8801;149;8652;CHETAILLE Romain;M;CHETAILLE;Romain;DVD;143
Législatives 2017 - 1er tour;Législatives;2017;1;9;9ème circonscription;12;BOULOGNE BILLANCOURT;92012;64984;30321;34663;987;33676;GOÏTIA Isabelle;F;GOÏTIA;Isabelle;COM;856
Législatives 2017 - 1er tour;Législatives;2017;1;9;9ème circonscription;12;BOULOGNE BILLANCOURT;92012;64984;30321;34663;987;33676;DELAHAYE Talia;F;DELAHAYE;Talia;DIV;618
Législatives 2017 - 1er tour;Législatives;2017;1;10;10ème circonscription;75;VANVES;92075;18507;7626;10881;125;10756;ZAZOUN Messaoud;M;ZAZOUN;Messaoud;DIV;22
Législatives 2017 - 1er tour;Législatives;2017;1;12;12ème circonscription;23;CLAMART;92023;35342;15954;19388;238;19150;REJA-BRET Alexandre;M;REJA-BRET;Alexandre;DIV;10
Législatives 2017 - 1er tour;Législatives;2017;1;13;13ème circonscription;14;BOURG LA REINE;92014;13736;5356;8380;81;8299;ROLLOT Franck;M;ROLLOT;Franck;EXG;26
Législatives 2017 - 2ème tour;Législatives;2017;2;1;1ère circonscription;78;VILLENEUVE LA GARENNE;92078;12445;8883;3562;297;3265;FAUCILLON Elsa;F;FAUCILLON;Elsa;COM;1613
Législatives 2017 - 2ème tour;Législatives;2017;2;7;7ème circonscription;33;GARCHES;92033;12777;6612;6165;326;5839;BERDOATI Eric;M;BERDOATI;Eric;LR;2510
Législatives 2017 - 2ème tour;Législatives;2017;2;8;8ème circonscription;48;MEUDON;92048;25242;13349;11893;962;10931;BOYER Gilles;M;BOYER;Gilles;LR;4471
Législatives 2017 - 2ème tour;Législatives;2017;2;10;10ème circonscription;75;VANVES;92075;18506;9482;9024;1014;8010;COSTE Jeremy;M;COSTE;Jeremy;UDI;2809
Législatives 2017 - 1er tour;Législatives;2017;1;7;7ème circonscription;63;RUEIL MALMAISON;92063;54498;24335;30163;377;29786;GUERY Jérôme;M;GUERY;Jérôme;EXD;185
Législatives 2017 - 1er tour;Législatives;2017;1;2;2ème circonscription;4;ASNIERES SUR SEINE;92004;48340;22557;25783;414;25369;AESCHLIMANN Marie-Do;F;AESCHLIMANN;Marie-Do;LR;6432
Législatives 2017 - 1er tour;Législatives;2017;1;2;2ème circonscription;25;COLOMBES;92025;19668;8354;11314;229;11085;BARTHÉLÉMY-RUIZ Chantal;F;BARTHÉLÉMY-RUIZ;Chantal;SOC;701
Législatives 2017 - 1er tour;Législatives;2017;1;3;3ème circonscription;35;LA GARENNE COLOMBES;92035;18829;8238;10591;114;10477;MUGERIN Richard;M;MUGERIN;Richard;DLF;89
Législatives 2017 - 1er tour;Législatives;2017;1;4;4ème circonscription;50;NANTERRE;92050;47651;26455;21196;432;20764;BOUKHEDIMI Patrick;M;BOUKHEDIMI;Patrick;EXG;33
Législatives 2017 - 1er tour;Législatives;2017;1;1;1ère circonscription;36;GENNEVILLIERS;92036;22174;13223;8951;243;8708;BEN M'BAREK Hassan;M;BEN M'BAREK;Hassan;DIV;68
Législatives 2017 - 1er tour;Législatives;2017;1;5;5ème circonscription;44;LEVALLOIS PERRET;92044;41751;17632;24119;255;23864;ZEGHLACHE Derradji;M;ZEGHLACHE;Derradji;ECO;35
Législatives 2017 - 1er tour;Législatives;2017;1;5;5ème circonscription;24;CLICHY;92024;28620;14628;13992;265;13727;FOURNIER Marie-Claude;F;FOURNIER;Marie-Claude;ECO;749
Législatives 2017 - 1er tour;Législatives;2017;1;5;5ème circonscription;24;CLICHY;92024;28620;14628;13992;265;13727;BEAUDOIN Franck;M;BEAUDOIN;Franck;DIV;52
Législatives 2017 - 1er tour;Législatives;2017;1;6;6ème circonscription;51;NEUILLY SUR SEINE;92051;37215;15249;21966;119;21847;MARCEL Françoise;F;MARCEL;Françoise;EXG;17
Présidentielles 2002 - 1er tour;Présidentielles;2002;1;;;20;CHATILLON;92020;18067;5487;12580;295;12285;CHIRAC JACQUES;M;CHIRAC;JACQUES;;2686
Présidentielles 2002 - 1er tour;Présidentielles;2002;1;;;20;CHATILLON;92020;18067;5487;12580;295;12285;BESANCENOT OLIVIER;M;BESANCENOT;OLIVIER;;459
Présidentielles 2002 - 1er tour;Présidentielles;2002;1;;;23;CLAMART;92023;31130;10977;20153;427;19726;MADELIN ALAIN;M;MADELIN;ALAIN;;934
Présidentielles 2002 - 1er tour;Présidentielles;2002;1;;;25;COLOMBES;92025;39608;13654;25954;571;25383;MAMERE NOEL;M;MAMERE;NOEL;;1722
Présidentielles 2002 - 1er tour;Présidentielles;2002;1;;;25;COLOMBES;92025;39608;13654;25954;571;25383;BESANCENOT OLIVIER;M;BESANCENOT;OLIVIER;;987
Présidentielles 2002 - 1er tour;Présidentielles;2002;1;;;33;GARCHES;92033;11708;3920;7788;137;7651;SAINT-JOSSE JEAN;M;SAINT-JOSSE;JEAN;;65
Présidentielles 2002 - 1er tour;Présidentielles;2002;1;;;40;ISSY LES MOULINEAUX;92040;32059;9424;22635;510;22125;BAYROU FRANCOIS;M;BAYROU;FRANCOIS;;2402
Présidentielles 2002 - 1er tour;Présidentielles;2002;1;;;40;ISSY LES MOULINEAUX;92040;32059;9424;22635;510;22125;SAINT-JOSSE JEAN;M;SAINT-JOSSE;JEAN;;210
Présidentielles 2002 - 1er tour;Présidentielles;2002;1;;;44;LEVALLOIS PERRET;92044;33618;9640;23978;575;23403;LE PEN JEAN-MARIE;M;LE PEN;JEAN-MARIE;;2601
Présidentielles 2002 - 2ème tour;Présidentielles;2002;2;;;22;CHAVILLE;92022;12123;2251;9872;345;9527;CHIRAC JACQUES;M;CHIRAC;JACQUES;;8404
Présidentielles 2002 - 2ème tour;Présidentielles;2002;2;;;25;COLOMBES;92025;39599;8138;31461;1186;30275;CHIRAC JACQUES;M;CHIRAC;JACQUES;;26078
Présidentielles 2002 - 2ème tour;Présidentielles;2002;2;;;50;NANTERRE;92050;37592;8741;28851;1099;27752;LE PEN JEAN-MARIE;M;LE PEN;JEAN-MARIE;;3768
Présidentielles 2002 - 2ème tour;Présidentielles;2002;2;;;77;VILLE D'AVRAY;92077;7249;1193;6056;116;5940;LE PEN JEAN-MARIE;M;LE PEN;JEAN-MARIE;;548
Présidentielles 2002 - 2ème tour;Présidentielles;2002;2;;;78;VILLENEUVE LA GARENNE;92078;11406;3421;7985;280;7705;LE PEN JEAN-MARIE;M;LE PEN;JEAN-MARIE;;1310
Présidentielles 2017 - 2ème tour;Présidentielles;2017;2;;;9;BOIS COLOMBES;92009;17896;4085;13811;1216;12595;MACRON Emmanuel;M;MACRON;Emmanuel;;10956
Présidentielles 2007 - 2ème tour;Présidentielles;2007;2;;;7;BAGNEUX;92007;20463;3047;17416;560;16856;ROYAL Ségolène;F;ROYAL;Ségolène;;10797
Présidentielles 2007 - 2ème tour;Présidentielles;2007;2;;;77;VILLE D'AVRAY;92077;7272;712;6560;300;6260;ROYAL Ségolène;F;ROYAL;Ségolène;;1851
Présidentielles 2012 - 2ème tour;Présidentielles;2012;2;;;35;LA GARENNE COLOMBES;92035;17302;2975;14327;653;13674;HOLLANDE François;M;HOLLANDE;François;;5729
Présidentielles 2012 - 2ème tour;Présidentielles;2012;2;;;63;RUEIL MALMAISON;92063;52387;8351;44036;1727;42309;SARKOZY Nicolas;M;SARKOZY;Nicolas;;24011
Présidentielles 2012 - 2ème tour;Présidentielles;2012;2;;;64;SAINT CLOUD;92064;19006;2699;16307;527;15780;SARKOZY Nicolas;M;SARKOZY;Nicolas;;11032
Législatives 2007 - 2ème tour;Législatives;2007;2;5;5ème circonscription;24;CLICHY;92024;28799;13470;15329;1007;14322;BALKANY Patrick;M;BALKANY;Patrick;UMP;5610
Législatives 2007 - 1er tour;Législatives;2007;1;2;2ème circonscription;4;ASNIERES SUR SEINE;92004;44110;17783;26327;312;26015;AESCHLIMANN Manuel;M;AESCHLIMANN;Manuel;UMP;12104
Législatives 2007 - 1er tour;Législatives;2007;1;9;9ème circonscription;12;BOULOGNE BILLANCOURT;92012;60773;22422;38351;535;37816;GOITIA Isabelle;F;GOITIA;Isabelle;COM;370
Législatives 2007 - 1er tour;Législatives;2007;1;9;9ème circonscription;12;BOULOGNE BILLANCOURT;92012;60773;22422;38351;535;37816;PICARD Marianne;F;PICARD;Marianne;DVG;240
Législatives 2007 - 1er tour;Législatives;2007;1;9;9ème circonscription;12;BOULOGNE BILLANCOURT;92012;60773;22422;38351;535;37816;DU REAU Eric;M;DU REAU;Eric;FN;854
Législatives 2007 - 1er tour;Législatives;2007;1;4;4ème circonscription;73;SURESNES;92073;24666;8949;15717;206;15511;FRANCOIS Jean-Michel;M;FRANCOIS;Jean-Michel;EXG;22
Législatives 2007 - 1er tour;Législatives;2007;1;7;7ème circonscription;64;SAINT CLOUD;92064;19115;6812;12303;93;12210;OLLIER Patrick;M;OLLIER;Patrick;UMP;7942
Législatives 2007 - 1er tour;Législatives;2007;1;13;13ème circonscription;71;SCEAUX;92071;14129;4679;9450;74;9376;FONTAN Huguette;F;FONTAN;Huguette;DIV;0
Législatives 2007 - 1er tour;Législatives;2007;1;7;7ème circonscription;64;SAINT CLOUD;92064;19115;6812;12303;93;12210;BARRE Camille;F;BARRE;Camille;COM;76
Législatives 2007 - 1er tour;Législatives;2007;1;8;8ème circonscription;72;SEVRES;92072;14460;5279;9181;151;9030;BOUCHARD Renaud;M;BOUCHARD;Renaud;DIV;6
Législatives 2007 - 1er tour;Législatives;2007;1;3;3ème circonscription;35;LA GARENNE COLOMBES;92035;16552;5947;10605;101;10504;TRIBOULET Catherine;F;TRIBOULET;Catherine;DIV;0
Législatives 2007 - 1er tour;Législatives;2007;1;7;7ème circonscription;33;GARCHES;92033;12286;4601;7685;112;7573;BRISON Christian;M;BRISON;Christian;EXG;9
Législatives 2007 - 1er tour;Législatives;2007;1;7;7ème circonscription;33;GARCHES;92033;12286;4601;7685;112;7573;FARCIS Dominique;M;FARCIS;Dominique;DVD;53
Législatives 2007 - 1er tour;Législatives;2007;1;6;6ème circonscription;51;NEUILLY SUR SEINE;92051;39134;14738;24396;185;24211;FROMANTIN Jean-Christophe;M;FROMANTIN;Jean-Christophe;DIV;3569
Législatives 2007 - 1er tour;Législatives;2007;1;5;5ème circonscription;44;LEVALLOIS PERRET;92044;39466;14724;24742;404;24338;BOUAKKA Lakdar;M;BOUAKKA;Lakdar;DIV;121
Législatives 2007 - 1er tour;Législatives;2007;1;11;11ème circonscription;46;MALAKOFF;92046;18478;7045;11433;204;11229;BONJEAN Hubert;M;BONJEAN;Hubert;FN;406
Législatives 2007 - 1er tour;Législatives;2007;1;12;12ème circonscription;60;LE PLESSIS ROBINSON;92060;16776;5588;11188;123;11065;DELMATTO Geneviève;F;DELMATTO;Geneviève;EXD;23
Législatives 2007 - 1er tour;Législatives;2007;1;6;6ème circonscription;62;PUTEAUX;92062;26791;8829;17962;396;17566;LEPIDI Bernard;M;LEPIDI;Bernard;DVD;657
Législatives 2007 - 1er tour;Législatives;2007;1;3;3ème circonscription;35;LA GARENNE COLOMBES;92035;16552;5947;10605;101;10504;KOSSOWSKI Jacques;M;KOSSOWSKI;Jacques;UMP;5895
Législatives 2007 - 1er tour;Législatives;2007;1;10;10ème circonscription;40;ISSY LES MOULINEAUX;92040;38520;14017;24503;359;24144;WOUTERS Nina;F;WOUTERS;Nina;EXG;392
Législatives 2007 - 1er tour;Législatives;2007;1;1;1ère circonscription;36;GENNEVILLIERS;92036;20048;9522;10526;189;10337;MUZEAU Roland;M;MUZEAU;Roland;COM;5096
Législatives 2007 - 1er tour;Législatives;2007;1;8;8ème circonscription;47;MARNES LA COQUETTE;92047;1074;316;758;5;753;FILLOUX Delphine;F;FILLOUX;Delphine;DIV;5
Législatives 2007 - 1er tour;Législatives;2007;1;10;10ème circonscription;48;MEUDON;92048;5066;1864;3202;29;3173;ALEZARD Lysiane;F;ALEZARD;Lysiane;COM;69
Législatives 2007 - 1er tour;Législatives;2007;1;10;10ème circonscription;48;MEUDON;92048;5066;1864;3202;29;3173;WOUTERS Nina;F;WOUTERS;Nina;EXG;71
Législatives 2017 - 1er tour;Législatives;2017;1;3;3ème circonscription;9;BOIS COLOMBES;92009;17921;7869;10052;437;9615;COURMONT Chloé;F;COURMONT;Chloé;COM;148
Législatives 2017 - 2ème tour;Législatives;2017;2;7;7ème circonscription;33;GARCHES;92033;12777;6612;6165;326;5839;MARILOSSIAN Jacques;M;MARILOSSIAN;Jacques;REM;3329
Législatives 2017 - 2ème tour;Législatives;2017;2;8;8ème circonscription;22;CHAVILLE;92022;13523;6615;6908;568;6340;BOYER Gilles;M;BOYER;Gilles;LR;2257
Législatives 2002 - 1er tour;Législatives;2002;1;6;6ème circonscription;51;NEUILLY SUR SEINE;92051;39134;14738;24396;185;24211;SALIOU Valérie;F;SALIOU;Valérie;VEC;342
Législatives 2002 - 1er tour;Législatives;2002;1;6;6ème circonscription;51;NEUILLY SUR SEINE;92051;39134;14738;24396;185;24211;LEPIDI Bernard;M;LEPIDI;Bernard;DVD;2622
Législatives 2002 - 1er tour;Législatives;2002;1;7;7ème circonscription;64;SAINT CLOUD;92064;19115;6812;12303;93;12210;SAGE Julien;M;SAGE;Julien;VEC;331
Législatives 2002 - 1er tour;Législatives;2002;1;13;13ème circonscription;71;SCEAUX;92071;14129;4679;9450;74;9376;GOURDOL Aimée;F;GOURDOL;Aimée;DVG;51
Législatives 2002 - 1er tour;Législatives;2002;1;8;8ème circonscription;72;SEVRES;92072;14460;5279;9181;151;9030;BEZAULT Christine;F;BEZAULT;Christine;DIV;45
Législatives 2002 - 1er tour;Législatives;2002;1;8;8ème circonscription;72;SEVRES;92072;14460;5279;9181;151;9030;DEQUEANT Annie;F;DEQUEANT;Annie;FN;264
Législatives 2002 - 1er tour;Législatives;2002;1;8;8ème circonscription;76;VAUCRESSON;92076;6076;2206;3870;46;3824;GUILLET Jean-Jacques;M;GUILLET;Jean-Jacques;UMP;2605
Législatives 2002 - 1er tour;Législatives;2002;1;1;1ère circonscription;78;VILLENEUVE LA GARENNE;92078;13038;7211;5827;131;5696;POURDIEU Stéphanie;F;POURDIEU;Stéphanie;MAJ;40
Législatives 2002 - 1er tour;Législatives;2002;1;1;1ère circonscription;78;VILLENEUVE LA GARENNE;92078;13038;7211;5827;131;5696;ROBERT Bertrand;M;ROBERT;Bertrand;EXD;42
Législatives 2002 - 2ème tour;Législatives;2002;2;10;10ème circonscription;40;ISSY LES MOULINEAUX;92040;32364;11826;20538;545;19993;SANTINI ANDRE;M;SANTINI;ANDRE;UDF;12468
Législatives 2002 - 2ème tour;Législatives;2002;2;8;8ème circonscription;48;MEUDON;92048;24187;9753;14434;776;13658;LEVAIN JEAN - MARIE;M;LEVAIN;JEAN - MARIE;PRG;6163
Législatives 2002 - 2ème tour;Législatives;2002;2;8;8ème circonscription;77;VILLE D'AVRAY;92077;7417;2822;4595;216;4379;LEVAIN JEAN - MARIE;M;LEVAIN;JEAN - MARIE;PRG;1339
Législatives 1997 - 2ème tour;Législatives;1997;2;12;12ème circonscription;23;CLAMART;92023;30272;8928;21344;1067;20277;FOUCHER J.PIERRE;M;FOUCHER;J.PIERRE;UDF;10487
Législatives 2012 - 1er tour;Législatives;2012;1;8;8ème circonscription;76;VAUCRESSON;92076;6093;2463;3630;39;3591;GRILLARD Jean;M;GRILLARD;Jean;AUT;5
Législatives 2012 - 1er tour;Législatives;2012;1;8;8ème circonscription;76;VAUCRESSON;92076;6093;2463;3630;39;3591;PAILLARD Christophe;M;PAILLARD;Christophe;AUT;10
Législatives 2012 - 1er tour;Législatives;2012;1;8;8ème circonscription;77;VILLE D'AVRAY;92077;7169;2468;4701;48;4653;TARDIEU Nicolas;M;TARDIEU;Nicolas;ECO;29
Législatives 2002 - 1er tour;Législatives;2002;1;13;13ème circonscription;2;ANTONY;92002;39807;13942;25865;456;25409;CANET Michèle;F;CANET;Michèle;SOC;5861
Législatives 2002 - 1er tour;Législatives;2002;1;13;13ème circonscription;2;ANTONY;92002;39807;13942;25865;456;25409;GOURDOL Aimée;F;GOURDOL;Aimée;DVG;141
Législatives 2002 - 1er tour;Législatives;2002;1;10;10ème circonscription;12;BOULOGNE BILLANCOURT;92012;5551;2367;3184;78;3106;HOCINI Malek;M;HOCINI;Malek;DIV;110
Législatives 2012 - 1er tour;Législatives;2012;1;2;2ème circonscription;4;ASNIERES SUR SEINE;92004;45114;18545;26569;310;26259;MARTIN SAINT LEON Laurent;M;MARTIN SAINT LEON;Laurent;DVD;781
Législatives 2012 - 1er tour;Législatives;2012;1;9;9ème circonscription;12;BOULOGNE BILLANCOURT;92012;61020;24579;36441;340;36101;JOYEUX Odile;F;JOYEUX;Odile;VEC;1067
Législatives 2012 - 1er tour;Législatives;2012;1;10;10ème circonscription;12;BOULOGNE BILLANCOURT;92012;6600;2912;3688;126;3562;ALEZARD Lysiane;F;ALEZARD;Lysiane;FG;233
Législatives 2012 - 1er tour;Législatives;2012;1;8;8ème circonscription;22;CHAVILLE;92022;12808;4688;8120;75;8045;TARDIEU Nicolas;M;TARDIEU;Nicolas;ECO;77
Législatives 2012 - 1er tour;Législatives;2012;1;8;8ème circonscription;22;CHAVILLE;92022;12808;4688;8120;75;8045;CHETAILLE Romain;M;CHETAILLE;Romain;DVD;379
Législatives 2012 - 1er tour;Législatives;2012;1;5;5ème circonscription;24;CLICHY;92024;29276;13521;15755;274;15481;CATOIRE Gilles;M;CATOIRE;Gilles;SOC;6611
Législatives 2012 - 1er tour;Législatives;2012;1;5;5ème circonscription;24;CLICHY;92024;29276;13521;15755;274;15481;ATLANI Alexis;M;ATLANI;Alexis;AUT;141
Législatives 2012 - 1er tour;Législatives;2012;1;1;1ère circonscription;25;COLOMBES;92025;26337;13144;13193;209;12984;LE GAL Anna;F;LE GAL;Anna;ECO;141
Législatives 2012 - 1er tour;Législatives;2012;1;6;6ème circonscription;26;COURBEVOIE;92026;8123;3742;4381;140;4241;PRUVOST Emmanuel;M;PRUVOST;Emmanuel;ECO;89
Législatives 2012 - 1er tour;Législatives;2012;1;12;12ème circonscription;32;FONTENAY AUX ROSES;92032;15230;5971;9259;85;9174;BAVAY Francine;F;BAVAY;Francine;VEC;473
Législatives 2012 - 1er tour;Législatives;2012;1;7;7ème circonscription;33;GARCHES;92033;12412;5093;7319;98;7221;ROSENMAN Gabriel;M;ROSENMAN;Gabriel;EXG;15
Législatives 2012 - 1er tour;Législatives;2012;1;3;3ème circonscription;35;LA GARENNE COLOMBES;92035;17314;7036;10278;79;10199;NATUREL Adélaïde;F;NATUREL;Adélaïde;FG;359
Législatives 2012 - 1er tour;Législatives;2012;1;3;3ème circonscription;35;LA GARENNE COLOMBES;92035;17314;7036;10278;79;10199;FRATELLIA Jacques;M;FRATELLIA;Jacques;AUT;39
Législatives 2012 - 1er tour;Législatives;2012;1;1;1ère circonscription;36;GENNEVILLIERS;92036;20795;10523;10272;192;10080;BEN M'BAREK Hassan;M;BEN M'BAREK;Hassan;AUT;181
Législatives 2012 - 1er tour;Législatives;2012;1;10;10ème circonscription;40;ISSY LES MOULINEAUX;92040;42014;16484;25530;277;25253;GAMBIEZ Fabienne;F;GAMBIEZ;Fabienne;CEN;765
Législatives 2012 - 1er tour;Législatives;2012;1;10;10ème circonscription;40;ISSY LES MOULINEAUX;92040;42014;16484;25530;277;25253;SANTINI André;M;SANTINI;André;NCE;12411
Législatives 2012 - 1er tour;Législatives;2012;1;8;8ème circonscription;47;MARNES LA COQUETTE;92047;1085;330;755;2;753;TARDIEU Nicolas;M;TARDIEU;Nicolas;ECO;2
Législatives 2012 - 1er tour;Législatives;2012;1;8;8ème circonscription;47;MARNES LA COQUETTE;92047;1085;330;755;2;753;PAILLARD Christophe;M;PAILLARD;Christophe;AUT;1
Législatives 2012 - 1er tour;Législatives;2012;1;8;8ème circonscription;48;MEUDON;92048;25002;9709;15293;150;15143;GUILLET Jean-Jacques;M;GUILLET;Jean-Jacques;UMP;5090
Législatives 2012 - 1er tour;Législatives;2012;1;8;8ème circonscription;48;MEUDON;92048;25002;9709;15293;150;15143;BENIERE Louise;F;BENIERE;Louise;DVD;65
Législatives 2012 - 1er tour;Législatives;2012;1;10;10ème circonscription;48;MEUDON;92048;5576;2083;3493;26;3467;SANTINI André;M;SANTINI;André;NCE;1370
Législatives 2012 - 1er tour;Législatives;2012;1;6;6ème circonscription;51;NEUILLY SUR SEINE;92051;37031;14672;22359;177;22182;FAVEUR Franck;M;FAVEUR;Franck;CEN;358
Législatives 2012 - 1er tour;Législatives;2012;1;6;6ème circonscription;51;NEUILLY SUR SEINE;92051;37031;14672;22359;177;22182;DEROCHE François;M;DEROCHE;François;DVD;342
Législatives 2012 - 1er tour;Législatives;2012;1;12;12ème circonscription;60;LE PLESSIS ROBINSON;92060;18785;6274;12511;101;12410;GERMAIN Jean-Marc;M;GERMAIN;Jean-Marc;SOC;3692
Législatives 2012 - 1er tour;Législatives;2012;1;6;6ème circonscription;62;PUTEAUX;92062;28253;11141;17112;441;16671;NEKKAZ Rachid;M;NEKKAZ;Rachid;DVG;0
Législatives 2012 - 1er tour;Législatives;2012;1;4;4ème circonscription;73;SURESNES;92073;26492;10723;15769;302;15467;FOULLON Laure;F;FOULLON;Laure;VEC;509
Législatives 2002 - 1er tour;Législatives;2002;1;5;5ème circonscription;24;CLICHY;92024;28799;12380;16419;297;16122;GALLAIS Alain;M;GALLAIS;Alain;FN;499
Législatives 2002 - 1er tour;Législatives;2002;1;3;3ème circonscription;26;COURBEVOIE;92026;49151;19345;29806;541;29265;SOUILLART Marie-Jeanne;F;SOUILLART;Marie-Jeanne;EXD;76
Législatives 2002 - 1er tour;Législatives;2002;1;12;12ème circonscription;32;FONTENAY AUX ROSES;92032;15468;5605;9863;84;9779;ANTZENBERGER Philippe;M;ANTZENBERGER;Philippe;EXG;218
Législatives 2002 - 1er tour;Législatives;2002;1;5;5ème circonscription;44;LEVALLOIS PERRET;92044;39466;14724;24742;404;24338;CATOIRE Gilles;M;CATOIRE;Gilles;SOC;3860
Législatives 2002 - 1er tour;Législatives;2002;1;8;8ème circonscription;47;MARNES LA COQUETTE;92047;1074;316;758;5;753;BOUCHARD Renaud;M;BOUCHARD;Renaud;DIV;0
Législatives 2002 - 1er tour;Législatives;2002;1;8;8ème circonscription;47;MARNES LA COQUETTE;92047;1074;316;758;5;753;LEHIDEUX Bernard;M;LEHIDEUX;Bernard;UDFD;66
Législatives 2002 - 1er tour;Législatives;2002;1;8;8ème circonscription;48;MEUDON;92048;25427;9683;15744;202;15542;GONNET Nicolas;M;GONNET;Nicolas;COM;334
Législatives 2002 - 1er tour;Législatives;2002;1;8;8ème circonscription;48;MEUDON;92048;25427;9683;15744;202;15542;BEZAULT Christine;F;BEZAULT;Christine;DIV;96
Législatives 2002 - 1er tour;Législatives;2002;1;4;4ème circonscription;50;NANTERRE;92050;42631;18721;23910;314;23596;CREUZET Pierre;M;CREUZET;Pierre;UDFD;2510
Législatives 2002 - 1er tour;Législatives;2002;1;6;6ème circonscription;62;PUTEAUX;92062;26791;8829;17962;396;17566;DANIS Thierry;M;DANIS;Thierry;COM;221
Législatives 2002 - 1er tour;Législatives;2002;1;8;8ème circonscription;76;VAUCRESSON;92076;6076;2206;3870;46;3824;GONNET Nicolas;M;GONNET;Nicolas;COM;20
Législatives 2002 - 1er tour;Législatives;2002;1;8;8ème circonscription;76;VAUCRESSON;92076;6076;2206;3870;46;3824;LEGRAND Pauline;F;LEGRAND;Pauline;EXD;22
Législatives 2002 - 1er tour;Législatives;2002;1;8;8ème circonscription;77;VILLE D'AVRAY;92077;7475;2429;5046;60;4986;BLANCHARD Luc;M;BLANCHARD;Luc;VEC;154
Législatives 1997 - 1er tour;Législatives;1997;1;10;10ème circonscription;12;BOULOGNE BILLANCOURT;92012;4529;1717;2812;99;2713;CRETET PHILIPPE;M;CRETET;PHILIPPE;EXG;32
Législatives 1997 - 1er tour;Législatives;1997;1;5;5ème circonscription;44;LEVALLOIS PERRET;92044;28281;9315;18966;650;18316;FOURNIER ALAIN;M;FOURNIER;ALAIN;ECO;363
Législatives 1997 - 1er tour;Législatives;1997;1;12;12ème circonscription;32;FONTENAY AUX ROSES;92032;14748;4655;10093;259;9834;LECOMTE HERVE;M;LECOMTE;HERVE;EXG;35
Législatives 1997 - 1er tour;Législatives;1997;1;1;1ère circonscription;25;COLOMBES;92025;26238;10153;16085;513;15572;DRUYER J.JACQUES;M;DRUYER;J.JACQUES;DVG;274
Législatives 1997 - 2ème tour;Législatives;1997;2;13;13ème circonscription;2;ANTONY;92002;37772;10363;27409;1400;26009;DEVEDJIAN PATRICK;M;DEVEDJIAN;PATRICK;RPR;14191
Législatives 1997 - 1er tour;Législatives;1997;1;10;10ème circonscription;48;MEUDON;92048;4118;1375;2743;67;2676;WELLENSTEIN CYRIL;M;WELLENSTEIN;CYRIL;DVD;37
Législatives 1997 - 1er tour;Législatives;1997;1;10;10ème circonscription;75;VANVES;92075;15446;4682;10764;329;10435;WELLENSTEIN CYRIL;M;WELLENSTEIN;CYRIL;DVD;120
Législatives 2002 - 2ème tour;Législatives;2002;2;4;4ème circonscription;50;NANTERRE;92050;37881;15862;22019;653;21366;DUPUY CHRISTIAN;M;DUPUY;CHRISTIAN;UMP;8770
Législatives 1997 - 2ème tour;Législatives;1997;2;1;1ère circonscription;36;GENNEVILLIERS;92036;19277;7045;12232;709;11523;LE GALLOU J.YVES;M;LE GALLOU;J.YVES;FRN;2862
Législatives 1997 - 2ème tour;Législatives;1997;2;1;1ère circonscription;36;GENNEVILLIERS;92036;19277;7045;12232;709;11523;BRUNHES JACQUES;M;BRUNHES;JACQUES;COM;8661
Législatives 1997 - 1er tour;Législatives;1997;1;12;12ème circonscription;32;FONTENAY AUX ROSES;92032;14748;4655;10093;259;9834;PEMEZEC PHILIPPE;M;PEMEZEC;PHILIPPE;DVD;1313
Législatives 1997 - 1er tour;Législatives;1997;1;7;7ème circonscription;33;GARCHES;92033;11323;3745;7578;290;7288;MARECHAL CHRISTIAN;M;MARECHAL;CHRISTIAN;FRN;847
Législatives 1997 - 1er tour;Législatives;1997;1;7;7ème circonscription;33;GARCHES;92033;11323;3745;7578;290;7288;CABOT DOMINIQUE;M;CABOT;DOMINIQUE;DIV;56
Législatives 1997 - 2ème tour;Législatives;1997;2;13;13ème circonscription;19;CHATENAY MALABRY;92019;17859;5865;11994;616;11378;MERLE J.FRANCOIS;M;MERLE;J.FRANCOIS;SOC;5682
Législatives 1997 - 2ème tour;Législatives;1997;2;3;3ème circonscription;26;COURBEVOIE;92026;35738;10796;24942;758;24184;HABY J.YVES;M;HABY;J.YVES;UDF;5692
Législatives 1997 - 1er tour;Législatives;1997;1;12;12ème circonscription;60;LE PLESSIS ROBINSON;92060;13002;3860;9142;204;8938;GERMA PHILIPPE;M;GERMA;PHILIPPE;DVD;172
Législatives 1997 - 1er tour;Législatives;1997;1;11;11ème circonscription;49;MONTROUGE;92049;21975;7943;14032;388;13644;BASSINET PHILIPPE;M;BASSINET;PHILIPPE;SOC;3485
Législatives 1997 - 1er tour;Législatives;1997;1;3;3ème circonscription;9;BOIS COLOMBES;92009;14757;5447;9310;293;9017;HABY J.YVES;M;HABY;J.YVES;UDF;1640
Législatives 1993 - 2ème tour;Législatives;1993;2;11;11ème circonscription;49;MONTROUGE;92049;22632;7620;15012;974;14038;ROBERT ALAIN;M;ROBERT;ALAIN;RPR;8040
Législatives 2012 - 2ème tour;Législatives;2012;2;12;12ème circonscription;23;CLAMART;92023;34173;13007;21166;422;20744;GERMAIN Jean-Marc;M;GERMAIN;Jean-Marc;SOC;10836
Législatives 2012 - 2ème tour;Législatives;2012;2;8;8ème circonscription;72;SEVRES;92072;14861;6026;8835;279;8556;LIME-BIFFE Catherine;F;LIME-BIFFE;Catherine;SOC;4264
Législatives 1997 - 1er tour;Législatives;1997;1;2;2ème circonscription;4;ASNIERES SUR SEINE;92004;37154;13729;23425;737;22688;MACE J.PAUL;M;MACE;J.PAUL;EXG;588
Législatives 2012 - 1er tour;Législatives;2012;1;12;12ème circonscription;32;FONTENAY AUX ROSES;92032;15230;5971;9259;85;9174;WAHNICH Sophie;F;WAHNICH;Sophie;AUT;45
Législatives 2012 - 1er tour;Législatives;2012;1;1;1ère circonscription;36;GENNEVILLIERS;92036;20795;10523;10272;192;10080;GUICHARD Isabelle;F;GUICHARD;Isabelle;EXG;59
Législatives 2012 - 1er tour;Législatives;2012;1;1;1ère circonscription;36;GENNEVILLIERS;92036;20795;10523;10272;192;10080;BACHELAY Alexis;M;BACHELAY;Alexis;SOC;2004
Législatives 2012 - 1er tour;Législatives;2012;1;1;1ère circonscription;36;GENNEVILLIERS;92036;20795;10523;10272;192;10080;HALEM Taoufik;M;HALEM;Taoufik;VEC;385
Législatives 2012 - 1er tour;Législatives;2012;1;11;11ème circonscription;49;MONTROUGE;92049;27889;10680;17209;123;17086;BRANAA Jean-Eric;M;BRANAA;Jean-Eric;CEN;181
Législatives 2012 - 1er tour;Législatives;2012;1;4;4ème circonscription;50;NANTERRE;92050;44344;21046;23298;337;22961;HUNAUT Véronique;F;HUNAUT;Véronique;EXG;74
Législatives 2012 - 1er tour;Législatives;2012;1;7;7ème circonscription;64;SAINT CLOUD;92064;19029;7431;11598;97;11501;BARRE Camille;F;BARRE;Camille;FG;183
Législatives 2012 - 1er tour;Législatives;2012;1;7;7ème circonscription;64;SAINT CLOUD;92064;19029;7431;11598;97;11501;HOSTEINS Olivier;M;HOSTEINS;Olivier;CEN;611
Législatives 2012 - 1er tour;Législatives;2012;1;8;8ème circonscription;72;SEVRES;92072;14861;5785;9076;101;8975;TARDIEU Nicolas;M;TARDIEU;Nicolas;ECO;52
Législatives 2012 - 1er tour;Législatives;2012;1;10;10ème circonscription;75;VANVES;92075;17559;6347;11212;104;11108;RONCHINI Vanessa;F;RONCHINI;Vanessa;EXG;33
Législatives 2012 - 1er tour;Législatives;2012;1;8;8ème circonscription;76;VAUCRESSON;92076;6093;2463;3630;39;3591;HENIQUE Philippe;M;HENIQUE;Philippe;EXG;3
Législatives 2012 - 1er tour;Législatives;2012;1;8;8ème circonscription;76;VAUCRESSON;92076;6093;2463;3630;39;3591;TARDIEU Nicolas;M;TARDIEU;Nicolas;ECO;17
Législatives 2012 - 1er tour;Législatives;2012;1;8;8ème circonscription;76;VAUCRESSON;92076;6093;2463;3630;39;3591;BENIERE Louise;F;BENIERE;Louise;DVD;18
Législatives 2012 - 1er tour;Législatives;2012;1;8;8ème circonscription;77;VILLE D'AVRAY;92077;7169;2468;4701;48;4653;GUILLET Jean-Jacques;M;GUILLET;Jean-Jacques;UMP;2136
Législatives 2012 - 1er tour;Législatives;2012;1;1;1ère circonscription;78;VILLENEUVE LA GARENNE;92078;12349;6903;5446;131;5315;BRETON Michel;M;BRETON;Michel;EXG;29
Législatives 2012 - 1er tour;Législatives;2012;1;1;1ère circonscription;78;VILLENEUVE LA GARENNE;92078;12349;6903;5446;131;5315;GRIMAL Jean;M;GRIMAL;Jean;EXG;16
Législatives 2012 - 1er tour;Législatives;2012;1;1;1ère circonscription;78;VILLENEUVE LA GARENNE;92078;12349;6903;5446;131;5315;MELIHI Rachida;F;MELIHI;Rachida;ECO;28
Législatives 1997 - 1er tour;Législatives;1997;1;2;2ème circonscription;25;COLOMBES;92025;17603;6110;11493;415;11078;DECHENOIX CYRILLE;M;DECHENOIX;CYRILLE;DVD;124
Législatives 1997 - 1er tour;Législatives;1997;1;1;1ère circonscription;25;COLOMBES;92025;26238;10153;16085;513;15572;ROBERT ALAIN;M;ROBERT;ALAIN;RPR;3054
Législatives 1997 - 1er tour;Législatives;1997;1;1;1ère circonscription;25;COLOMBES;92025;26238;10153;16085;513;15572;HAMON HENRI;M;HAMON;HENRI;DVD;92
Législatives 1997 - 1er tour;Législatives;1997;1;10;10ème circonscription;48;MEUDON;92048;4118;1375;2743;67;2676;BRUNET FRANCOISE;F;BRUNET;FRANCOISE;EXG;69
Législatives 1997 - 1er tour;Législatives;1997;1;4;4ème circonscription;50;NANTERRE;92050;38533;13799;24734;766;23968;SCHAUB STEPHANE;M;SCHAUB;STEPHANE;DVD;188
Législatives 1997 - 1er tour;Législatives;1997;1;11;11ème circonscription;49;MONTROUGE;92049;21975;7943;14032;388;13644;PIROIS LOUIS;M;PIROIS;LOUIS;EXG;382
Législatives 1997 - 1er tour;Législatives;1997;1;12;12ème circonscription;60;LE PLESSIS ROBINSON;92060;13002;3860;9142;204;8938;MORILLERE DENIS;M;MORILLERE;DENIS;DIV;0
Législatives 1997 - 1er tour;Législatives;1997;1;8;8ème circonscription;22;CHAVILLE;92022;12268;3930;8338;262;8076;MARKOVITCH ISABELLE;F;MARKOVITCH;ISABELLE;DVD;0
Législatives 1997 - 1er tour;Législatives;1997;1;5;5ème circonscription;24;CLICHY;92024;23725;8942;14783;486;14297;COURT MIREILLE;F;COURT;MIREILLE;EXG;120
Législatives 2012 - 1er tour;Législatives;2012;1;11;11ème circonscription;7;BAGNEUX;92007;20609;9648;10961;145;10816;SOMMARUGA Julie;F;SOMMARUGA;Julie;SOC;2761
Législatives 2012 - 1er tour;Législatives;2012;1;3;3ème circonscription;9;BOIS COLOMBES;92009;16783;6763;10020;331;9689;LASSERRE Jean-André;M;LASSERRE;Jean-André;SOC;3285
Législatives 2012 - 1er tour;Législatives;2012;1;9;9ème circonscription;12;BOULOGNE BILLANCOURT;92012;61020;24579;36441;340;36101;GOITIA Isabelle;F;GOITIA;Isabelle;FG;748
Législatives 2012 - 1er tour;Législatives;2012;1;12;12ème circonscription;20;CHATILLON;92020;21681;8265;13416;122;13294;CHIVILO Isabelle;F;CHIVILO;Isabelle;ECO;135
Législatives 2012 - 1er tour;Législatives;2012;1;8;8ème circonscription;22;CHAVILLE;92022;12808;4688;8120;75;8045;CANDELIER Catherine;F;CANDELIER;Catherine;VEC;367
Législatives 2012 - 1er tour;Législatives;2012;1;1;1ère circonscription;25;COLOMBES;92025;26337;13144;13193;209;12984;BEN M'BAREK Hassan;M;BEN M'BAREK;Hassan;AUT;78
Législatives 2012 - 1er tour;Législatives;2012;1;2;2ème circonscription;25;COLOMBES;92025;18458;7115;11343;114;11229;OLIVIER Bruno;M;OLIVIER;Bruno;AUT;12
Législatives 1997 - 1er tour;Législatives;1997;1;13;13ème circonscription;2;ANTONY;92002;37772;12082;25690;861;24829;LETTRON J.PIERRE;M;LETTRON;J.PIERRE;DVG;502
Législatives 1997 - 1er tour;Législatives;1997;1;11;11ème circonscription;7;BAGNEUX;92007;20284;7388;12896;374;12522;FAGES PATRICK;M;FAGES;PATRICK;DVD;60
Législatives 1993 - 2ème tour;Législatives;1993;2;10;10ème circonscription;75;VANVES;92075;15286;4712;10574;664;9910;SANTINI ANDRE;M;SANTINI;ANDRE;UDF;5908
Législatives 1997 - 1er tour;Législatives;1997;1;8;8ème circonscription;76;VAUCRESSON;92076;5546;1861;3685;139;3546;BRISSAUD SOPHIE;F;BRISSAUD;SOPHIE;FRN;443
Législatives 1997 - 1er tour;Législatives;1997;1;10;10ème circonscription;75;VANVES;92075;15446;4682;10764;329;10435;BELLAIRE VALERIE;F;BELLAIRE;VALERIE;DIV;0
Législatives 1997 - 2ème tour;Législatives;1997;2;2;2ème circonscription;4;ASNIERES SUR SEINE;92004;37154;12512;24642;1420;23222;TAITTINGER FRANTZ;M;TAITTINGER;FRANTZ;RPR;13548
Législatives 1997 - 2ème tour;Législatives;1997;2;13;13ème circonscription;2;ANTONY;92002;37772;10363;27409;1400;26009;MERLE J.FRANCOIS;M;MERLE;J.FRANCOIS;SOC;11818
Législatives 2012 - 2ème tour;Législatives;2012;2;9;9ème circonscription;12;BOULOGNE BILLANCOURT;92012;61020;25102;35918;564;35354;EVEN Martine;F;EVEN;Martine;SOC;7864
Législatives 2012 - 2ème tour;Législatives;2012;2;10;10ème circonscription;12;BOULOGNE BILLANCOURT;92012;6600;3010;3590;117;3473;SANTINI André;M;SANTINI;André;NCE;1587
Législatives 2012 - 2ème tour;Législatives;2012;2;12;12ème circonscription;20;CHATILLON;92020;21682;8175;13507;266;13241;GERMAIN Jean-Marc;M;GERMAIN;Jean-Marc;SOC;7038
Législatives 2012 - 2ème tour;Législatives;2012;2;12;12ème circonscription;32;FONTENAY AUX ROSES;92032;15232;6027;9205;223;8982;PEMEZEC Philippe;M;PEMEZEC;Philippe;UMP;3707
Législatives 2012 - 2ème tour;Législatives;2012;2;6;6ème circonscription;62;PUTEAUX;92062;28253;11728;16525;586;15939;FROMANTIN Jean-Christophe;M;FROMANTIN;Jean-Christophe;DVD;5176
Législatives 2002 - 1er tour;Législatives;2002;1;2;2ème circonscription;4;ASNIERES SUR SEINE;92004;44110;17783;26327;312;26015;AESCHLIMANN Manuel;M;AESCHLIMANN;Manuel;UMP;12104
Législatives 2002 - 1er tour;Législatives;2002;1;9;9ème circonscription;12;BOULOGNE BILLANCOURT;92012;60773;22422;38351;535;37816;PAGEARD Michel;M;PAGEARD;Michel;EXD;89
Législatives 2002 - 1er tour;Législatives;2002;1;10;10ème circonscription;12;BOULOGNE BILLANCOURT;92012;5551;2367;3184;78;3106;BOTTET Philippe;M;BOTTET;Philippe;EXG;17
Législatives 2002 - 1er tour;Législatives;2002;1;12;12ème circonscription;20;CHATILLON;92020;20661;7083;13578;137;13441;DIAZ GOMEZ Elisabeth;F;DIAZ GOMEZ;Elisabeth;DIV;1
Législatives 2002 - 1er tour;Législatives;2002;1;5;5ème circonscription;24;CLICHY;92024;28799;12380;16419;297;16122;GOUDAL Emilie;F;GOUDAL;Emilie;EXG;532
Législatives 2002 - 1er tour;Législatives;2002;1;1;1ère circonscription;25;COLOMBES;92025;26192;12273;13919;366;13553;LE GAL Anna;F;LE GAL;Anna;ECO;111
Législatives 2002 - 1er tour;Législatives;2002;1;1;1ère circonscription;25;COLOMBES;92025;26192;12273;13919;366;13553;ROBERT Bertrand;M;ROBERT;Bertrand;EXD;56
Législatives 2002 - 1er tour;Législatives;2002;1;3;3ème circonscription;26;COURBEVOIE;92026;49151;19345;29806;541;29265;KOSSOWSKI Jacques;M;KOSSOWSKI;Jacques;UMP;17108
Législatives 2002 - 1er tour;Législatives;2002;1;10;10ème circonscription;40;ISSY LES MOULINEAUX;92040;38520;14017;24503;359;24144;VIGUIE Laurence;F;VIGUIE;Laurence;EXG;97
Législatives 2002 - 1er tour;Législatives;2002;1;10;10ème circonscription;40;ISSY LES MOULINEAUX;92040;38520;14017;24503;359;24144;TERRET Eugène;M;TERRET;Eugène;FN;558
Législatives 2002 - 1er tour;Législatives;2002;1;5;5ème circonscription;44;LEVALLOIS PERRET;92044;39466;14724;24742;404;24338;REBATO Stéphanie;F;REBATO;Stéphanie;DIV;131
Législatives 2002 - 1er tour;Législatives;2002;1;8;8ème circonscription;47;MARNES LA COQUETTE;92047;1074;316;758;5;753;BLANCHARD Luc;M;BLANCHARD;Luc;VEC;4
Législatives 2002 - 1er tour;Législatives;2002;1;8;8ème circonscription;47;MARNES LA COQUETTE;92047;1074;316;758;5;753;BEZAULT Christine;F;BEZAULT;Christine;DIV;3
Législatives 2002 - 1er tour;Législatives;2002;1;8;8ème circonscription;47;MARNES LA COQUETTE;92047;1074;316;758;5;753;RUSSO Annick;F;RUSSO;Annick;DIV;0
Législatives 2002 - 1er tour;Législatives;2002;1;4;4ème circonscription;50;NANTERRE;92050;42631;18721;23910;314;23596;BOUKHEDIMI Yvonne;F;BOUKHEDIMI;Yvonne;EXG;59
Législatives 2002 - 1er tour;Législatives;2002;1;12;12ème circonscription;60;LE PLESSIS ROBINSON;92060;16776;5588;11188;123;11065;DELVITTO Denis;M;DELVITTO;Denis;DIV;0
Législatives 2002 - 1er tour;Législatives;2002;1;6;6ème circonscription;62;PUTEAUX;92062;26791;8829;17962;396;17566;OLIVIER Pascal;M;OLIVIER;Pascal;DVG;39
Législatives 2002 - 1er tour;Législatives;2002;1;7;7ème circonscription;63;RUEIL MALMAISON;92063;51481;18902;32579;337;32242;INDJIAN Patrick;M;INDJIAN;Patrick;DVG;122
Législatives 2002 - 1er tour;Législatives;2002;1;7;7ème circonscription;63;RUEIL MALMAISON;92063;51481;18902;32579;337;32242;BITTERLIN Anne;F;BITTERLIN;Anne;ECO;237
Législatives 2002 - 1er tour;Législatives;2002;1;13;13ème circonscription;71;SCEAUX;92071;14129;4679;9450;74;9376;DELRIEU Denis;M;DELRIEU;Denis;VEC;314
Législatives 2002 - 1er tour;Législatives;2002;1;13;13ème circonscription;71;SCEAUX;92071;14129;4679;9450;74;9376;BRAULT Chantal;F;BRAULT;Chantal;UDFD;2012
Législatives 2002 - 1er tour;Législatives;2002;1;8;8ème circonscription;72;SEVRES;92072;14460;5279;9181;151;9030;LEHIDEUX Bernard;M;LEHIDEUX;Bernard;UDFD;1205
Législatives 2002 - 1er tour;Législatives;2002;1;4;4ème circonscription;73;SURESNES;92073;24666;8949;15717;206;15511;LE ROUX Cécile;M;LE ROUX;Cécile;DIV;7
Législatives 2002 - 1er tour;Législatives;2002;1;8;8ème circonscription;77;VILLE D'AVRAY;92077;7475;2429;5046;60;4986;SUCHARD Sophie;F;SUCHARD;Sophie;EXG;6
Législatives 2002 - 1er tour;Législatives;2002;1;1;1ère circonscription;78;VILLENEUVE LA GARENNE;92078;13038;7211;5827;131;5696;BEN M'BAREK Hassan;M;BEN M'BAREK;Hassan;DIV;72
Législatives 2002 - 1er tour;Législatives;2002;1;1;1ère circonscription;78;VILLENEUVE LA GARENNE;92078;13038;7211;5827;131;5696;VIGNON Véronique;F;VIGNON;Véronique;UMP;2148
Législatives 2002 - 2ème tour;Législatives;2002;2;7;7ème circonscription;33;GARCHES;92033;11902;4852;7050;170;6880;OLLIER PATRICK;M;OLLIER;PATRICK;UMP;4968
Législatives 2002 - 2ème tour;Législatives;2002;2;1;1ère circonscription;36;GENNEVILLIERS;92036;18324;8861;9463;271;9192;BARTHE CECILE;F;BARTHE;CECILE;UMP;2507
Législatives 2002 - 2ème tour;Législatives;2002;2;12;12ème circonscription;60;LE PLESSIS ROBINSON;92060;14602;5016;9586;213;9373;PEMEZEC PHILIPPE;M;PEMEZEC;PHILIPPE;RPF;5750
Législatives 2002 - 2ème tour;Législatives;2002;2;7;7ème circonscription;63;RUEIL MALMAISON;92063;48901;20615;28286;986;27300;NADOR SOUHILA;F;NADOR;SOUHILA;SOC;9586
Législatives 1997 - 1er tour;Législatives;1997;1;13;13ème circonscription;19;CHATENAY MALABRY;92019;17859;6462;11397;367;11030;DEVEDJIAN PATRICK;M;DEVEDJIAN;PATRICK;RPR;3479
Législatives 1997 - 1er tour;Législatives;1997;1;8;8ème circonscription;48;MEUDON;92048;24248;8136;16112;629;15483;ARIA D DANIELA;F;ARIA D;DANIELA;DIV;0
Législatives 1997 - 2ème tour;Législatives;1997;2;13;13ème circonscription;71;SCEAUX;92071;13168;3546;9622;450;9172;DEVEDJIAN PATRICK;M;DEVEDJIAN;PATRICK;RPR;5757
Législatives 1997 - 2ème tour;Législatives;1997;2;8;8ème circonscription;72;SEVRES;92072;13776;3819;9957;476;9481;LEVAIN JEAN;M;LEVAIN;JEAN;PRS;4193
Législatives 1997 - 1er tour;Législatives;1997;1;7;7ème circonscription;33;GARCHES;92033;11323;3745;7578;290;7288;PACOURET J.RAYMOND;M;PACOURET;J.RAYMOND;COM;257
Législatives 2002 - 1er tour;Législatives;2002;1;13;13ème circonscription;2;ANTONY;92002;39807;13942;25865;456;25409;SARFATI André;M;SARFATI;André;DIV;147
Présidentielles 1995 - 1er tour;Présidentielles;1995;1;;;2;ANTONY;92002;37894;9274;28620;590;28030;LE PEN J.MARIE;M;LE PEN;J.MARIE;;2935
Présidentielles 2017 - 1er tour;Présidentielles;2017;1;;;2;ANTONY;92002;41488;6486;35002;776;34226;CHEMINADE Jacques;M;CHEMINADE;Jacques;;67
Présidentielles 2017 - 1er tour;Présidentielles;2017;1;;;4;ASNIERES SUR SEINE;92004;48227;8578;39649;807;38842;LASSALLE Jean;M;LASSALLE;Jean;;215
Présidentielles 2017 - 1er tour;Présidentielles;2017;1;;;7;BAGNEUX;92007;21873;5369;16504;428;16076;CHEMINADE Jacques;M;CHEMINADE;Jacques;;20
Présidentielles 2017 - 1er tour;Présidentielles;2017;1;;;9;BOIS COLOMBES;92009;17896;3242;14654;318;14336;LE PEN Marine;F;LE PEN;Marine;;955
Présidentielles 2017 - 1er tour;Présidentielles;2017;1;;;14;BOURG LA REINE;92014;13769;2202;11567;212;11355;LE PEN Marine;F;LE PEN;Marine;;608
Présidentielles 2017 - 1er tour;Présidentielles;2017;1;;;32;FONTENAY AUX ROSES;92032;16036;3739;12297;218;12078;MÉLENCHON Jean-Luc;M;MÉLENCHON;Jean-Luc;;2496
Présidentielles 2017 - 1er tour;Présidentielles;2017;1;;;46;MALAKOFF;92046;18434;3186;15248;268;14979;ARTHAUD Nathalie;F;ARTHAUD;Nathalie;;68
Présidentielles 2017 - 1er tour;Présidentielles;2017;1;;;47;MARNES LA COQUETTE;92047;1215;171;1044;5;1039;DUPONT-AIGNAN Nicolas;M;DUPONT-AIGNAN;Nicolas;;19
Présidentielles 2017 - 1er tour;Présidentielles;2017;1;;;63;RUEIL MALMAISON;92063;54426;9298;45128;713;44414;ARTHAUD Nathalie;F;ARTHAUD;Nathalie;;140
Présidentielles 2017 - 1er tour;Présidentielles;2017;1;;;71;SCEAUX;92071;15052;2914;12138;145;11993;MACRON Emmanuel;M;MACRON;Emmanuel;;4507
Présidentielles 2017 - 1er tour;Présidentielles;2017;1;;;72;SEVRES;92072;15142;2166;12976;213;12763;LE PEN Marine;F;LE PEN;Marine;;755
Présidentielles 2017 - 1er tour;Présidentielles;2017;1;;;73;SURESNES;92073;28497;4342;24155;520;23635;LE PEN Marine;F;LE PEN;Marine;;1940
Présidentielles 2017 - 1er tour;Présidentielles;2017;1;;;73;SURESNES;92073;28497;4342;24155;520;23635;MACRON Emmanuel;M;MACRON;Emmanuel;;8054
Présidentielles 2017 - 1er tour;Présidentielles;2017;1;;;76;VAUCRESSON;92076;6176;835;5341;72;5269;POUTOU Philippe;M;POUTOU;Philippe;;15
Présidentielles 2017 - 1er tour;Présidentielles;2017;1;;;77;VILLE D'AVRAY;92077;7433;837;6596;89;6507;DUPONT-AIGNAN Nicolas;M;DUPONT-AIGNAN;Nicolas;;160
Présidentielles 2017 - 1er tour;Présidentielles;2017;1;;;78;VILLENEUVE LA GARENNE;92078;12429;3872;8557;315;8242;CHEMINADE Jacques;M;CHEMINADE;Jacques;;11
Présidentielles 2017 - 2ème tour;Présidentielles;2017;2;;;20;CHATILLON;92020;22292;4814;17478;1509;15969;LE PEN Marine;F;LE PEN;Marine;;2486
Présidentielles 2017 - 2ème tour;Présidentielles;2017;2;;;26;COURBEVOIE;92026;52391;12550;39841;3469;36372;MACRON Emmanuel;M;MACRON;Emmanuel;;31237
Présidentielles 2017 - 2ème tour;Présidentielles;2017;2;;;44;LEVALLOIS PERRET;92044;41716;8651;33065;2640;30425;LE PEN Marine;F;LE PEN;Marine;;4259
Présidentielles 2017 - 2ème tour;Présidentielles;2017;2;;;47;MARNES LA COQUETTE;92047;1215;249;966;96;870;MACRON Emmanuel;M;MACRON;Emmanuel;;731
Présidentielles 2017 - 2ème tour;Présidentielles;2017;2;;;51;NEUILLY SUR SEINE;92051;37186;6787;30399;2384;28015;LE PEN Marine;F;LE PEN;Marine;;3144
Présidentielles 2017 - 2ème tour;Présidentielles;2017;2;;;76;VAUCRESSON;92076;6176;1207;4969;427;4542;LE PEN Marine;F;LE PEN;Marine;;557
Législatives 2007 - 1er tour;Législatives;2007;1;11;11ème circonscription;46;MALAKOFF;92046;18478;7045;11433;204;11229;BOUKHEDIMI Patrick;M;BOUKHEDIMI;Patrick;EXG;44
Législatives 2007 - 1er tour;Législatives;2007;1;11;11ème circonscription;46;MALAKOFF;92046;18478;7045;11433;204;11229;AMIABLE Marie-Hélène;F;AMIABLE;Marie-Hélène;COM;4461
Législatives 2007 - 1er tour;Législatives;2007;1;8;8ème circonscription;48;MEUDON;92048;25427;9683;15744;202;15542;RAFFALI Danielle;F;RAFFALI;Danielle;ECO;184
Législatives 2007 - 1er tour;Législatives;2007;1;4;4ème circonscription;50;NANTERRE;92050;42631;18721;23910;314;23596;DUPUY Christian;M;DUPUY;Christian;UMP;6409
Législatives 2007 - 1er tour;Législatives;2007;1;6;6ème circonscription;51;NEUILLY SUR SEINE;92051;39134;14738;24396;185;24211;DANIS Thierry;M;DANIS;Thierry;COM;64
Législatives 2007 - 1er tour;Législatives;2007;1;6;6ème circonscription;51;NEUILLY SUR SEINE;92051;39134;14738;24396;185;24211;LARAQUE Isabelle;F;LARAQUE;Isabelle;EXD;111
Législatives 2007 - 1er tour;Législatives;2007;1;12;12ème circonscription;60;LE PLESSIS ROBINSON;92060;16776;5588;11188;123;11065;KALTENBACH Philippe;M;KALTENBACH;Philippe;SOC;2450
Législatives 2007 - 1er tour;Législatives;2007;1;7;7ème circonscription;64;SAINT CLOUD;92064;19115;6812;12303;93;12210;INDJIAN Patrick;M;INDJIAN;Patrick;DVG;30
Législatives 2007 - 1er tour;Législatives;2007;1;13;13ème circonscription;71;SCEAUX;92071;14129;4679;9450;74;9376;BASTIDE Anne;F;BASTIDE;Anne;ECO;85
Législatives 2007 - 1er tour;Législatives;2007;1;8;8ème circonscription;72;SEVRES;92072;14460;5279;9181;151;9030;BEZAULT Christine;F;BEZAULT;Christine;DIV;45
Législatives 2007 - 1er tour;Législatives;2007;1;8;8ème circonscription;76;VAUCRESSON;92076;6076;2206;3870;46;3824;DEQUEANT Annie;F;DEQUEANT;Annie;FN;111
Législatives 2007 - 1er tour;Législatives;2007;1;8;8ème circonscription;77;VILLE D'AVRAY;92077;7475;2429;5046;60;4986;BOUCHARD Renaud;M;BOUCHARD;Renaud;DIV;3
Législatives 2007 - 2ème tour;Législatives;2007;2;2;2ème circonscription;4;ASNIERES SUR SEINE;92004;44102;20511;23591;887;22704;ETCHEBERRY Michèle;F;ETCHEBERRY;Michèle;SOC;9854
Législatives 2007 - 2ème tour;Législatives;2007;2;13;13ème circonscription;19;CHATENAY MALABRY;92019;17835;7350;10485;421;10064;DEVEDJIAN Patrick;M;DEVEDJIAN;Patrick;UMP;5229
Législatives 2007 - 2ème tour;Législatives;2007;2;1;1ère circonscription;36;GENNEVILLIERS;92036;20048;9832;10216;209;10007;VIGNON Véronique;F;VIGNON;Véronique;UMP;2540
Législatives 2007 - 2ème tour;Législatives;2007;2;10;10ème circonscription;40;ISSY LES MOULINEAUX;92040;38521;16323;22198;726;21472;SCHMID Lucille;F;SCHMID;Lucille;SOC;8857
Législatives 2007 - 1er tour;Législatives;2007;1;3;3ème circonscription;35;LA GARENNE COLOMBES;92035;16552;5947;10605;101;10504;MARCEL Françoise;F;MARCEL;Françoise;EXG;57
Législatives 2007 - 1er tour;Législatives;2007;1;1;1ère circonscription;36;GENNEVILLIERS;92036;20048;9522;10526;189;10337;LE GAL Anna;F;LE GAL;Anna;ECO;72
Législatives 2007 - 1er tour;Législatives;2007;1;9;9ème circonscription;12;BOULOGNE BILLANCOURT;92012;60773;22422;38351;535;37816;GROLIERE Catherine;F;GROLIERE;Catherine;ECO;254
Législatives 2007 - 1er tour;Législatives;2007;1;9;9ème circonscription;12;BOULOGNE BILLANCOURT;92012;60773;22422;38351;535;37816;PINEAU Dorothée;F;PINEAU;Dorothée;DVD;4129
Législatives 2007 - 1er tour;Législatives;2007;1;11;11ème circonscription;7;BAGNEUX;92007;20520;8538;11982;178;11804;PICARD Catherine;F;PICARD;Catherine;SOC;1910
Législatives 2007 - 1er tour;Législatives;2007;1;2;2ème circonscription;25;COLOMBES;92025;18336;7144;11192;207;10985;POURBAGHER Francis;M;POURBAGHER;Francis;DVD;59
Législatives 2007 - 1er tour;Législatives;2007;1;1;1ère circonscription;25;COLOMBES;92025;26192;12273;13919;366;13553;GUICHARD Isabelle;F;GUICHARD;Isabelle;EXG;240
Législatives 2007 - 1er tour;Législatives;2007;1;12;12ème circonscription;23;CLAMART;92023;32916;11487;21429;154;21275;PEMEZEC Philippe;M;PEMEZEC;Philippe;UMP;9267
Législatives 2007 - 1er tour;Législatives;2007;1;1;1ère circonscription;36;GENNEVILLIERS;92036;20048;9522;10526;189;10337;KADUR Alexandre;M;KADUR;Alexandre;DVD;28
Législatives 2007 - 1er tour;Législatives;2007;1;13;13ème circonscription;19;CHATENAY MALABRY;92019;17835;6584;11251;211;11040;LEPEUVE Stéphane;M;LEPEUVE;Stéphane;EXG;281
Législatives 2007 - 1er tour;Législatives;2007;1;13;13ème circonscription;19;CHATENAY MALABRY;92019;17835;6584;11251;211;11040;GOURDOL Aimée;F;GOURDOL;Aimée;DVG;66
Législatives 2007 - 1er tour;Législatives;2007;1;13;13ème circonscription;14;BOURG LA REINE;92014;13381;4391;8990;78;8912;BASTIDE Anne;F;BASTIDE;Anne;ECO;71
Législatives 2007 - 1er tour;Législatives;2007;1;12;12ème circonscription;20;CHATILLON;92020;20661;7083;13578;137;13441;KALTENBACH Philippe;M;KALTENBACH;Philippe;SOC;4107
Législatives 2007 - 1er tour;Législatives;2007;1;8;8ème circonscription;22;CHAVILLE;92022;12928;4682;8246;120;8126;BEZAULT Christine;F;BEZAULT;Christine;DIV;42
Législatives 2007 - 1er tour;Législatives;2007;1;8;8ème circonscription;22;CHAVILLE;92022;12928;4682;8246;120;8126;RAFFALI Danielle;F;RAFFALI;Danielle;ECO;81
Législatives 2007 - 1er tour;Législatives;2007;1;8;8ème circonscription;22;CHAVILLE;92022;12928;4682;8246;120;8126;LEGRAND Pauline;F;LEGRAND;Pauline;EXD;41
Présidentielles 2002 - 1er tour;Présidentielles;2002;1;;;2;ANTONY;92002;36989;11047;25942;517;25425;MEGRET BRUNO;M;MEGRET;BRUNO;;389
Présidentielles 2002 - 1er tour;Présidentielles;2002;1;;;4;ASNIERES SUR SEINE;92004;35702;11271;24431;515;23916;BAYROU FRANCOIS;M;BAYROU;FRANCOIS;;1944
Présidentielles 2002 - 1er tour;Présidentielles;2002;1;;;7;BAGNEUX;92007;18489;5873;12616;519;12097;SAINT-JOSSE JEAN;M;SAINT-JOSSE;JEAN;;88
Présidentielles 2002 - 1er tour;Présidentielles;2002;1;;;9;BOIS COLOMBES;92009;13996;4554;9442;200;9242;CHIRAC JACQUES;M;CHIRAC;JACQUES;;2277
Présidentielles 2002 - 1er tour;Présidentielles;2002;1;;;9;BOIS COLOMBES;92009;13996;4554;9442;200;9242;LAGUILLER ARLETTE;F;LAGUILLER;ARLETTE;;317
Présidentielles 2002 - 1er tour;Présidentielles;2002;1;;;19;CHATENAY MALABRY;92019;15965;4483;11482;241;11241;MEGRET BRUNO;M;MEGRET;BRUNO;;168
Présidentielles 2002 - 1er tour;Présidentielles;2002;1;;;19;CHATENAY MALABRY;92019;15965;4483;11482;241;11241;GLUCKSTEIN DANIEL;M;GLUCKSTEIN;DANIEL;;38
Présidentielles 2002 - 1er tour;Présidentielles;2002;1;;;20;CHATILLON;92020;18067;5487;12580;295;12285;GLUCKSTEIN DANIEL;M;GLUCKSTEIN;DANIEL;;61
Présidentielles 2002 - 1er tour;Présidentielles;2002;1;;;20;CHATILLON;92020;18067;5487;12580;295;12285;BAYROU FRANCOIS;M;BAYROU;FRANCOIS;;977
Présidentielles 2002 - 1er tour;Présidentielles;2002;1;;;20;CHATILLON;92020;18067;5487;12580;295;12285;JOSPIN LIONEL;M;JOSPIN;LIONEL;;2324
Présidentielles 2002 - 1er tour;Présidentielles;2002;1;;;23;CLAMART;92023;31130;10977;20153;427;19726;CHIRAC JACQUES;M;CHIRAC;JACQUES;;4073
Présidentielles 2002 - 1er tour;Présidentielles;2002;1;;;24;CLICHY;92024;24491;8395;16096;399;15697;GLUCKSTEIN DANIEL;M;GLUCKSTEIN;DANIEL;;77
Présidentielles 2002 - 1er tour;Présidentielles;2002;1;;;24;CLICHY;92024;24491;8395;16096;399;15697;BOUTIN CHRISTINE;F;BOUTIN;CHRISTINE;;88
Présidentielles 2002 - 1er tour;Présidentielles;2002;1;;;25;COLOMBES;92025;39608;13654;25954;571;25383;GLUCKSTEIN DANIEL;M;GLUCKSTEIN;DANIEL;;115
Présidentielles 2002 - 1er tour;Présidentielles;2002;1;;;25;COLOMBES;92025;39608;13654;25954;571;25383;SAINT-JOSSE JEAN;M;SAINT-JOSSE;JEAN;;225
Présidentielles 2002 - 1er tour;Présidentielles;2002;1;;;26;COURBEVOIE;92026;39941;11959;27982;520;27462;MAMERE NOEL;M;MAMERE;NOEL;;1552
Présidentielles 2002 - 1er tour;Présidentielles;2002;1;;;35;LA GARENNE COLOMBES;92035;15006;5167;9839;227;9612;MAMERE NOEL;M;MAMERE;NOEL;;486
Présidentielles 2002 - 1er tour;Présidentielles;2002;1;;;40;ISSY LES MOULINEAUX;92040;32059;9424;22635;510;22125;CHEVENEMENT JEAN-PIERRE;M;CHEVENEMENT;JEAN-PIERRE;;1517
Présidentielles 2002 - 1er tour;Présidentielles;2002;1;;;47;MARNES LA COQUETTE;92047;997;272;725;7;718;HUE ROBERT;M;HUE;ROBERT;;5
Présidentielles 2002 - 1er tour;Présidentielles;2002;1;;;48;MEUDON;92048;28283;9341;18942;321;18621;TAUBIRA CHRISTIANE;F;TAUBIRA;CHRISTIANE;;579
Présidentielles 2002 - 1er tour;Présidentielles;2002;1;;;49;MONTROUGE;92049;23382;8142;15240;301;14939;LEPAGE CORINNE;F;LEPAGE;CORINNE;;367
Présidentielles 2002 - 1er tour;Présidentielles;2002;1;;;60;LE PLESSIS ROBINSON;92060;14503;4736;9767;230;9537;TAUBIRA CHRISTIANE;F;TAUBIRA;CHRISTIANE;;307
Présidentielles 2002 - 1er tour;Présidentielles;2002;1;;;62;PUTEAUX;92062;23861;6804;17057;487;16570;JOSPIN LIONEL;M;JOSPIN;LIONEL;;2642
Présidentielles 2002 - 1er tour;Présidentielles;2002;1;;;63;RUEIL MALMAISON;92063;48302;17158;31144;693;30451;TAUBIRA CHRISTIANE;F;TAUBIRA;CHRISTIANE;;774
Présidentielles 2002 - 1er tour;Présidentielles;2002;1;;;71;SCEAUX;92071;12917;3930;8987;154;8833;JOSPIN LIONEL;M;JOSPIN;LIONEL;;1595
Présidentielles 2002 - 1er tour;Présidentielles;2002;1;;;72;SEVRES;92072;13367;4140;9227;153;9074;LEPAGE CORINNE;F;LEPAGE;CORINNE;;287
Présidentielles 2002 - 1er tour;Présidentielles;2002;1;;;76;VAUCRESSON;92076;5861;2048;3813;62;3751;CHEVENEMENT JEAN-PIERRE;M;CHEVENEMENT;JEAN-PIERRE;;212
Présidentielles 2002 - 1er tour;Présidentielles;2002;1;;;76;VAUCRESSON;92076;5861;2048;3813;62;3751;MADELIN ALAIN;M;MADELIN;ALAIN;;380
Présidentielles 2002 - 1er tour;Présidentielles;2002;1;;;78;VILLENEUVE LA GARENNE;92078;11406;4746;6660;180;6480;JOSPIN LIONEL;M;JOSPIN;LIONEL;;1199
Présidentielles 2002 - 1er tour;Présidentielles;2002;1;;;78;VILLENEUVE LA GARENNE;92078;11406;4746;6660;180;6480;CHEVENEMENT JEAN-PIERRE;M;CHEVENEMENT;JEAN-PIERRE;;338
Présidentielles 2007 - 1er tour;Présidentielles;2007;1;;;2;ANTONY;92002;39316;4695;34621;413;34208;BOVÉ José;M;BOVÉ;José;;326
Présidentielles 2007 - 1er tour;Présidentielles;2007;1;;;2;ANTONY;92002;39316;4695;34621;413;34208;VOYNET Dominique;F;VOYNET;Dominique;;575
Présidentielles 2007 - 1er tour;Présidentielles;2007;1;;;2;ANTONY;92002;39316;4695;34621;413;34208;NIHOUS Frédéric;M;NIHOUS;Frédéric;;105
Présidentielles 2007 - 1er tour;Présidentielles;2007;1;;;4;ASNIERES SUR SEINE;92004;43605;5665;37940;436;37504;BUFFET Marie-George;F;BUFFET;Marie-George;;314
Présidentielles 2007 - 1er tour;Présidentielles;2007;1;;;7;BAGNEUX;92007;20438;2809;17629;261;17368;ROYAL Ségolène;F;ROYAL;Ségolène;;6441
Présidentielles 2007 - 1er tour;Présidentielles;2007;1;;;9;BOIS COLOMBES;92009;16113;2534;13579;152;13427;ROYAL Ségolène;F;ROYAL;Ségolène;;3332
Présidentielles 2007 - 1er tour;Présidentielles;2007;1;;;24;CLICHY;92024;28539;4472;24067;245;23822;SCHIVARDI Gérard;M;SCHIVARDI;Gérard;;75
Présidentielles 2007 - 1er tour;Présidentielles;2007;1;;;26;COURBEVOIE;92026;48308;7118;41190;456;40734;LAGUILLER Arlette;F;LAGUILLER;Arlette;;228
Présidentielles 2007 - 1er tour;Présidentielles;2007;1;;;32;FONTENAY AUX ROSES;92032;15234;2027;13207;123;13084;BUFFET Marie-George;F;BUFFET;Marie-George;;252
Présidentielles 2007 - 1er tour;Présidentielles;2007;1;;;33;GARCHES;92033;11957;1346;10611;106;10505;SCHIVARDI Gérard;M;SCHIVARDI;Gérard;;6
Présidentielles 2007 - 1er tour;Présidentielles;2007;1;;;36;GENNEVILLIERS;92036;19890;3536;16354;259;16095;BESANCENOT Olivier;M;BESANCENOT;Olivier;;884
Présidentielles 2007 - 1er tour;Présidentielles;2007;1;;;36;GENNEVILLIERS;92036;19890;3536;16354;259;16095;BAYROU François;M;BAYROU;François;;2371
Présidentielles 2007 - 1er tour;Présidentielles;2007;1;;;36;GENNEVILLIERS;92036;19890;3536;16354;259;16095;ROYAL Ségolène;F;ROYAL;Ségolène;;6492
Présidentielles 2007 - 1er tour;Présidentielles;2007;1;;;40;ISSY LES MOULINEAUX;92040;37966;4920;33046;365;32681;BAYROU François;M;BAYROU;François;;8311
Présidentielles 2007 - 1er tour;Présidentielles;2007;1;;;40;ISSY LES MOULINEAUX;92040;37966;4920;33046;365;32681;BOVÉ José;M;BOVÉ;José;;260
Présidentielles 2007 - 1er tour;Présidentielles;2007;1;;;40;ISSY LES MOULINEAUX;92040;37966;4920;33046;365;32681;ROYAL Ségolène;F;ROYAL;Ségolène;;8738
Présidentielles 2007 - 1er tour;Présidentielles;2007;1;;;40;ISSY LES MOULINEAUX;92040;37966;4920;33046;365;32681;LE PEN Jean-Marie;M;LE PEN;Jean-Marie;;1576
Présidentielles 2007 - 1er tour;Présidentielles;2007;1;;;47;MARNES LA COQUETTE;92047;1054;91;963;9;954;LE PEN Jean-Marie;M;LE PEN;Jean-Marie;;48
Présidentielles 2007 - 1er tour;Présidentielles;2007;1;;;50;NANTERRE;92050;42083;6117;35966;477;35489;de VILLIERS Philippe;M;de VILLIERS;Philippe;;412
Présidentielles 2007 - 1er tour;Présidentielles;2007;1;;;62;PUTEAUX;92062;26761;3397;23364;263;23101;de VILLIERS Philippe;M;de VILLIERS;Philippe;;282
Présidentielles 2007 - 1er tour;Présidentielles;2007;1;;;62;PUTEAUX;92062;26761;3397;23364;263;23101;NIHOUS Frédéric;M;NIHOUS;Frédéric;;79
Présidentielles 2007 - 1er tour;Présidentielles;2007;1;;;64;SAINT CLOUD;92064;18455;1926;16529;91;16438;ROYAL Ségolène;F;ROYAL;Ségolène;;2411
Présidentielles 2007 - 1er tour;Présidentielles;2007;1;;;72;SEVRES;92072;14178;1738;12440;129;12311;LAGUILLER Arlette;F;LAGUILLER;Arlette;;62
Présidentielles 2007 - 1er tour;Présidentielles;2007;1;;;73;SURESNES;92073;24255;2600;21655;272;21383;BOVÉ José;M;BOVÉ;José;;157
Présidentielles 2007 - 1er tour;Présidentielles;2007;1;;;75;VANVES;92075;17139;2129;15010;126;14884;VOYNET Dominique;F;VOYNET;Dominique;;273
Présidentielles 2012 - 1er tour;Présidentielles;2012;1;;;25;COLOMBES;92025;44741;10181;34560;526;34034;POUTOU Philippe;M;POUTOU;Philippe;;289
Présidentielles 2012 - 1er tour;Présidentielles;2012;1;;;26;COURBEVOIE;92026;50576;11277;39299;681;38618;SARKOZY Nicolas;M;SARKOZY;Nicolas;;15158
Présidentielles 2012 - 1er tour;Présidentielles;2012;1;;;33;GARCHES;92033;12388;2501;9887;167;9720;ARTHAUD Nathalie;F;ARTHAUD;Nathalie;;13
Présidentielles 2012 - 1er tour;Présidentielles;2012;1;;;46;MALAKOFF;92046;18852;4162;14690;207;14483;LE PEN Marine;F;LE PEN;Marine;;1412
Présidentielles 2012 - 1er tour;Présidentielles;2012;1;;;47;MARNES LA COQUETTE;92047;1082;163;919;8;911;CHEMINADE Jacques;M;CHEMINADE;Jacques;;1
Présidentielles 2012 - 1er tour;Présidentielles;2012;1;;;49;MONTROUGE;92049;27851;5527;22324;289;22035;POUTOU Philippe;M;POUTOU;Philippe;;171
Présidentielles 2012 - 1er tour;Présidentielles;2012;1;;;51;NEUILLY SUR SEINE;92051;37003;5964;31039;257;30782;HOLLANDE François;M;HOLLANDE;François;;3132
Présidentielles 2012 - 1er tour;Présidentielles;2012;1;;;63;RUEIL MALMAISON;92063;52385;10540;41845;580;41265;SARKOZY Nicolas;M;SARKOZY;Nicolas;;15865
Présidentielles 2012 - 1er tour;Présidentielles;2012;1;;;75;VANVES;92075;17512;3079;14433;161;14272;JOLY Eva;F;JOLY;Eva;;507
Présidentielles 2012 - 1er tour;Présidentielles;2012;1;;;76;VAUCRESSON;92076;6089;1241;4848;74;4774;POUTOU Philippe;M;POUTOU;Philippe;;15
Présidentielles 2012 - 1er tour;Présidentielles;2012;1;;;76;VAUCRESSON;92076;6089;1241;4848;74;4774;BAYROU François;M;BAYROU;François;;558
Présidentielles 1995 - 1er tour;Présidentielles;1995;1;;;24;CLICHY;92024;24688;6820;17868;364;17504;VILLIERS DE PHILIPPE;M;VILLIERS DE;PHILIPPE;;473
Présidentielles 1995 - 1er tour;Présidentielles;1995;1;;;40;ISSY LES MOULINEAUX;92040;30054;8139;21915;444;21471;VILLIERS DE PHILIPPE;M;VILLIERS DE;PHILIPPE;;636
Présidentielles 1995 - 1er tour;Présidentielles;1995;1;;;44;LEVALLOIS PERRET;92044;29477;6881;22596;402;22194;LAGUILLER ARLETTE;F;LAGUILLER;ARLETTE;;977
Présidentielles 1995 - 1er tour;Présidentielles;1995;1;;;7;BAGNEUX;92007;20166;5090;15076;308;14768;VOYNET DOMINIQUE;F;VOYNET;DOMINIQUE;;475
Présidentielles 1995 - 1er tour;Présidentielles;1995;1;;;49;MONTROUGE;92049;22293;5924;16369;314;16055;HUE ROBERT;M;HUE;ROBERT;;1276
Présidentielles 1995 - 1er tour;Présidentielles;1995;1;;;64;SAINT CLOUD;92064;18989;5119;13870;179;13691;HUE ROBERT;M;HUE;ROBERT;;296
Présidentielles 2012 - 2ème tour;Présidentielles;2012;2;;;19;CHATENAY MALABRY;92019;17895;2822;15073;757;14316;SARKOZY Nicolas;M;SARKOZY;Nicolas;;6008
Présidentielles 2012 - 2ème tour;Présidentielles;2012;2;;;33;GARCHES;92033;12388;1986;10402;405;9997;HOLLANDE François;M;HOLLANDE;François;;3423
Présidentielles 2012 - 2ème tour;Présidentielles;2012;2;;;46;MALAKOFF;92046;18865;3800;15065;590;14475;SARKOZY Nicolas;M;SARKOZY;Nicolas;;4241
Présidentielles 2012 - 2ème tour;Présidentielles;2012;2;;;50;NANTERRE;92050;44340;9083;35257;1617;33640;SARKOZY Nicolas;M;SARKOZY;Nicolas;;10358
Présidentielles 2007 - 2ème tour;Présidentielles;2007;2;;;9;BOIS COLOMBES;92009;16112;2461;13651;517;13134;ROYAL Ségolène;F;ROYAL;Ségolène;;5480
Présidentielles 2007 - 2ème tour;Présidentielles;2007;2;;;25;COLOMBES;92025;44039;7231;36808;1348;35460;ROYAL Ségolène;F;ROYAL;Ségolène;;19139
Présidentielles 2007 - 2ème tour;Présidentielles;2007;2;;;26;COURBEVOIE;92026;48313;7148;41165;1673;39492;SARKOZY Nicolas;M;SARKOZY;Nicolas;;24147
Présidentielles 1995 - 2ème tour;Présidentielles;1995;2;;;9;BOIS COLOMBES;92009;14923;3184;11739;539;11200;JOSPIN LIONEL;M;JOSPIN;LIONEL;;4110
Législatives 2012 - 1er tour;Législatives;2012;1;12;12ème circonscription;23;CLAMART;92023;34173;13440;20733;193;20540;PEMEZEC Philippe;M;PEMEZEC;Philippe;UMP;7535
Législatives 2012 - 1er tour;Législatives;2012;1;12;12ème circonscription;23;CLAMART;92023;34173;13440;20733;193;20540;CARRASCO Julia;F;CARRASCO;Julia;DVD;161
Législatives 2012 - 1er tour;Législatives;2012;1;1;1ère circonscription;25;COLOMBES;92025;26337;13144;13193;209;12984;CARILLON Rémi;M;CARILLON;Rémi;FN;1447
Législatives 2012 - 1er tour;Législatives;2012;1;3;3ème circonscription;26;COURBEVOIE;92026;42456;16939;25517;317;25200;PARRY Jean-Marie;M;PARRY;Jean-Marie;EXG;29
Législatives 2012 - 1er tour;Législatives;2012;1;3;3ème circonscription;26;COURBEVOIE;92026;42456;16939;25517;317;25200;VILLEDEY Florence;F;VILLEDEY;Florence;ALLI;968
Législatives 2012 - 1er tour;Législatives;2012;1;6;6ème circonscription;26;COURBEVOIE;92026;8123;3742;4381;140;4241;LECLERC Monique;F;LECLERC;Monique;EXG;14
Législatives 2012 - 1er tour;Législatives;2012;1;6;6ème circonscription;26;COURBEVOIE;92026;8123;3742;4381;140;4241;FAVEUR Franck;M;FAVEUR;Franck;CEN;131
Législatives 2012 - 1er tour;Législatives;2012;1;6;6ème circonscription;26;COURBEVOIE;92026;8123;3742;4381;140;4241;HERVE Nicole;F;HERVE;Nicole;FN;405
Législatives 2012 - 1er tour;Législatives;2012;1;12;12ème circonscription;32;FONTENAY AUX ROSES;92032;15230;5971;9259;85;9174;BIERENT Rudolph;M;BIERENT;Rudolph;AUT;20
Législatives 2012 - 1er tour;Législatives;2012;1;7;7ème circonscription;33;GARCHES;92033;12412;5093;7319;98;7221;ROCHERON Bertrand;M;ROCHERON;Bertrand;SOC;1889
Législatives 2012 - 1er tour;Législatives;2012;1;11;11ème circonscription;46;MALAKOFF;92046;18858;7608;11250;119;11131;HAUJARD Sébastien;M;HAUJARD;Sébastien;DVD;32
Législatives 2012 - 1er tour;Législatives;2012;1;8;8ème circonscription;48;MEUDON;92048;25002;9709;15293;150;15143;RABANY Dominique;F;RABANY;Dominique;FG;641
Législatives 2012 - 1er tour;Législatives;2012;1;8;8ème circonscription;48;MEUDON;92048;25002;9709;15293;150;15143;MOGHIR Naïma;F;MOGHIR;Naïma;ECO;91
Législatives 2012 - 1er tour;Législatives;2012;1;8;8ème circonscription;48;MEUDON;92048;25002;9709;15293;150;15143;GRILLARD Jean;M;GRILLARD;Jean;AUT;34
Législatives 2012 - 1er tour;Législatives;2012;1;8;8ème circonscription;48;MEUDON;92048;25002;9709;15293;150;15143;BECQ Michel;M;BECQ;Michel;DVD;92
Législatives 2012 - 1er tour;Législatives;2012;1;10;10ème circonscription;48;MEUDON;92048;5576;2083;3493;26;3467;ALEZARD Lysiane;F;ALEZARD;Lysiane;FG;192
Législatives 2012 - 1er tour;Législatives;2012;1;6;6ème circonscription;51;NEUILLY SUR SEINE;92051;37031;14672;22359;177;22182;PRUVOST Emmanuel;M;PRUVOST;Emmanuel;ECO;229
Législatives 2012 - 1er tour;Législatives;2012;1;12;12ème circonscription;60;LE PLESSIS ROBINSON;92060;18785;6274;12511;101;12410;WAHNICH Sophie;F;WAHNICH;Sophie;AUT;16
Législatives 2012 - 1er tour;Législatives;2012;1;13;13ème circonscription;71;SCEAUX;92071;14395;5253;9142;70;9072;FEUILLADE Fabien;M;FEUILLADE;Fabien;VEC;759
Législatives 2012 - 1er tour;Législatives;2012;1;8;8ème circonscription;72;SEVRES;92072;14861;5785;9076;101;8975;GRILLARD Jean;M;GRILLARD;Jean;AUT;18
Législatives 2012 - 1er tour;Législatives;2012;1;4;4ème circonscription;73;SURESNES;92073;26492;10723;15769;302;15467;DUPUY Christian;M;DUPUY;Christian;UMP;6778
Législatives 2012 - 1er tour;Législatives;2012;1;1;1ère circonscription;78;VILLENEUVE LA GARENNE;92078;12349;6903;5446;131;5315;DESACHY Anne-Marie;F;DESACHY;Anne-Marie;AUT;15
Législatives 2012 - 2ème tour;Législatives;2012;2;8;8ème circonscription;22;CHAVILLE;92022;12808;4743;8065;184;7881;LIME-BIFFE Catherine;F;LIME-BIFFE;Catherine;SOC;3887
Législatives 2012 - 2ème tour;Législatives;2012;2;6;6ème circonscription;51;NEUILLY SUR SEINE;92051;37031;16138;20893;237;20656;LEPIDI Bernard;M;LEPIDI;Bernard;DVD;4098
Législatives 2012 - 1er tour;Législatives;2012;1;13;13ème circonscription;2;ANTONY;92002;40941;15088;25853;361;25492;GEORGET Michel;M;GEORGET;Michel;FN;1398
Législatives 2012 - 1er tour;Législatives;2012;1;2;2ème circonscription;4;ASNIERES SUR SEINE;92004;45114;18545;26569;310;26259;BENTEBRA Mohamed;M;BENTEBRA;Mohamed;ECO;231
Législatives 2012 - 1er tour;Législatives;2012;1;11;11ème circonscription;7;BAGNEUX;92007;20609;9648;10961;145;10816;BENHABRI Mehdi;M;BENHABRI;Mehdi;CEN;162
Législatives 2012 - 1er tour;Législatives;2012;1;10;10ème circonscription;12;BOULOGNE BILLANCOURT;92012;6600;2912;3688;126;3562;SCHMID Lucile;F;SCHMID;Lucile;VEC;1019
Législatives 2012 - 1er tour;Législatives;2012;1;13;13ème circonscription;19;CHATENAY MALABRY;92019;17908;6775;11133;210;10923;FEUILLADE Fabien;M;FEUILLADE;Fabien;VEC;885
Législatives 1993 - 1er tour;Législatives;1993;1;12;12ème circonscription;60;LE PLESSIS ROBINSON;92060;13118;4266;8852;315;8537;BURGAUD CHRISTINE;F;BURGAUD;CHRISTINE;DIV;78
Législatives 1993 - 1er tour;Législatives;1993;1;6;6ème circonscription;51;NEUILLY SUR SEINE;92051;35806;10146;25660;620;25040;JOUBERT BERTRAND;M;JOUBERT;BERTRAND;DVD;357
Législatives 1993 - 1er tour;Législatives;1993;1;7;7ème circonscription;63;RUEIL MALMAISON;92063;42219;12104;30115;1049;29066;BAUMEL JACQUES;M;BAUMEL;JACQUES;RPR;15624
Législatives 1993 - 1er tour;Législatives;1993;1;11;11ème circonscription;49;MONTROUGE;92049;22632;7554;15078;554;14524;BERTINELLI M.JOSE;F;BERTINELLI;M.JOSE;DIV;145
Législatives 1993 - 1er tour;Législatives;1993;1;4;4ème circonscription;50;NANTERRE;92050;38007;11484;26523;795;25728;DUPUY CHRISTIAN;M;DUPUY;CHRISTIAN;RPR;7951
Législatives 1993 - 1er tour;Législatives;1993;1;5;5ème circonscription;44;LEVALLOIS PERRET;92044;27392;7486;19906;624;19282;CONVERSY LAURENT;M;CONVERSY;LAURENT;DIV;149
Législatives 1993 - 1er tour;Législatives;1993;1;3;3ème circonscription;35;LA GARENNE COLOMBES;92035;13664;4290;9374;347;9027;MASSOU GABRIEL;M;MASSOU;GABRIEL;COM;513
Législatives 1993 - 1er tour;Législatives;1993;1;11;11ème circonscription;46;MALAKOFF;92046;19559;6951;12608;416;12192;BASSINET PHILIPPE;M;BASSINET;PHILIPPE;SOC;1556
Législatives 1993 - 1er tour;Législatives;1993;1;8;8ème circonscription;47;MARNES LA COQUETTE;92047;1006;246;760;21;739;WOLF HENRY;M;WOLF;HENRY;UDF;170
Législatives 1993 - 1er tour;Législatives;1993;1;7;7ème circonscription;64;SAINT CLOUD;92064;19166;6250;12916;429;12487;MARECHAL CHRISTIAN;M;MARECHAL;CHRISTIAN;FRN;1322
Législatives 1993 - 1er tour;Législatives;1993;1;13;13ème circonscription;71;SCEAUX;92071;13127;3574;9553;306;9247;DEVEDJIAN PATRICK;M;DEVEDJIAN;PATRICK;RPR;4816
Législatives 1993 - 1er tour;Législatives;1993;1;7;7ème circonscription;64;SAINT CLOUD;92064;19166;6250;12916;429;12487;BURQ DANIEL;M;BURQ;DANIEL;GEC;1174
Législatives 1993 - 1er tour;Législatives;1993;1;10;10ème circonscription;75;VANVES;92075;15286;4324;10962;394;10568;LARDOUX BRUNO;M;LARDOUX;BRUNO;EXG;74
Législatives 1993 - 1er tour;Législatives;1993;1;10;10ème circonscription;75;VANVES;92075;15286;4324;10962;394;10568;BITON MARLENE;F;BITON;MARLENE;SOC;1658
Législatives 2002 - 1er tour;Législatives;2002;1;3;3ème circonscription;9;BOIS COLOMBES;92009;16245;6561;9684;288;9396;MARCEL Françoise;F;MARCEL;Françoise;EXG;29
Législatives 2002 - 1er tour;Législatives;2002;1;9;9ème circonscription;12;BOULOGNE BILLANCOURT;92012;60773;22422;38351;535;37816;BAGUET P-Christophe;M;BAGUET;P-Christophe;MAJ;22433
Législatives 2002 - 1er tour;Législatives;2002;1;12;12ème circonscription;20;CHATILLON;92020;20661;7083;13578;137;13441;LARCHER Robert;M;LARCHER;Robert;EXG;75
Législatives 2002 - 1er tour;Législatives;2002;1;8;8ème circonscription;22;CHAVILLE;92022;12928;4682;8246;120;8126;LUCET Francis;M;LUCET;Francis;EXG;47
Législatives 2002 - 1er tour;Législatives;2002;1;8;8ème circonscription;22;CHAVILLE;92022;12928;4682;8246;120;8126;DEQUEANT Annie;F;DEQUEANT;Annie;FN;247
Législatives 2002 - 1er tour;Législatives;2002;1;1;1ère circonscription;36;GENNEVILLIERS;92036;20048;9522;10526;189;10337;RABIER Marie-Cécile;F;RABIER;Marie-Cécile;FN;431
Législatives 2002 - 1er tour;Législatives;2002;1;10;10ème circonscription;40;ISSY LES MOULINEAUX;92040;38520;14017;24503;359;24144;ALEZARD Lysiane;F;ALEZARD;Lysiane;COM;447
Législatives 2002 - 1er tour;Législatives;2002;1;10;10ème circonscription;40;ISSY LES MOULINEAUX;92040;38520;14017;24503;359;24144;SANTINI André;M;SANTINI;André;MAJ;12379
Législatives 2002 - 1er tour;Législatives;2002;1;10;10ème circonscription;40;ISSY LES MOULINEAUX;92040;38520;14017;24503;359;24144;DROUET Valérie;F;DROUET;Valérie;EXD;27
Législatives 2002 - 1er tour;Législatives;2002;1;11;11ème circonscription;46;MALAKOFF;92046;18478;7045;11433;204;11229;BOUKHEDIMI Patrick;M;BOUKHEDIMI;Patrick;EXG;44
Législatives 2002 - 1er tour;Législatives;2002;1;8;8ème circonscription;47;MARNES LA COQUETTE;92047;1074;316;758;5;753;LEGRAND Pauline;F;LEGRAND;Pauline;EXD;3
Législatives 2002 - 1er tour;Législatives;2002;1;8;8ème circonscription;48;MEUDON;92048;25427;9683;15744;202;15542;DEQUEANT Annie;F;DEQUEANT;Annie;FN;409
Législatives 2002 - 1er tour;Législatives;2002;1;10;10ème circonscription;48;MEUDON;92048;5066;1864;3202;29;3173;ARIPA Alain;M;ARIPA;Alain;MPF;55
Législatives 2002 - 1er tour;Législatives;2002;1;6;6ème circonscription;51;NEUILLY SUR SEINE;92051;39134;14738;24396;185;24211;EISENBERG Mathilde;F;EISENBERG;Mathilde;EXG;103
Législatives 2002 - 1er tour;Législatives;2002;1;12;12ème circonscription;60;LE PLESSIS ROBINSON;92060;16776;5588;11188;123;11065;BRILLON Freddy;M;BRILLON;Freddy;DVD;29
Législatives 2002 - 1er tour;Législatives;2002;1;13;13ème circonscription;71;SCEAUX;92071;14129;4679;9450;74;9376;CANET Michèle;F;CANET;Michèle;SOC;1881
Législatives 2002 - 1er tour;Législatives;2002;1;8;8ème circonscription;77;VILLE D'AVRAY;92077;7475;2429;5046;60;4986;DEQUEANT Annie;F;DEQUEANT;Annie;FN;111
Législatives 2002 - 1er tour;Législatives;2002;1;1;1ère circonscription;78;VILLENEUVE LA GARENNE;92078;13038;7211;5827;131;5696;GRIMAL Jean;M;GRIMAL;Jean;EXG;35
Législatives 2002 - 2ème tour;Législatives;2002;2;11;11ème circonscription;7;BAGNEUX;92007;18569;7336;11233;358;10875;JAMBU JANINE;F;JAMBU;JANINE;COM;6112
Législatives 1997 - 2ème tour;Législatives;1997;2;8;8ème circonscription;77;VILLE D'AVRAY;92077;7112;1988;5124;162;4962;GUILLET J.JACQUES;M;GUILLET;J.JACQUES;RPR;3642
Législatives 1993 - 2ème tour;Législatives;1993;2;2;2ème circonscription;4;ASNIERES SUR SEINE;92004;37314;14413;22901;3359;19542;TRANCHANT GEORGES;M;TRANCHANT;GEORGES;RPR;7240
Législatives 1993 - 2ème tour;Législatives;1993;2;12;12ème circonscription;32;FONTENAY AUX ROSES;92032;15096;5121;9975;559;9416;BUCHET PASCAL;M;BUCHET;PASCAL;SOC;4177
Législatives 1993 - 2ème tour;Législatives;1993;2;2;2ème circonscription;25;COLOMBES;92025;18318;7739;10579;2093;8486;TRANCHANT GEORGES;M;TRANCHANT;GEORGES;RPR;4808
Législatives 1993 - 2ème tour;Législatives;1993;2;12;12ème circonscription;20;CHATILLON;92020;15705;4600;11105;678;10427;BUCHET PASCAL;M;BUCHET;PASCAL;SOC;4388
Législatives 1993 - 2ème tour;Législatives;1993;2;5;5ème circonscription;44;LEVALLOIS PERRET;92044;27392;8022;19370;1292;18078;BALKANY PATRICK;M;BALKANY;PATRICK;RPR;11458
Législatives 1993 - 2ème tour;Législatives;1993;2;1;1ère circonscription;36;GENNEVILLIERS;92036;19185;6903;12282;598;11684;PREVOT ROGER;M;PREVOT;ROGER;UDF;4118
Législatives 1997 - 1er tour;Législatives;1997;1;13;13ème circonscription;2;ANTONY;92002;37772;12082;25690;861;24829;ANSQUER VIRGINIE;F;ANSQUER;VIRGINIE;EXG;142
Législatives 1993 - 1er tour;Législatives;1993;1;13;13ème circonscription;2;ANTONY;92002;36749;10226;26523;1007;25516;ROSNER ADRIAN;M;ROSNER;ADRIAN;GEC;2700
Législatives 1997 - 1er tour;Législatives;1997;1;7;7ème circonscription;64;SAINT CLOUD;92064;18908;7095;11813;417;11396;PACOURET J.RAYMOND;M;PACOURET;J.RAYMOND;COM;259
Législatives 1997 - 1er tour;Législatives;1997;1;7;7ème circonscription;64;SAINT CLOUD;92064;18908;7095;11813;417;11396;DRIOUT PIERRE;M;DRIOUT;PIERRE;EXD;69
Législatives 1997 - 1er tour;Législatives;1997;1;8;8ème circonscription;76;VAUCRESSON;92076;5546;1861;3685;139;3546;ARIA D DANIELA;F;ARIA D;DANIELA;DIV;0
Législatives 1993 - 1er tour;Législatives;1993;1;13;13ème circonscription;14;BOURG LA REINE;92014;12754;4085;8669;303;8366;CAILLAULT JACQUES;M;CAILLAULT;JACQUES;MAJ;174
Législatives 1993 - 1er tour;Législatives;1993;1;2;2ème circonscription;4;ASNIERES SUR SEINE;92004;37314;11544;25770;852;24918;LE GUERNEVE SERGE;M;LE GUERNEVE;SERGE;COM;1337
Législatives 1993 - 1er tour;Législatives;1993;1;1;1ère circonscription;25;COLOMBES;92025;26594;9512;17082;693;16389;FAUCONNIER DENIS;M;FAUCONNIER;DENIS;DIV;551
Législatives 1993 - 1er tour;Législatives;1993;1;8;8ème circonscription;22;CHAVILLE;92022;12345;3904;8441;296;8145;NICOLAS PATRICK;M;NICOLAS;PATRICK;DVD;38
Législatives 1993 - 1er tour;Législatives;1993;1;1;1ère circonscription;25;COLOMBES;92025;26594;9512;17082;693;16389;MAS J.LOUIS;M;MAS;J.LOUIS;DVD;210
Législatives 1993 - 1er tour;Législatives;1993;1;12;12ème circonscription;32;FONTENAY AUX ROSES;92032;15091;4963;10128;341;9787;LEGOEUIL ANNETTE;F;LEGOEUIL;ANNETTE;SOC;113
Législatives 1993 - 1er tour;Législatives;1993;1;3;3ème circonscription;26;COURBEVOIE;92026;34737;9916;24821;828;23993;ROUSSEL PIERRE;M;ROUSSEL;PIERRE;SOC;3625
Législatives 1997 - 1er tour;Législatives;1997;1;8;8ème circonscription;22;CHAVILLE;92022;12268;3930;8338;262;8076;BALLOT LENA CAROLINE;F;BALLOT LENA;CAROLINE;DVD;214
Législatives 1997 - 1er tour;Législatives;1997;1;13;13ème circonscription;19;CHATENAY MALABRY;92019;17859;6462;11397;367;11030;MARTIN ANNICK;F;MARTIN;ANNICK;FRN;1318
Législatives 1997 - 1er tour;Législatives;1997;1;13;13ème circonscription;14;BOURG LA REINE;92014;12587;4431;8156;266;7890;LAVAL J.MARIE;M;LAVAL;J.MARIE;DVD;212
Législatives 1997 - 1er tour;Législatives;1997;1;11;11ème circonscription;46;MALAKOFF;92046;19124;7233;11891;338;11553;RAKETITCH RAOUL;M;RAKETITCH;RAOUL;FRN;1369
Législatives 1997 - 1er tour;Législatives;1997;1;1;1ère circonscription;25;COLOMBES;92025;26238;10153;16085;513;15572;BRETON MICHEL;M;BRETON;MICHEL;EXG;481
Législatives 1997 - 1er tour;Législatives;1997;1;12;12ème circonscription;23;CLAMART;92023;30471;10310;20161;590;19571;GARREC CLAUDE;M;GARREC;CLAUDE;DVD;11
Législatives 1997 - 1er tour;Législatives;1997;1;6;6ème circonscription;51;NEUILLY SUR SEINE;92051;35571;12347;23224;570;22654;GRANGER J.MICHEL;M;GRANGER;J.MICHEL;DVD;0
Législatives 1997 - 1er tour;Législatives;1997;1;6;6ème circonscription;51;NEUILLY SUR SEINE;92051;35571;12347;23224;570;22654;ROCHAS SOPHIE;F;ROCHAS;SOPHIE;DVD;382
Législatives 1997 - 1er tour;Législatives;1997;1;3;3ème circonscription;26;COURBEVOIE;92026;35738;12354;23384;653;22731;GALICIER BEATRICE;F;GALICIER;BEATRICE;COM;927
Législatives 1997 - 1er tour;Législatives;1997;1;9;9ème circonscription;12;BOULOGNE BILLANCOURT;92012;53287;18902;34385;948;33437;BAGUET P.CHRISTOPHE;M;BAGUET;P.CHRISTOPHE;UDF;9399
Législatives 1997 - 1er tour;Législatives;1997;1;2;2ème circonscription;4;ASNIERES SUR SEINE;92004;37154;13729;23425;737;22688;THOMAS CAPUCINE;F;THOMAS;CAPUCINE;ECO;0
Législatives 1997 - 1er tour;Législatives;1997;1;11;11ème circonscription;7;BAGNEUX;92007;20284;7388;12896;374;12522;BOURGES BRIGITTE;F;BOURGES;BRIGITTE;EXG;360
Législatives 1997 - 1er tour;Législatives;1997;1;12;12ème circonscription;60;LE PLESSIS ROBINSON;92060;13002;3860;9142;204;8938;LE BERRE ALAIN;M;LE BERRE;ALAIN;FRN;769
Législatives 2017 - 1er tour;Législatives;2017;1;1;1ère circonscription;36;GENNEVILLIERS;92036;22174;13223;8951;243;8708;WICQUART Emmanuelle;F;WICQUART;Emmanuelle;DLF;95
Législatives 2017 - 1er tour;Législatives;2017;1;1;1ère circonscription;78;VILLENEUVE LA GARENNE;92078;12445;8430;4015;143;3872;BRETON Michel;M;BRETON;Michel;EXG;42
Législatives 2017 - 1er tour;Législatives;2017;1;12;12ème circonscription;23;CLAMART;92023;35342;15954;19388;238;19150;CAMARA Makhtar;M;CAMARA;Makhtar;DVD;40
Législatives 2017 - 1er tour;Législatives;2017;1;12;12ème circonscription;60;LE PLESSIS ROBINSON;92060;19154;7496;11658;130;11528;BAHLOUL Madeleine;F;BAHLOUL;Madeleine;FI;869
Législatives 2017 - 1er tour;Législatives;2017;1;4;4ème circonscription;73;SURESNES;92073;28524;12725;15799;423;15376;EISENBERG Mathilde;F;EISENBERG;Mathilde;EXG;35
Législatives 2017 - 1er tour;Législatives;2017;1;11;11ème circonscription;46;MALAKOFF;92046;18448;8148;10300;133;10167;MARTIN Agathe;F;MARTIN;Agathe;EXG;94
Législatives 2017 - 1er tour;Législatives;2017;1;3;3ème circonscription;35;LA GARENNE COLOMBES;92035;18829;8238;10591;114;10477;DENIAU Floriane;F;DENIAU;Floriane;FN;401
Législatives 2017 - 1er tour;Législatives;2017;1;3;3ème circonscription;35;LA GARENNE COLOMBES;92035;18829;8238;10591;114;10477;DENOO Emilia;F;DENOO;Emilia;DIV;173
Législatives 2017 - 1er tour;Législatives;2017;1;2;2ème circonscription;25;COLOMBES;92025;19668;8354;11314;229;11085;SCHILLACI Nino;M;SCHILLACI;Nino;FI;1009
Législatives 2017 - 1er tour;Législatives;2017;1;6;6ème circonscription;26;COURBEVOIE;92026;8107;4228;3879;107;3772;CHEVIGNARD Grégoire;M;CHEVIGNARD;Grégoire;DIV;14
Législatives 2017 - 1er tour;Législatives;2017;1;6;6ème circonscription;26;COURBEVOIE;92026;8107;4228;3879;107;3772;BOUGHERARA Zohra;F;BOUGHERARA;Zohra;COM;56
Législatives 2017 - 1er tour;Législatives;2017;1;8;8ème circonscription;48;MEUDON;92048;25240;11059;14181;174;14007;DE SAINT ALBIN Stéphane;M;DE SAINT ALBIN;Stéphane;DVD;212
Législatives 2017 - 1er tour;Législatives;2017;1;8;8ème circonscription;48;MEUDON;92048;25240;11059;14181;174;14007;ROURE Françoise;F;ROURE;Françoise;RDG;428
Législatives 2017 - 1er tour;Législatives;2017;1;8;8ème circonscription;22;CHAVILLE;92022;13523;5385;8138;93;8045;MACHILLOT Alexandre;M;MACHILLOT;Alexandre;DIV;66
Législatives 2017 - 1er tour;Législatives;2017;1;7;7ème circonscription;33;GARCHES;92033;12777;5514;7263;115;7148;BERTHAULT Grégory;M;BERTHAULT;Grégory;ECO;112
Législatives 2017 - 1er tour;Législatives;2017;1;7;7ème circonscription;64;SAINT CLOUD;92064;19410;7490;11920;102;11818;NGUYEN Maryline;F;NGUYEN;Maryline;COM;49
Législatives 2017 - 1er tour;Législatives;2017;1;6;6ème circonscription;62;PUTEAUX;92062;28983;11794;17189;436;16753;PINCEMIN Martine;F;PINCEMIN;Martine;EXD;77
Législatives 2017 - 1er tour;Législatives;2017;1;10;10ème circonscription;40;ISSY LES MOULINEAUX;92040;45375;19009;26366;517;25849;VIGNON Anne-Violaine;F;VIGNON;Anne-Violaine;DVD;259
Législatives 2017 - 1er tour;Législatives;2017;1;10;10ème circonscription;40;ISSY LES MOULINEAUX;92040;45375;19009;26366;517;25849;LECOCQ Laurence;F;LECOCQ;Laurence;DIV;73
Législatives 2017 - 1er tour;Législatives;2017;1;10;10ème circonscription;48;MEUDON;92048;6009;2545;3464;38;3426;ATTAL Gabriel;M;ATTAL;Gabriel;REM;1618
Présidentielles 1995 - 1er tour;Présidentielles;1995;1;;;2;ANTONY;92002;37894;9274;28620;590;28030;VILLIERS DE PHILIPPE;M;VILLIERS DE;PHILIPPE;;920
Présidentielles 1995 - 2ème tour;Présidentielles;1995;2;;;7;BAGNEUX;92007;20165;4704;15461;949;14512;JOSPIN LIONEL;M;JOSPIN;LIONEL;;8221
Présidentielles 1995 - 2ème tour;Présidentielles;1995;2;;;33;GARCHES;92033;11689;2199;9490;345;9145;CHIRAC JACQUES;M;CHIRAC;JACQUES;;2666
Présidentielles 1995 - 1er tour;Présidentielles;1995;1;;;51;NEUILLY SUR SEINE;92051;35904;7798;28106;261;27845;VILLIERS DE PHILIPPE;M;VILLIERS DE;PHILIPPE;;1043
Présidentielles 1995 - 1er tour;Présidentielles;1995;1;;;47;MARNES LA COQUETTE;92047;1003;227;776;11;765;HUE ROBERT;M;HUE;ROBERT;;11
Présidentielles 1995 - 1er tour;Présidentielles;1995;1;;;48;MEUDON;92048;29714;7851;21863;352;21511;CHEMINADE JACQUES;M;CHEMINADE;JACQUES;;61
Présidentielles 1995 - 1er tour;Présidentielles;1995;1;;;25;COLOMBES;92025;44864;11966;32898;703;32195;CHEMINADE JACQUES;M;CHEMINADE;JACQUES;;61
Présidentielles 1995 - 1er tour;Présidentielles;1995;1;;;33;GARCHES;92033;11689;2941;8748;172;8576;LAGUILLER ARLETTE;F;LAGUILLER;ARLETTE;;287
Présidentielles 1995 - 1er tour;Présidentielles;1995;1;;;51;NEUILLY SUR SEINE;92051;35904;7798;28106;261;27845;VOYNET DOMINIQUE;F;VOYNET;DOMINIQUE;;376
Présidentielles 1995 - 1er tour;Présidentielles;1995;1;;;60;LE PLESSIS ROBINSON;92060;13056;3285;9771;199;9572;LE PEN J.MARIE;M;LE PEN;J.MARIE;;1170
Présidentielles 1995 - 1er tour;Présidentielles;1995;1;;;63;RUEIL MALMAISON;92063;44438;10571;33867;718;33149;HUE ROBERT;M;HUE;ROBERT;;1875
Présidentielles 1995 - 1er tour;Présidentielles;1995;1;;;76;VAUCRESSON;92076;5529;1334;4195;65;4130;CHEMINADE JACQUES;M;CHEMINADE;JACQUES;;8
Présidentielles 2007 - 1er tour;Présidentielles;2007;1;;;2;ANTONY;92002;39316;4695;34621;413;34208;SCHIVARDI Gérard;M;SCHIVARDI;Gérard;;46
Présidentielles 2007 - 1er tour;Présidentielles;2007;1;;;7;BAGNEUX;92007;20438;2809;17629;261;17368;de VILLIERS Philippe;M;de VILLIERS;Philippe;;199
Présidentielles 2007 - 1er tour;Présidentielles;2007;1;;;9;BOIS COLOMBES;92009;16113;2534;13579;152;13427;de VILLIERS Philippe;M;de VILLIERS;Philippe;;190
Présidentielles 2007 - 1er tour;Présidentielles;2007;1;;;12;BOULOGNE BILLANCOURT;92012;64709;7685;57024;546;56478;BAYROU François;M;BAYROU;François;;11646
Présidentielles 2007 - 1er tour;Présidentielles;2007;1;;;12;BOULOGNE BILLANCOURT;92012;64709;7685;57024;546;56478;BOVÉ José;M;BOVÉ;José;;257
Présidentielles 2007 - 1er tour;Présidentielles;2007;1;;;19;CHATENAY MALABRY;92019;17598;2318;15280;229;15051;SCHIVARDI Gérard;M;SCHIVARDI;Gérard;;16
Présidentielles 2007 - 1er tour;Présidentielles;2007;1;;;20;CHATILLON;92020;20466;2231;18235;177;18058;VOYNET Dominique;F;VOYNET;Dominique;;295
Présidentielles 2007 - 1er tour;Présidentielles;2007;1;;;25;COLOMBES;92025;44025;7536;36489;501;35988;BOVÉ José;M;BOVÉ;José;;410
Présidentielles 2007 - 1er tour;Présidentielles;2007;1;;;26;COURBEVOIE;92026;48308;7118;41190;456;40734;SCHIVARDI Gérard;M;SCHIVARDI;Gérard;;44
Présidentielles 2007 - 1er tour;Présidentielles;2007;1;;;33;GARCHES;92033;11957;1346;10611;106;10505;BOVÉ José;M;BOVÉ;José;;61
Présidentielles 2007 - 1er tour;Présidentielles;2007;1;;;35;LA GARENNE COLOMBES;92035;16350;1826;14524;117;14407;BUFFET Marie-George;F;BUFFET;Marie-George;;161
Présidentielles 2007 - 1er tour;Présidentielles;2007;1;;;40;ISSY LES MOULINEAUX;92040;37966;4920;33046;365;32681;SCHIVARDI Gérard;M;SCHIVARDI;Gérard;;61
Présidentielles 2007 - 1er tour;Présidentielles;2007;1;;;48;MEUDON;92048;29936;4129;25807;223;25584;BOVÉ José;M;BOVÉ;José;;269
Présidentielles 2007 - 1er tour;Présidentielles;2007;1;;;50;NANTERRE;92050;42083;6117;35966;477;35489;ROYAL Ségolène;F;ROYAL;Ségolène;;12769
Présidentielles 2007 - 1er tour;Présidentielles;2007;1;;;51;NEUILLY SUR SEINE;92051;37647;4032;33615;154;33461;SCHIVARDI Gérard;M;SCHIVARDI;Gérard;;7
Présidentielles 2007 - 1er tour;Présidentielles;2007;1;;;62;PUTEAUX;92062;26761;3397;23364;263;23101;LE PEN Jean-Marie;M;LE PEN;Jean-Marie;;1564
Présidentielles 2007 - 1er tour;Présidentielles;2007;1;;;64;SAINT CLOUD;92064;18455;1926;16529;91;16438;BESANCENOT Olivier;M;BESANCENOT;Olivier;;174
Présidentielles 2007 - 1er tour;Présidentielles;2007;1;;;71;SCEAUX;92071;13824;1539;12285;86;12199;SCHIVARDI Gérard;M;SCHIVARDI;Gérard;;14
Présidentielles 2007 - 1er tour;Présidentielles;2007;1;;;72;SEVRES;92072;14178;1738;12440;129;12311;BOVÉ José;M;BOVÉ;José;;103
Présidentielles 2007 - 1er tour;Présidentielles;2007;1;;;73;SURESNES;92073;24255;2600;21655;272;21383;SARKOZY Nicolas;M;SARKOZY;Nicolas;;8503
Présidentielles 2007 - 1er tour;Présidentielles;2007;1;;;75;VANVES;92075;17139;2129;15010;126;14884;NIHOUS Frédéric;M;NIHOUS;Frédéric;;31
Présidentielles 2007 - 1er tour;Présidentielles;2007;1;;;75;VANVES;92075;17139;2129;15010;126;14884;SARKOZY Nicolas;M;SARKOZY;Nicolas;;4830
Présidentielles 2007 - 1er tour;Présidentielles;2007;1;;;77;VILLE D'AVRAY;92077;7253;672;6581;57;6524;SCHIVARDI Gérard;M;SCHIVARDI;Gérard;;10
Présidentielles 2007 - 1er tour;Présidentielles;2007;1;;;77;VILLE D'AVRAY;92077;7253;672;6581;57;6524;VOYNET Dominique;F;VOYNET;Dominique;;91
Présidentielles 2017 - 1er tour;Présidentielles;2017;1;;;2;ANTONY;92002;41488;6486;35002;776;34226;LE PEN Marine;F;LE PEN;Marine;;2606
Présidentielles 2017 - 1er tour;Présidentielles;2017;1;;;2;ANTONY;92002;41488;6486;35002;776;34226;MÉLENCHON Jean-Luc;M;MÉLENCHON;Jean-Luc;;6018
Présidentielles 2017 - 1er tour;Présidentielles;2017;1;;;4;ASNIERES SUR SEINE;92004;48227;8578;39649;807;38842;ARTHAUD Nathalie;F;ARTHAUD;Nathalie;;138
Présidentielles 2017 - 1er tour;Présidentielles;2017;1;;;9;BOIS COLOMBES;92009;17896;3242;14654;318;14336;POUTOU Philippe;M;POUTOU;Philippe;;76
Présidentielles 2017 - 1er tour;Présidentielles;2017;1;;;19;CHATENAY MALABRY;92019;18708;3336;15372;454;14918;MÉLENCHON Jean-Luc;M;MÉLENCHON;Jean-Luc;;3306
Présidentielles 2017 - 1er tour;Présidentielles;2017;1;;;23;CLAMART;92023;35291;6330;28961;560;28401;CHEMINADE Jacques;M;CHEMINADE;Jacques;;62
Présidentielles 2017 - 1er tour;Présidentielles;2017;1;;;35;LA GARENNE COLOMBES;92035;18828;3121;15707;289;15418;MACRON Emmanuel;M;MACRON;Emmanuel;;5160
Présidentielles 2017 - 1er tour;Présidentielles;2017;1;;;36;GENNEVILLIERS;92036;22149;5526;16623;490;16133;MÉLENCHON Jean-Luc;M;MÉLENCHON;Jean-Luc;;7597
Présidentielles 2017 - 1er tour;Présidentielles;2017;1;;;46;MALAKOFF;92046;18434;3186;15248;268;14979;LE PEN Marine;F;LE PEN;Marine;;1424
Présidentielles 2017 - 1er tour;Présidentielles;2017;1;;;50;NANTERRE;92050;47568;10655;36913;884;36029;CHEMINADE Jacques;M;CHEMINADE;Jacques;;77
Présidentielles 2017 - 1er tour;Présidentielles;2017;1;;;51;NEUILLY SUR SEINE;92051;37184;4180;33004;212;32792;MÉLENCHON Jean-Luc;M;MÉLENCHON;Jean-Luc;;1162
Présidentielles 2017 - 1er tour;Présidentielles;2017;1;;;60;LE PLESSIS ROBINSON;92060;19141;2947;16194;344;15850;MÉLENCHON Jean-Luc;M;MÉLENCHON;Jean-Luc;;2785
Présidentielles 2017 - 1er tour;Présidentielles;2017;1;;;62;PUTEAUX;92062;28950;4530;24420;549;23871;MÉLENCHON Jean-Luc;M;MÉLENCHON;Jean-Luc;;3992
Présidentielles 2017 - 1er tour;Présidentielles;2017;1;;;76;VAUCRESSON;92076;6176;835;5341;72;5269;MACRON Emmanuel;M;MACRON;Emmanuel;;1569
Présidentielles 2012 - 1er tour;Présidentielles;2012;1;;;7;BAGNEUX;92007;20608;4687;15921;281;15640;ARTHAUD Nathalie;F;ARTHAUD;Nathalie;;77
Présidentielles 2012 - 1er tour;Présidentielles;2012;1;;;9;BOIS COLOMBES;92009;16746;3612;13134;231;12903;MÉLENCHON Jean-Luc;M;MÉLENCHON;Jean-Luc;;1176
Présidentielles 2012 - 1er tour;Présidentielles;2012;1;;;14;BOURG LA REINE;92014;13300;2381;10919;132;10787;LE PEN Marine;F;LE PEN;Marine;;775
Présidentielles 2012 - 1er tour;Présidentielles;2012;1;;;24;CLICHY;92024;29226;6786;22440;374;22066;HOLLANDE François;M;HOLLANDE;François;;9183
Présidentielles 2012 - 1er tour;Présidentielles;2012;1;;;33;GARCHES;92033;12388;2501;9887;167;9720;HOLLANDE François;M;HOLLANDE;François;;2091
Présidentielles 2012 - 1er tour;Présidentielles;2012;1;;;36;GENNEVILLIERS;92036;20990;5264;15726;342;15384;CHEMINADE Jacques;M;CHEMINADE;Jacques;;40
Présidentielles 2012 - 1er tour;Présidentielles;2012;1;;;40;ISSY LES MOULINEAUX;92040;41994;9488;32506;521;31985;CHEMINADE Jacques;M;CHEMINADE;Jacques;;105
Présidentielles 2012 - 1er tour;Présidentielles;2012;1;;;44;LEVALLOIS PERRET;92044;39497;7296;32201;438;31763;MÉLENCHON Jean-Luc;M;MÉLENCHON;Jean-Luc;;2134
Présidentielles 2012 - 1er tour;Présidentielles;2012;1;;;48;MEUDON;92048;30572;6341;24231;318;23913;MÉLENCHON Jean-Luc;M;MÉLENCHON;Jean-Luc;;2268
Présidentielles 2012 - 1er tour;Présidentielles;2012;1;;;48;MEUDON;92048;30572;6341;24231;318;23913;POUTOU Philippe;M;POUTOU;Philippe;;163
Présidentielles 2012 - 1er tour;Présidentielles;2012;1;;;50;NANTERRE;92050;44307;10435;33872;654;33218;MÉLENCHON Jean-Luc;M;MÉLENCHON;Jean-Luc;;6168
Présidentielles 2012 - 1er tour;Présidentielles;2012;1;;;63;RUEIL MALMAISON;92063;52385;10540;41845;580;41265;BAYROU François;M;BAYROU;François;;5312
Présidentielles 2012 - 1er tour;Présidentielles;2012;1;;;63;RUEIL MALMAISON;92063;52385;10540;41845;580;41265;DUPONT-AIGNAN Nicolas;M;DUPONT-AIGNAN;Nicolas;;652
Présidentielles 2012 - 1er tour;Présidentielles;2012;1;;;71;SCEAUX;92071;14355;2941;11414;118;11296;LE PEN Marine;F;LE PEN;Marine;;697
Présidentielles 2012 - 1er tour;Présidentielles;2012;1;;;72;SEVRES;92072;14837;2876;11961;219;11742;SARKOZY Nicolas;M;SARKOZY;Nicolas;;4206
Présidentielles 2012 - 1er tour;Présidentielles;2012;1;;;76;VAUCRESSON;92076;6089;1241;4848;74;4774;LE PEN Marine;F;LE PEN;Marine;;318
Présidentielles 2012 - 1er tour;Présidentielles;2012;1;;;78;VILLENEUVE LA GARENNE;92078;12332;3328;9004;225;8779;POUTOU Philippe;M;POUTOU;Philippe;;90
Présidentielles 2012 - 1er tour;Présidentielles;2012;1;;;78;VILLENEUVE LA GARENNE;92078;12332;3328;9004;225;8779;HOLLANDE François;M;HOLLANDE;François;;3711
Présidentielles 2002 - 1er tour;Présidentielles;2002;1;;;47;MARNES LA COQUETTE;92047;997;272;725;7;718;BAYROU FRANCOIS;M;BAYROU;FRANCOIS;;64
Présidentielles 2002 - 1er tour;Présidentielles;2002;1;;;49;MONTROUGE;92049;23382;8142;15240;301;14939;LE PEN JEAN-MARIE;M;LE PEN;JEAN-MARIE;;1645
Présidentielles 2002 - 1er tour;Présidentielles;2002;1;;;49;MONTROUGE;92049;23382;8142;15240;301;14939;BOUTIN CHRISTINE;F;BOUTIN;CHRISTINE;;150
Présidentielles 2002 - 1er tour;Présidentielles;2002;1;;;50;NANTERRE;92050;37590;13303;24287;669;23618;MADELIN ALAIN;M;MADELIN;ALAIN;;616
Présidentielles 2002 - 1er tour;Présidentielles;2002;1;;;51;NEUILLY SUR SEINE;92051;34066;10108;23958;309;23649;JOSPIN LIONEL;M;JOSPIN;LIONEL;;1807
Présidentielles 2002 - 1er tour;Présidentielles;2002;1;;;63;RUEIL MALMAISON;92063;48302;17158;31144;693;30451;GLUCKSTEIN DANIEL;M;GLUCKSTEIN;DANIEL;;93
Présidentielles 2002 - 1er tour;Présidentielles;2002;1;;;63;RUEIL MALMAISON;92063;48302;17158;31144;693;30451;MAMERE NOEL;M;MAMERE;NOEL;;1659
Présidentielles 2002 - 1er tour;Présidentielles;2002;1;;;63;RUEIL MALMAISON;92063;48302;17158;31144;693;30451;HUE ROBERT;M;HUE;ROBERT;;592
Présidentielles 2002 - 1er tour;Présidentielles;2002;1;;;71;SCEAUX;92071;12917;3930;8987;154;8833;LAGUILLER ARLETTE;F;LAGUILLER;ARLETTE;;214
Présidentielles 2002 - 1er tour;Présidentielles;2002;1;;;75;VANVES;92075;15493;4648;10845;221;10624;MEGRET BRUNO;M;MEGRET;BRUNO;;166
Présidentielles 2002 - 1er tour;Présidentielles;2002;1;;;76;VAUCRESSON;92076;5861;2048;3813;62;3751;LE PEN JEAN-MARIE;M;LE PEN;JEAN-MARIE;;389
Présidentielles 2002 - 1er tour;Présidentielles;2002;1;;;76;VAUCRESSON;92076;5861;2048;3813;62;3751;JOSPIN LIONEL;M;JOSPIN;LIONEL;;405
Présidentielles 2002 - 1er tour;Présidentielles;2002;1;;;76;VAUCRESSON;92076;5861;2048;3813;62;3751;BOUTIN CHRISTINE;F;BOUTIN;CHRISTINE;;87
Présidentielles 2002 - 1er tour;Présidentielles;2002;1;;;76;VAUCRESSON;92076;5861;2048;3813;62;3751;LAGUILLER ARLETTE;F;LAGUILLER;ARLETTE;;63
Présidentielles 2002 - 1er tour;Présidentielles;2002;1;;;77;VILLE D'AVRAY;92077;7251;2486;4765;70;4695;CHIRAC JACQUES;M;CHIRAC;JACQUES;;1424
Présidentielles 2002 - 1er tour;Présidentielles;2002;1;;;78;VILLENEUVE LA GARENNE;92078;11406;4746;6660;180;6480;HUE ROBERT;M;HUE;ROBERT;;248
Présidentielles 2002 - 1er tour;Présidentielles;2002;1;;;2;ANTONY;92002;36989;11047;25942;517;25425;LAGUILLER ARLETTE;F;LAGUILLER;ARLETTE;;922
Présidentielles 2002 - 1er tour;Présidentielles;2002;1;;;4;ASNIERES SUR SEINE;92004;35702;11271;24431;515;23916;SAINT-JOSSE JEAN;M;SAINT-JOSSE;JEAN;;183
Présidentielles 2002 - 1er tour;Présidentielles;2002;1;;;12;BOULOGNE BILLANCOURT;92012;57382;17570;39812;645;39167;CHEVENEMENT JEAN-PIERRE;M;CHEVENEMENT;JEAN-PIERRE;;2243
Législatives 2017 - 1er tour;Législatives;2017;1;1;1ère circonscription;78;VILLENEUVE LA GARENNE;92078;12445;8430;4015;143;3872;LAJILI Nasser;M;LAJILI;Nasser;FI;564
Législatives 2017 - 1er tour;Législatives;2017;1;1;1ère circonscription;36;GENNEVILLIERS;92036;22174;13223;8951;243;8708;LAJILI Nasser;M;LAJILI;Nasser;FI;1246
Législatives 2017 - 1er tour;Législatives;2017;1;1;1ère circonscription;25;COLOMBES;92025;27867;16420;11447;405;11042;CLAUX Bertille;F;CLAUX;Bertille;UDI;12
Législatives 2017 - 1er tour;Législatives;2017;1;1;1ère circonscription;36;GENNEVILLIERS;92036;22174;13223;8951;243;8708;LE GAL Anna;F;LE GAL;Anna;ECO;70
Législatives 2017 - 1er tour;Législatives;2017;1;1;1ère circonscription;78;VILLENEUVE LA GARENNE;92078;12445;8430;4015;143;3872;AODELLA Abdelmajid;M;AODELLA;Abdelmajid;DIV;123
Législatives 2017 - 1er tour;Législatives;2017;1;1;1ère circonscription;36;GENNEVILLIERS;92036;22174;13223;8951;243;8708;AODELLA Abdelmajid;M;AODELLA;Abdelmajid;DIV;239
Législatives 2017 - 1er tour;Législatives;2017;1;4;4ème circonscription;73;SURESNES;92073;28524;12725;15799;423;15376;BEDIN Camille;F;BEDIN;Camille;LR;2828
Législatives 2017 - 1er tour;Législatives;2017;1;5;5ème circonscription;24;CLICHY;92024;28620;14628;13992;265;13727;DUTILLOY Marie-Catherine;F;DUTILLOY;Marie-Catherine;ECO;200
Législatives 2017 - 1er tour;Législatives;2017;1;6;6ème circonscription;51;NEUILLY SUR SEINE;92051;37215;15249;21966;119;21847;ETZENBACH Nathalie;F;ETZENBACH;Nathalie;DVD;4578
Législatives 2017 - 1er tour;Législatives;2017;1;6;6ème circonscription;51;NEUILLY SUR SEINE;92051;37215;15249;21966;119;21847;PINCEMIN Martine;F;PINCEMIN;Martine;EXD;102
Législatives 2017 - 1er tour;Législatives;2017;1;8;8ème circonscription;72;SEVRES;92072;15144;6343;8801;149;8652;MEROUCHI Sandra;F;MEROUCHI;Sandra;DIV;48
Législatives 2017 - 1er tour;Législatives;2017;1;8;8ème circonscription;77;VILLE D'AVRAY;92077;7440;2857;4583;44;4539;CHETAILLE Romain;M;CHETAILLE;Romain;DVD;91
Législatives 2017 - 1er tour;Législatives;2017;1;10;10ème circonscription;12;BOULOGNE BILLANCOURT;92012;9082;4562;4520;114;4406;DRELON Marie-Thérèse;F;DRELON;Marie-Thérèse;DIV;59
Législatives 2017 - 1er tour;Législatives;2017;1;10;10ème circonscription;40;ISSY LES MOULINEAUX;92040;45375;19009;26366;517;25849;FOSSAERT Michel;M;FOSSAERT;Michel;ECO;24
Législatives 2017 - 1er tour;Législatives;2017;1;10;10ème circonscription;75;VANVES;92075;18507;7626;10881;125;10756;COUVENT Pauline;F;COUVENT;Pauline;ECO;699
Législatives 2017 - 1er tour;Législatives;2017;1;11;11ème circonscription;46;MALAKOFF;92046;18448;8148;10300;133;10167;EL-BOUZAÏDI CHEIKHI Aze-Dine;M;EL-BOUZAÏDI CHEIKHI;Aze-Dine;ECO;19
Législatives 2017 - 1er tour;Législatives;2017;1;11;11ème circonscription;46;MALAKOFF;92046;18448;8148;10300;133;10167;CARRASCO Julia;F;CARRASCO;Julia;FN;644
Législatives 2017 - 1er tour;Législatives;2017;1;12;12ème circonscription;23;CLAMART;92023;35342;15954;19388;238;19150;BOURLANGES Jean-Louis;M;BOURLANGES;Jean-Louis;MDM;8173
Législatives 2017 - 1er tour;Législatives;2017;1;12;12ème circonscription;60;LE PLESSIS ROBINSON;92060;19154;7496;11658;130;11528;PEMEZEC Philippe;M;PEMEZEC;Philippe;LR;4678
Législatives 2017 - 2ème tour;Législatives;2017;2;8;8ème circonscription;77;VILLE D'AVRAY;92077;7440;3586;3854;221;3633;BOYER Gilles;M;BOYER;Gilles;LR;1378
Législatives 2017 - 2ème tour;Législatives;2017;2;11;11ème circonscription;7;BAGNEUX;92007;21911;12848;9063;516;8547;BOUDJENAH Yasmine;F;BOUDJENAH;Yasmine;FI;4803
Législatives 2017 - 2ème tour;Législatives;2017;2;11;11ème circonscription;46;MALAKOFF;92046;18448;9121;9327;443;8884;BOUDJENAH Yasmine;F;BOUDJENAH;Yasmine;FI;5067
Législatives 2017 - 2ème tour;Législatives;2017;2;12;12ème circonscription;20;CHATILLON;92020;22311;11653;10658;1083;9575;BOURLANGES Jean-Louis;M;BOURLANGES;Jean-Louis;MDM;6002
Législatives 2017 - 1er tour;Législatives;2017;1;3;3ème circonscription;26;COURBEVOIE;92026;44322;19890;24432;415;24017;HENNION Christine;F;HENNION;Christine;REM;11208
Législatives 2017 - 1er tour;Législatives;2017;1;4;4ème circonscription;50;NANTERRE;92050;47651;26455;21196;432;20764;BRUNET Antoine;M;BRUNET;Antoine;EXG;37
Législatives 2017 - 1er tour;Législatives;2017;1;4;4ème circonscription;73;SURESNES;92073;28524;12725;15799;423;15376;FANTINO Laurent;M;FANTINO;Laurent;DIV;49
Présidentielles 2017 - 1er tour;Présidentielles;2017;1;;;4;ASNIERES SUR SEINE;92004;48227;8578;39649;807;38842;MÉLENCHON Jean-Luc;M;MÉLENCHON;Jean-Luc;;7669
Présidentielles 2017 - 1er tour;Présidentielles;2017;1;;;22;CHAVILLE;92022;13493;2042;11451;183;11267;FILLON François;M;FILLON;François;;3153
Présidentielles 2017 - 1er tour;Présidentielles;2017;1;;;23;CLAMART;92023;35291;6330;28961;560;28401;LASSALLE Jean;M;LASSALLE;Jean;;190
Présidentielles 2017 - 1er tour;Présidentielles;2017;1;;;26;COURBEVOIE;92026;52391;9609;42782;817;41965;DUPONT-AIGNAN Nicolas;M;DUPONT-AIGNAN;Nicolas;;1116
Présidentielles 2017 - 1er tour;Présidentielles;2017;1;;;26;COURBEVOIE;92026;52391;9609;42782;817;41965;LE PEN Marine;F;LE PEN;Marine;;3111
Présidentielles 2017 - 1er tour;Présidentielles;2017;1;;;32;FONTENAY AUX ROSES;92032;16036;3739;12297;218;12078;CHEMINADE Jacques;M;CHEMINADE;Jacques;;29
Présidentielles 2017 - 1er tour;Présidentielles;2017;1;;;33;GARCHES;92033;12767;1975;10792;194;10598;DUPONT-AIGNAN Nicolas;M;DUPONT-AIGNAN;Nicolas;;273
Présidentielles 2017 - 1er tour;Présidentielles;2017;1;;;36;GENNEVILLIERS;92036;22149;5526;16623;490;16133;ASSELINEAU François;M;ASSELINEAU;François;;456
Présidentielles 2017 - 1er tour;Présidentielles;2017;1;;;36;GENNEVILLIERS;92036;22149;5526;16623;490;16133;HAMON Benoît;M;HAMON;Benoît;;1254
Présidentielles 2017 - 1er tour;Présidentielles;2017;1;;;48;MEUDON;92048;31280;5715;25565;405;25160;CHEMINADE Jacques;M;CHEMINADE;Jacques;;45
Présidentielles 2017 - 1er tour;Présidentielles;2017;1;;;48;MEUDON;92048;31280;5715;25565;405;25160;FILLON François;M;FILLON;François;;7239
Présidentielles 2017 - 1er tour;Présidentielles;2017;1;;;49;MONTROUGE;92049;28899;4312;24587;429;24158;LASSALLE Jean;M;LASSALLE;Jean;;156
Présidentielles 2017 - 1er tour;Présidentielles;2017;1;;;51;NEUILLY SUR SEINE;92051;37184;4180;33004;212;32792;POUTOU Philippe;M;POUTOU;Philippe;;48
Présidentielles 2017 - 1er tour;Présidentielles;2017;1;;;64;SAINT CLOUD;92064;19370;2628;16742;186;16556;CHEMINADE Jacques;M;CHEMINADE;Jacques;;22
Présidentielles 2017 - 1er tour;Présidentielles;2017;1;;;71;SCEAUX;92071;15052;2914;12138;145;11993;HAMON Benoît;M;HAMON;Benoît;;884
Présidentielles 2017 - 1er tour;Présidentielles;2017;1;;;72;SEVRES;92072;15142;2166;12976;213;12763;LASSALLE Jean;M;LASSALLE;Jean;;83
Présidentielles 2017 - 1er tour;Présidentielles;2017;1;;;73;SURESNES;92073;28497;4342;24155;520;23635;DUPONT-AIGNAN Nicolas;M;DUPONT-AIGNAN;Nicolas;;695
Présidentielles 2017 - 1er tour;Présidentielles;2017;1;;;75;VANVES;92075;18500;3228;15272;248;15024;LASSALLE Jean;M;LASSALLE;Jean;;105
Présidentielles 2017 - 1er tour;Présidentielles;2017;1;;;77;VILLE D'AVRAY;92077;7433;837;6596;89;6507;ASSELINEAU François;M;ASSELINEAU;François;;44
Présidentielles 2017 - 1er tour;Présidentielles;2017;1;;;77;VILLE D'AVRAY;92077;7433;837;6596;89;6507;MÉLENCHON Jean-Luc;M;MÉLENCHON;Jean-Luc;;627
Présidentielles 2017 - 1er tour;Présidentielles;2017;1;;;78;VILLENEUVE LA GARENNE;92078;12429;3872;8557;315;8242;FILLON François;M;FILLON;François;;1030
Présidentielles 2017 - 1er tour;Présidentielles;2017;1;;;78;VILLENEUVE LA GARENNE;92078;12429;3872;8557;315;8242;POUTOU Philippe;M;POUTOU;Philippe;;75
Présidentielles 2012 - 1er tour;Présidentielles;2012;1;;;2;ANTONY;92002;40169;7755;32414;674;31740;ARTHAUD Nathalie;F;ARTHAUD;Nathalie;;108
Présidentielles 2012 - 1er tour;Présidentielles;2012;1;;;4;ASNIERES SUR SEINE;92004;45042;9279;35763;516;35247;JOLY Eva;F;JOLY;Eva;;1054
Présidentielles 2012 - 1er tour;Présidentielles;2012;1;;;32;FONTENAY AUX ROSES;92032;15217;3289;11928;161;11767;LE PEN Marine;F;LE PEN;Marine;;1029
Présidentielles 2012 - 1er tour;Présidentielles;2012;1;;;46;MALAKOFF;92046;18852;4162;14690;207;14483;BAYROU François;M;BAYROU;François;;1141
Présidentielles 2012 - 1er tour;Présidentielles;2012;1;;;77;VILLE D'AVRAY;92077;7132;1060;6072;80;5992;JOLY Eva;F;JOLY;Eva;;196
Présidentielles 2012 - 1er tour;Présidentielles;2012;1;;;78;VILLENEUVE LA GARENNE;92078;12332;3328;9004;225;8779;JOLY Eva;F;JOLY;Eva;;126
Présidentielles 2012 - 2ème tour;Présidentielles;2012;2;;;26;COURBEVOIE;92026;50575;9527;41048;1678;39370;SARKOZY Nicolas;M;SARKOZY;Nicolas;;21894
Présidentielles 2012 - 2ème tour;Présidentielles;2012;2;;;50;NANTERRE;92050;44340;9083;35257;1617;33640;HOLLANDE François;M;HOLLANDE;François;;23282
Présidentielles 2012 - 2ème tour;Présidentielles;2012;2;;;78;VILLENEUVE LA GARENNE;92078;12332;3034;9298;486;8812;SARKOZY Nicolas;M;SARKOZY;Nicolas;;2898
Présidentielles 2017 - 2ème tour;Présidentielles;2017;2;;;23;CLAMART;92023;35297;8251;27046;2436;24610;LE PEN Marine;F;LE PEN;Marine;;4083
Présidentielles 2017 - 2ème tour;Présidentielles;2017;2;;;48;MEUDON;92048;31253;7214;24039;2126;21913;LE PEN Marine;F;LE PEN;Marine;;3384
Présidentielles 2017 - 2ème tour;Présidentielles;2017;2;;;62;PUTEAUX;92062;28954;5852;23102;2162;20940;LE PEN Marine;F;LE PEN;Marine;;3655
Présidentielles 2017 - 2ème tour;Présidentielles;2017;2;;;64;SAINT CLOUD;92064;19377;3971;15406;1271;14135;LE PEN Marine;F;LE PEN;Marine;;2066
Législatives 2007 - 1er tour;Législatives;2007;1;13;13ème circonscription;2;ANTONY;92002;39807;13942;25865;456;25409;FONTAN Huguette;F;FONTAN;Huguette;DIV;26
Législatives 2007 - 1er tour;Législatives;2007;1;10;10ème circonscription;40;ISSY LES MOULINEAUX;92040;38520;14017;24503;359;24144;DROUET Valérie;F;DROUET;Valérie;EXD;27
Législatives 2007 - 1er tour;Législatives;2007;1;7;7ème circonscription;33;GARCHES;92033;12286;4601;7685;112;7573;SAGE Julien;M;SAGE;Julien;VEC;196
Législatives 2007 - 1er tour;Législatives;2007;1;12;12ème circonscription;20;CHATILLON;92020;20661;7083;13578;137;13441;DIAZ GOMEZ Elisabeth;F;DIAZ GOMEZ;Elisabeth;DIV;1
Législatives 2007 - 1er tour;Législatives;2007;1;10;10ème circonscription;48;MEUDON;92048;5066;1864;3202;29;3173;NAVIAUX Catherine;F;NAVIAUX;Catherine;VEC;148
Législatives 2007 - 1er tour;Législatives;2007;1;4;4ème circonscription;50;NANTERRE;92050;42631;18721;23910;314;23596;GOIN Catherine;F;GOIN;Catherine;EXG;116
Législatives 2007 - 1er tour;Législatives;2007;1;13;13ème circonscription;71;SCEAUX;92071;14129;4679;9450;74;9376;SARFATI André;M;SARFATI;André;DIV;58
Législatives 2007 - 1er tour;Législatives;2007;1;8;8ème circonscription;72;SEVRES;92072;14460;5279;9181;151;9030;DEQUEANT Annie;F;DEQUEANT;Annie;FN;264
Législatives 2007 - 1er tour;Législatives;2007;1;10;10ème circonscription;12;BOULOGNE BILLANCOURT;92012;5551;2367;3184;78;3106;VENTURINI Jean-Michel;M;VENTURINI;Jean-Michel;DIV;7
Législatives 2007 - 1er tour;Législatives;2007;1;12;12ème circonscription;60;LE PLESSIS ROBINSON;92060;16776;5588;11188;123;11065;BRILLON Freddy;M;BRILLON;Freddy;DVD;29
Législatives 2007 - 1er tour;Législatives;2007;1;4;4ème circonscription;50;NANTERRE;92050;42631;18721;23910;314;23596;LE ROUX Cécile;M;LE ROUX;Cécile;DIV;39
Législatives 2007 - 1er tour;Législatives;2007;1;6;6ème circonscription;62;PUTEAUX;92062;26791;8829;17962;396;17566;CECCALDI-RAYNAUD Joëlle;F;CECCALDI-RAYNAUD;Joëlle;UMP;8656
Législatives 2007 - 1er tour;Législatives;2007;1;7;7ème circonscription;63;RUEIL MALMAISON;92063;51481;18902;32579;337;32242;CHOLLOU Sylvia;F;CHOLLOU;Sylvia;DIV;0
Législatives 2007 - 1er tour;Législatives;2007;1;13;13ème circonscription;71;SCEAUX;92071;14129;4679;9450;74;9376;DELRIEU Denis;M;DELRIEU;Denis;VEC;314
Législatives 2007 - 1er tour;Législatives;2007;1;10;10ème circonscription;12;BOULOGNE BILLANCOURT;92012;5551;2367;3184;78;3106;BINDER Sabrina;F;BINDER;Sabrina;DIV;12
Législatives 2007 - 1er tour;Législatives;2007;1;13;13ème circonscription;19;CHATENAY MALABRY;92019;17835;6584;11251;211;11040;CANET Michèle;F;CANET;Michèle;SOC;3100
Législatives 2007 - 1er tour;Législatives;2007;1;8;8ème circonscription;76;VAUCRESSON;92076;6076;2206;3870;46;3824;FILLOUX Delphine;F;FILLOUX;Delphine;DIV;36
Législatives 2007 - 1er tour;Législatives;2007;1;1;1ère circonscription;78;VILLENEUVE LA GARENNE;92078;13038;7211;5827;131;5696;ROBERT Bertrand;M;ROBERT;Bertrand;EXD;42
Législatives 2007 - 2ème tour;Législatives;2007;2;11;11ème circonscription;49;MONTROUGE;92049;26595;10737;15858;381;15477;AMIABLE Marie-Hélène;F;AMIABLE;Marie-Hélène;COM;7217
Législatives 2007 - 2ème tour;Législatives;2007;2;13;13ème circonscription;2;ANTONY;92002;39811;15865;23946;885;23061;DEVEDJIAN Patrick;M;DEVEDJIAN;Patrick;UMP;12754
Présidentielles 2002 - 1er tour;Présidentielles;2002;1;;;2;ANTONY;92002;36989;11047;25942;517;25425;TAUBIRA CHRISTIANE;F;TAUBIRA;CHRISTIANE;;924
Présidentielles 2002 - 1er tour;Présidentielles;2002;1;;;2;ANTONY;92002;36989;11047;25942;517;25425;CHEVENEMENT JEAN-PIERRE;M;CHEVENEMENT;JEAN-PIERRE;;1850
Présidentielles 2002 - 1er tour;Présidentielles;2002;1;;;4;ASNIERES SUR SEINE;92004;35702;11271;24431;515;23916;MAMERE NOEL;M;MAMERE;NOEL;;1354
Présidentielles 2002 - 1er tour;Présidentielles;2002;1;;;9;BOIS COLOMBES;92009;13996;4554;9442;200;9242;BOUTIN CHRISTINE;F;BOUTIN;CHRISTINE;;123
Présidentielles 2002 - 1er tour;Présidentielles;2002;1;;;14;BOURG LA REINE;92014;12075;3519;8556;149;8407;LEPAGE CORINNE;F;LEPAGE;CORINNE;;226
Présidentielles 2002 - 1er tour;Présidentielles;2002;1;;;14;BOURG LA REINE;92014;12075;3519;8556;149;8407;JOSPIN LIONEL;M;JOSPIN;LIONEL;;1514
Présidentielles 2002 - 1er tour;Présidentielles;2002;1;;;14;BOURG LA REINE;92014;12075;3519;8556;149;8407;HUE ROBERT;M;HUE;ROBERT;;196
Présidentielles 2002 - 1er tour;Présidentielles;2002;1;;;20;CHATILLON;92020;18067;5487;12580;295;12285;SAINT-JOSSE JEAN;M;SAINT-JOSSE;JEAN;;98
Présidentielles 2002 - 1er tour;Présidentielles;2002;1;;;20;CHATILLON;92020;18067;5487;12580;295;12285;CHEVENEMENT JEAN-PIERRE;M;CHEVENEMENT;JEAN-PIERRE;;816
Présidentielles 2002 - 1er tour;Présidentielles;2002;1;;;25;COLOMBES;92025;39608;13654;25954;571;25383;MEGRET BRUNO;M;MEGRET;BRUNO;;614
Présidentielles 2002 - 1er tour;Présidentielles;2002;1;;;35;LA GARENNE COLOMBES;92035;15006;5167;9839;227;9612;BOUTIN CHRISTINE;F;BOUTIN;CHRISTINE;;119
Présidentielles 2002 - 1er tour;Présidentielles;2002;1;;;35;LA GARENNE COLOMBES;92035;15006;5167;9839;227;9612;BESANCENOT OLIVIER;M;BESANCENOT;OLIVIER;;251
Présidentielles 2002 - 1er tour;Présidentielles;2002;1;;;40;ISSY LES MOULINEAUX;92040;32059;9424;22635;510;22125;MAMERE NOEL;M;MAMERE;NOEL;;1491
Présidentielles 2002 - 1er tour;Présidentielles;2002;1;;;44;LEVALLOIS PERRET;92044;33618;9640;23978;575;23403;CHIRAC JACQUES;M;CHIRAC;JACQUES;;6934
Présidentielles 2002 - 1er tour;Présidentielles;2002;1;;;44;LEVALLOIS PERRET;92044;33618;9640;23978;575;23403;MAMERE NOEL;M;MAMERE;NOEL;;1162
Présidentielles 2002 - 1er tour;Présidentielles;2002;1;;;46;MALAKOFF;92046;17268;6020;11248;271;10977;LE PEN JEAN-MARIE;M;LE PEN;JEAN-MARIE;;1288
Présidentielles 2002 - 1er tour;Présidentielles;2002;1;;;48;MEUDON;92048;28283;9341;18942;321;18621;GLUCKSTEIN DANIEL;M;GLUCKSTEIN;DANIEL;;55
Présidentielles 2002 - 1er tour;Présidentielles;2002;1;;;49;MONTROUGE;92049;23382;8142;15240;301;14939;TAUBIRA CHRISTIANE;F;TAUBIRA;CHRISTIANE;;595
Présidentielles 2002 - 1er tour;Présidentielles;2002;1;;;50;NANTERRE;92050;37590;13303;24287;669;23618;JOSPIN LIONEL;M;JOSPIN;LIONEL;;4490
Présidentielles 2002 - 1er tour;Présidentielles;2002;1;;;51;NEUILLY SUR SEINE;92051;34066;10108;23958;309;23649;MAMERE NOEL;M;MAMERE;NOEL;;489
Présidentielles 2002 - 1er tour;Présidentielles;2002;1;;;51;NEUILLY SUR SEINE;92051;34066;10108;23958;309;23649;HUE ROBERT;M;HUE;ROBERT;;79
Présidentielles 2002 - 1er tour;Présidentielles;2002;1;;;60;LE PLESSIS ROBINSON;92060;14503;4736;9767;230;9537;CHIRAC JACQUES;M;CHIRAC;JACQUES;;2286
Présidentielles 2002 - 1er tour;Présidentielles;2002;1;;;60;LE PLESSIS ROBINSON;92060;14503;4736;9767;230;9537;MAMERE NOEL;M;MAMERE;NOEL;;526
Présidentielles 2002 - 1er tour;Présidentielles;2002;1;;;62;PUTEAUX;92062;23861;6804;17057;487;16570;MAMERE NOEL;M;MAMERE;NOEL;;961
Présidentielles 2002 - 1er tour;Présidentielles;2002;1;;;63;RUEIL MALMAISON;92063;48302;17158;31144;693;30451;LAGUILLER ARLETTE;F;LAGUILLER;ARLETTE;;1101
Présidentielles 2002 - 1er tour;Présidentielles;2002;1;;;72;SEVRES;92072;13367;4140;9227;153;9074;MADELIN ALAIN;M;MADELIN;ALAIN;;584
Présidentielles 2002 - 1er tour;Présidentielles;2002;1;;;73;SURESNES;92073;22099;7156;14943;329;14614;GLUCKSTEIN DANIEL;M;GLUCKSTEIN;DANIEL;;37
Présidentielles 2002 - 1er tour;Présidentielles;2002;1;;;75;VANVES;92075;15493;4648;10845;221;10624;BESANCENOT OLIVIER;M;BESANCENOT;OLIVIER;;388
Présidentielles 2002 - 1er tour;Présidentielles;2002;1;;;76;VAUCRESSON;92076;5861;2048;3813;62;3751;LEPAGE CORINNE;F;LEPAGE;CORINNE;;131
Présidentielles 2002 - 1er tour;Présidentielles;2002;1;;;77;VILLE D'AVRAY;92077;7251;2486;4765;70;4695;CHEVENEMENT JEAN-PIERRE;M;CHEVENEMENT;JEAN-PIERRE;;280
Présidentielles 2002 - 1er tour;Présidentielles;2002;1;;;78;VILLENEUVE LA GARENNE;92078;11406;4746;6660;180;6480;LE PEN JEAN-MARIE;M;LE PEN;JEAN-MARIE;;1186
Présidentielles 2002 - 1er tour;Présidentielles;2002;1;;;78;VILLENEUVE LA GARENNE;92078;11406;4746;6660;180;6480;MADELIN ALAIN;M;MADELIN;ALAIN;;311
Présidentielles 2007 - 1er tour;Présidentielles;2007;1;;;2;ANTONY;92002;39316;4695;34621;413;34208;ROYAL Ségolène;F;ROYAL;Ségolène;;9418
Présidentielles 2007 - 1er tour;Présidentielles;2007;1;;;19;CHATENAY MALABRY;92019;17598;2318;15280;229;15051;LAGUILLER Arlette;F;LAGUILLER;Arlette;;96
Présidentielles 2007 - 1er tour;Présidentielles;2007;1;;;22;CHAVILLE;92022;12743;1700;11043;119;10924;BAYROU François;M;BAYROU;François;;2635
Présidentielles 2007 - 1er tour;Présidentielles;2007;1;;;23;CLAMART;92023;32539;3879;28660;293;28367;BESANCENOT Olivier;M;BESANCENOT;Olivier;;816
Présidentielles 2007 - 1er tour;Présidentielles;2007;1;;;23;CLAMART;92023;32539;3879;28660;293;28367;VOYNET Dominique;F;VOYNET;Dominique;;469
Présidentielles 2007 - 1er tour;Présidentielles;2007;1;;;24;CLICHY;92024;28539;4472;24067;245;23822;SARKOZY Nicolas;M;SARKOZY;Nicolas;;6209
Présidentielles 2007 - 1er tour;Présidentielles;2007;1;;;32;FONTENAY AUX ROSES;92032;15234;2027;13207;123;13084;NIHOUS Frédéric;M;NIHOUS;Frédéric;;39
Présidentielles 2007 - 1er tour;Présidentielles;2007;1;;;44;LEVALLOIS PERRET;92044;38708;4734;33974;296;33678;LAGUILLER Arlette;F;LAGUILLER;Arlette;;180
Présidentielles 2007 - 1er tour;Présidentielles;2007;1;;;47;MARNES LA COQUETTE;92047;1054;91;963;9;954;SCHIVARDI Gérard;M;SCHIVARDI;Gérard;;0
Présidentielles 2007 - 1er tour;Présidentielles;2007;1;;;47;MARNES LA COQUETTE;92047;1054;91;963;9;954;BOVÉ José;M;BOVÉ;José;;6
Présidentielles 2007 - 1er tour;Présidentielles;2007;1;;;47;MARNES LA COQUETTE;92047;1054;91;963;9;954;SARKOZY Nicolas;M;SARKOZY;Nicolas;;566
Présidentielles 2007 - 1er tour;Présidentielles;2007;1;;;60;LE PLESSIS ROBINSON;92060;16571;1989;14582;159;14423;de VILLIERS Philippe;M;de VILLIERS;Philippe;;205
Présidentielles 2007 - 1er tour;Présidentielles;2007;1;;;62;PUTEAUX;92062;26761;3397;23364;263;23101;BAYROU François;M;BAYROU;François;;5075
Présidentielles 2007 - 1er tour;Présidentielles;2007;1;;;73;SURESNES;92073;24255;2600;21655;272;21383;LAGUILLER Arlette;F;LAGUILLER;Arlette;;155
Présidentielles 2007 - 1er tour;Présidentielles;2007;1;;;76;VAUCRESSON;92076;5902;781;5121;42;5079;BUFFET Marie-George;F;BUFFET;Marie-George;;21
Présidentielles 1995 - 1er tour;Présidentielles;1995;1;;;48;MEUDON;92048;29714;7851;21863;352;21511;JOSPIN LIONEL;M;JOSPIN;LIONEL;;5629
Présidentielles 1995 - 1er tour;Présidentielles;1995;1;;;50;NANTERRE;92050;46920;11548;35372;736;34636;JOSPIN LIONEL;M;JOSPIN;LIONEL;;8271
Présidentielles 1995 - 1er tour;Présidentielles;1995;1;;;50;NANTERRE;92050;46920;11548;35372;736;34636;VOYNET DOMINIQUE;F;VOYNET;DOMINIQUE;;1255
Présidentielles 1995 - 1er tour;Présidentielles;1995;1;;;64;SAINT CLOUD;92064;18989;5119;13870;179;13691;LAGUILLER ARLETTE;F;LAGUILLER;ARLETTE;;377
Présidentielles 1995 - 1er tour;Présidentielles;1995;1;;;4;ASNIERES SUR SEINE;92004;39050;10288;28762;594;28168;HUE ROBERT;M;HUE;ROBERT;;1582
Présidentielles 1995 - 1er tour;Présidentielles;1995;1;;;7;BAGNEUX;92007;20166;5090;15076;308;14768;CHEMINADE JACQUES;M;CHEMINADE;JACQUES;;28
Présidentielles 1995 - 1er tour;Présidentielles;1995;1;;;7;BAGNEUX;92007;20166;5090;15076;308;14768;LE PEN J.MARIE;M;LE PEN;J.MARIE;;1810
Présidentielles 2007 - 2ème tour;Présidentielles;2007;2;;;4;ASNIERES SUR SEINE;92004;43559;6164;37395;1262;36133;ROYAL Ségolène;F;ROYAL;Ségolène;;16762
Présidentielles 2007 - 2ème tour;Présidentielles;2007;2;;;12;BOULOGNE BILLANCOURT;92012;64778;8373;56405;1995;54410;ROYAL Ségolène;F;ROYAL;Ségolène;;18140
Présidentielles 2007 - 2ème tour;Présidentielles;2007;2;;;19;CHATENAY MALABRY;92019;17599;2412;15187;633;14554;ROYAL Ségolène;F;ROYAL;Ségolène;;7680
Présidentielles 2007 - 2ème tour;Présidentielles;2007;2;;;75;VANVES;92075;17143;2248;14895;572;14323;ROYAL Ségolène;F;ROYAL;Ségolène;;7262
Présidentielles 1995 - 1er tour;Présidentielles;1995;1;;;19;CHATENAY MALABRY;92019;18227;5121;13106;238;12868;VILLIERS DE PHILIPPE;M;VILLIERS DE;PHILIPPE;;421
Présidentielles 1995 - 1er tour;Présidentielles;1995;1;;;9;BOIS COLOMBES;92009;14922;3871;11051;199;10852;VOYNET DOMINIQUE;F;VOYNET;DOMINIQUE;;382
Présidentielles 1995 - 1er tour;Présidentielles;1995;1;;;32;FONTENAY AUX ROSES;92032;14917;3559;11358;196;11162;CHIRAC JACQUES;M;CHIRAC;JACQUES;;2687
Présidentielles 1995 - 1er tour;Présidentielles;1995;1;;;33;GARCHES;92033;11689;2941;8748;172;8576;HUE ROBERT;M;HUE;ROBERT;;273
Présidentielles 1995 - 2ème tour;Présidentielles;1995;2;;;25;COLOMBES;92025;44851;10790;34061;1956;32105;CHIRAC JACQUES;M;CHIRAC;JACQUES;;16642
Présidentielles 1995 - 2ème tour;Présidentielles;1995;2;;;32;FONTENAY AUX ROSES;92032;14917;2889;12028;533;11495;JOSPIN LIONEL;M;JOSPIN;LIONEL;;5300
Présidentielles 1995 - 2ème tour;Présidentielles;1995;2;;;50;NANTERRE;92050;46920;10896;36024;2205;33819;JOSPIN LIONEL;M;JOSPIN;LIONEL;;18449
Présidentielles 2002 - 2ème tour;Présidentielles;2002;2;;;72;SEVRES;92072;13374;2151;11223;295;10928;LE PEN JEAN-MARIE;M;LE PEN;JEAN-MARIE;;1069
Présidentielles 1995 - 1er tour;Présidentielles;1995;1;;;24;CLICHY;92024;24688;6820;17868;364;17504;LE PEN J.MARIE;M;LE PEN;J.MARIE;;2674
Présidentielles 1995 - 1er tour;Présidentielles;1995;1;;;4;ASNIERES SUR SEINE;92004;39050;10288;28762;594;28168;LAGUILLER ARLETTE;F;LAGUILLER;ARLETTE;;1430
Législatives 1993 - 2ème tour;Législatives;1993;2;11;11ème circonscription;49;MONTROUGE;92049;22632;7620;15012;974;14038;JAMBU JANINE;F;JAMBU;JANINE;COM;5998
Législatives 1997 - 1er tour;Législatives;1997;1;13;13ème circonscription;2;ANTONY;92002;37772;12082;25690;861;24829;PARLANGE AGNES;F;PARLANGE;AGNES;EXG;133
Législatives 1997 - 1er tour;Législatives;1997;1;11;11ème circonscription;7;BAGNEUX;92007;20284;7388;12896;374;12522;JAMBU JANINE;F;JAMBU;JANINE;COM;4616
Législatives 1997 - 1er tour;Législatives;1997;1;10;10ème circonscription;12;BOULOGNE BILLANCOURT;92012;4529;1717;2812;99;2713;BERTRAND GINETTE;F;BERTRAND;GINETTE;DVD;70
Législatives 1997 - 1er tour;Législatives;1997;1;9;9ème circonscription;12;BOULOGNE BILLANCOURT;92012;53287;18902;34385;948;33437;HUNSINGER MARC;M;HUNSINGER;MARC;DVD;309
Législatives 1997 - 1er tour;Législatives;1997;1;9;9ème circonscription;12;BOULOGNE BILLANCOURT;92012;53287;18902;34385;948;33437;RUBIN SABINE;F;RUBIN;SABINE;DIV;0
Législatives 1997 - 1er tour;Législatives;1997;1;8;8ème circonscription;22;CHAVILLE;92022;12268;3930;8338;262;8076;JASSERAND BERNARD;M;JASSERAND;BERNARD;COM;658
Législatives 1997 - 1er tour;Législatives;1997;1;12;12ème circonscription;20;CHATILLON;92020;16406;5234;11172;367;10805;BUCHET PASCAL;M;BUCHET;PASCAL;SOC;3094
Législatives 1997 - 1er tour;Législatives;1997;1;12;12ème circonscription;23;CLAMART;92023;30471;10310;20161;590;19571;BUCHET PASCAL;M;BUCHET;PASCAL;SOC;5099
Législatives 1997 - 1er tour;Législatives;1997;1;13;13ème circonscription;19;CHATENAY MALABRY;92019;17859;6462;11397;367;11030;RIVIERE ALAIN;M;RIVIERE;ALAIN;DVD;276
Législatives 1997 - 1er tour;Législatives;1997;1;13;13ème circonscription;14;BOURG LA REINE;92014;12587;4431;8156;266;7890;ROMAN INGRID;F;ROMAN;INGRID;DIV;5
Législatives 1997 - 1er tour;Législatives;1997;1;13;13ème circonscription;19;CHATENAY MALABRY;92019;17859;6462;11397;367;11030;SEXER YVES;M;SEXER;YVES;DVD;188
Législatives 1997 - 1er tour;Législatives;1997;1;10;10ème circonscription;40;ISSY LES MOULINEAUX;92040;30164;10899;19265;543;18722;LE ROY THIERRY;M;LE ROY;THIERRY;DVG;1232
Législatives 1997 - 1er tour;Législatives;1997;1;10;10ème circonscription;40;ISSY LES MOULINEAUX;92040;30164;10899;19265;543;18722;HERVO DIDIER;M;HERVO;DIDIER;ECO;961
Législatives 1997 - 1er tour;Législatives;1997;1;1;1ère circonscription;36;GENNEVILLIERS;92036;19277;7226;12051;295;11756;ROUAT ALAIN;M;ROUAT;ALAIN;ECO;363
Législatives 1997 - 1er tour;Législatives;1997;1;12;12ème circonscription;32;FONTENAY AUX ROSES;92032;14748;4655;10093;259;9834;BUCHET PASCAL;M;BUCHET;PASCAL;SOC;3456
Législatives 1997 - 1er tour;Législatives;1997;1;2;2ème circonscription;25;COLOMBES;92025;17603;6110;11493;415;11078;MOAL PHILIPPE;M;MOAL;PHILIPPE;DIV;25
Législatives 1997 - 1er tour;Législatives;1997;1;3;3ème circonscription;35;LA GARENNE COLOMBES;92035;13992;5163;8829;294;8535;LE RET CHRISTOPHE;M;LE RET;CHRISTOPHE;DVD;121
Législatives 1997 - 1er tour;Législatives;1997;1;3;3ème circonscription;35;LA GARENNE COLOMBES;92035;13992;5163;8829;294;8535;HABY J.YVES;M;HABY;J.YVES;UDF;1760
Législatives 1993 - 1er tour;Législatives;1993;1;12;12ème circonscription;60;LE PLESSIS ROBINSON;92060;13118;4266;8852;315;8537;BUCHET PASCAL;M;BUCHET;PASCAL;SOC;1331
Législatives 1993 - 1er tour;Législatives;1993;1;7;7ème circonscription;64;SAINT CLOUD;92064;19166;6250;12916;429;12487;DARBEL MADELEINE;F;DARBEL;MADELEINE;SOC;1673
Législatives 1993 - 1er tour;Législatives;1993;1;6;6ème circonscription;62;PUTEAUX;92062;23271;6636;16635;697;15938;DACHEZ ROGER;M;DACHEZ;ROGER;DIV;295
Législatives 1993 - 1er tour;Législatives;1993;1;1;1ère circonscription;78;VILLENEUVE LA GARENNE;92078;11604;4168;7436;212;7224;BRUNHES JACQUES;M;BRUNHES;JACQUES;COM;1172
Législatives 1993 - 1er tour;Législatives;1993;1;10;10ème circonscription;75;VANVES;92075;15286;4324;10962;394;10568;VASSEUR J.YVES;M;VASSEUR;J.YVES;COM;603
Législatives 1993 - 1er tour;Législatives;1993;1;1;1ère circonscription;36;GENNEVILLIERS;92036;19185;6818;12367;395;11972;FAUCONNIER DENIS;M;FAUCONNIER;DENIS;DIV;306
Législatives 1993 - 1er tour;Législatives;1993;1;1;1ère circonscription;36;GENNEVILLIERS;92036;19185;6818;12367;395;11972;MOURRE DOMINIQUE;M;MOURRE;DOMINIQUE;EXG;78
Législatives 1993 - 1er tour;Législatives;1993;1;7;7ème circonscription;33;GARCHES;92033;11440;3330;8110;328;7782;GENSANNE MARIE;F;GENSANNE;MARIE;DIV;233
Législatives 1993 - 1er tour;Législatives;1993;1;8;8ème circonscription;22;CHAVILLE;92022;12345;3904;8441;296;8145;ROY CAROLINE;F;ROY;CAROLINE;RDG;1695
Législatives 1993 - 1er tour;Législatives;1993;1;8;8ème circonscription;22;CHAVILLE;92022;12345;3904;8441;296;8145;WOLF HENRY;M;WOLF;HENRY;UDF;1230
Législatives 1993 - 1er tour;Législatives;1993;1;12;12ème circonscription;23;CLAMART;92023;30899;9896;21003;704;20299;BURGAUD CHRISTINE;F;BURGAUD;CHRISTINE;DIV;154
Législatives 1993 - 1er tour;Législatives;1993;1;5;5ème circonscription;24;CLICHY;92024;25172;9290;15882;514;15368;LEFEBVRE HERVE;M;LEFEBVRE;HERVE;DVD;59
Législatives 1993 - 1er tour;Législatives;1993;1;12;12ème circonscription;23;CLAMART;92023;30899;9896;21003;704;20299;DUNG JURGEN;M;DUNG;JURGEN;MAJ;210
Législatives 1993 - 1er tour;Législatives;1993;1;5;5ème circonscription;24;CLICHY;92024;25172;9290;15882;514;15368;SCHMAUS GUY;M;SCHMAUS;GUY;COM;1428
Législatives 1993 - 1er tour;Législatives;1993;1;5;5ème circonscription;24;CLICHY;92024;25172;9290;15882;514;15368;YADAN DOV;M;YADAN;DOV;DVD;183
Législatives 1993 - 2ème tour;Législatives;1993;2;10;10ème circonscription;12;BOULOGNE BILLANCOURT;92012;4523;2047;2476;163;2313;BITON MARLENE;F;BITON;MARLENE;SOC;1003
Législatives 1997 - 1er tour;Législatives;1997;1;4;4ème circonscription;73;SURESNES;92073;20985;7217;13768;441;13327;THIBAULT FRANCOIS;M;THIBAULT;FRANCOIS;DVG;38
Législatives 1997 - 1er tour;Législatives;1997;1;8;8ème circonscription;72;SEVRES;92072;13776;4413;9363;352;9011;ETILE L.CHRISTOPHE;M;ETILE;L.CHRISTOPHE;DVD;195
Législatives 1997 - 1er tour;Législatives;1997;1;7;7ème circonscription;64;SAINT CLOUD;92064;18908;7095;11813;417;11396;PEYRILLER PAUL;M;PEYRILLER;PAUL;ECO;76
Législatives 1997 - 1er tour;Législatives;1997;1;13;13ème circonscription;71;SCEAUX;92071;13168;3887;9281;266;9015;LAVAL J.MARIE;M;LAVAL;J.MARIE;DVD;209
Législatives 1997 - 1er tour;Législatives;1997;1;12;12ème circonscription;60;LE PLESSIS ROBINSON;92060;13002;3860;9142;204;8938;PEYRONNEAU GASTON;M;PEYRONNEAU;GASTON;COM;793
Législatives 1997 - 1er tour;Législatives;1997;1;6;6ème circonscription;51;NEUILLY SUR SEINE;92051;35571;12347;23224;570;22654;CASSETTE DANIELE;F;CASSETTE;DANIELE;EXG;236
Législatives 1997 - 1er tour;Législatives;1997;1;6;6ème circonscription;51;NEUILLY SUR SEINE;92051;35571;12347;23224;570;22654;FLUMIAN OLIVIER;M;FLUMIAN;OLIVIER;DIV;0
Législatives 1997 - 1er tour;Législatives;1997;1;10;10ème circonscription;48;MEUDON;92048;4118;1375;2743;67;2676;JANVIER FREDERIC;M;JANVIER;FREDERIC;EXD;58
Législatives 1997 - 1er tour;Législatives;1997;1;7;7ème circonscription;64;SAINT CLOUD;92064;18908;7095;11813;417;11396;MAULION CHRISTIANE;F;MAULION;CHRISTIANE;SOC;2054
Législatives 1997 - 1er tour;Législatives;1997;1;7;7ème circonscription;63;RUEIL MALMAISON;92063;44715;14813;29902;1094;28808;LAGACHE YVES;M;LAGACHE;YVES;ECO;882
Législatives 1997 - 1er tour;Législatives;1997;1;6;6ème circonscription;62;PUTEAUX;92062;24329;8862;15467;635;14832;BUTON LUCIENNE;F;BUTON;LUCIENNE;SOC;3153
Législatives 1997 - 1er tour;Législatives;1997;1;6;6ème circonscription;62;PUTEAUX;92062;24329;8862;15467;635;14832;VIDAL GEORGES;M;VIDAL;GEORGES;EXG;115
Législatives 1997 - 1er tour;Législatives;1997;1;6;6ème circonscription;62;PUTEAUX;92062;24329;8862;15467;635;14832;BENARD JOEL;M;BENARD;JOEL;COM;883
Législatives 1997 - 1er tour;Législatives;1997;1;10;10ème circonscription;75;VANVES;92075;15446;4682;10764;329;10435;LE ROY THIERRY;M;LE ROY;THIERRY;DVG;567
Législatives 1997 - 1er tour;Législatives;1997;1;4;4ème circonscription;73;SURESNES;92073;20985;7217;13768;441;13327;CASSOU ANDRE;M;CASSOU;ANDRE;DVG;130
Législatives 1997 - 2ème tour;Législatives;1997;2;13;13ème circonscription;19;CHATENAY MALABRY;92019;17859;5865;11994;616;11378;DEVEDJIAN PATRICK;M;DEVEDJIAN;PATRICK;RPR;5696
Législatives 1997 - 2ème tour;Législatives;1997;2;9;9ème circonscription;12;BOULOGNE BILLANCOURT;92012;53287;17619;35668;1296;34372;GABORIT PIERRE;M;GABORIT;PIERRE;SOC;10908
Législatives 2002 - 1er tour;Législatives;2002;1;12;12ème circonscription;23;CLAMART;92023;32916;11487;21429;154;21275;LARCHER Robert;M;LARCHER;Robert;EXG;88
Législatives 2002 - 1er tour;Législatives;2002;1;5;5ème circonscription;24;CLICHY;92024;28799;12380;16419;297;16122;FOURNIER Alain;M;FOURNIER;Alain;VEC;781
Législatives 2002 - 1er tour;Législatives;2002;1;5;5ème circonscription;24;CLICHY;92024;28799;12380;16419;297;16122;COCHEPAIN Stéphane;M;COCHEPAIN;Stéphane;UDFD;1803
Législatives 2002 - 1er tour;Législatives;2002;1;1;1ère circonscription;25;COLOMBES;92025;26192;12273;13919;366;13553;RABIER Marie-Cécile;F;RABIER;Marie-Cécile;FN;497
Législatives 2002 - 1er tour;Législatives;2002;1;12;12ème circonscription;32;FONTENAY AUX ROSES;92032;15468;5605;9863;84;9779;KALTENBACH Philippe;M;KALTENBACH;Philippe;SOC;3254
Législatives 2002 - 1er tour;Législatives;2002;1;12;12ème circonscription;32;FONTENAY AUX ROSES;92032;15468;5605;9863;84;9779;BRILLON Freddy;M;BRILLON;Freddy;DVD;88
Législatives 2002 - 1er tour;Législatives;2002;1;7;7ème circonscription;33;GARCHES;92033;12286;4601;7685;112;7573;BRISON Christian;M;BRISON;Christian;EXG;9
Législatives 2002 - 1er tour;Législatives;2002;1;3;3ème circonscription;35;LA GARENNE COLOMBES;92035;16552;5947;10605;101;10504;RAGOT Jean-Louis;M;RAGOT;Jean-Louis;UDFD;1141
Législatives 2002 - 1er tour;Législatives;2002;1;5;5ème circonscription;44;LEVALLOIS PERRET;92044;39466;14724;24742;404;24338;GOUDAL Emilie;F;GOUDAL;Emilie;EXG;394
Législatives 2002 - 1er tour;Législatives;2002;1;5;5ème circonscription;44;LEVALLOIS PERRET;92044;39466;14724;24742;404;24338;COCHEPAIN Stéphane;M;COCHEPAIN;Stéphane;UDFD;2736
Législatives 2002 - 1er tour;Législatives;2002;1;8;8ème circonscription;48;MEUDON;92048;25427;9683;15744;202;15542;BLANCHARD Luc;M;BLANCHARD;Luc;VEC;635
Législatives 2002 - 1er tour;Législatives;2002;1;11;11ème circonscription;49;MONTROUGE;92049;26595;9698;16897;213;16684;BOUKHEDIMI Patrick;M;BOUKHEDIMI;Patrick;EXG;51
Législatives 2002 - 1er tour;Législatives;2002;1;11;11ème circonscription;49;MONTROUGE;92049;26595;9698;16897;213;16684;MORILLERE Denis;M;MORILLERE;Denis;DIV;0
Législatives 2017 - 1er tour;Législatives;2017;1;1;1ère circonscription;36;GENNEVILLIERS;92036;22174;13223;8951;243;8708;JAN Corinne;F;JAN;Corinne;EXG;32
Législatives 2017 - 1er tour;Législatives;2017;1;1;1ère circonscription;25;COLOMBES;92025;27867;16420;11447;405;11042;TOUMI Délia;F;TOUMI;Délia;ECO;276
Législatives 2017 - 1er tour;Législatives;2017;1;1;1ère circonscription;25;COLOMBES;92025;27867;16420;11447;405;11042;LE GAL Anna;F;LE GAL;Anna;ECO;88
Législatives 2017 - 1er tour;Législatives;2017;1;5;5ème circonscription;44;LEVALLOIS PERRET;92044;41751;17632;24119;255;23864;DAD Hicham;M;DAD;Hicham;COM;204
Législatives 2017 - 1er tour;Législatives;2017;1;4;4ème circonscription;50;NANTERRE;92050;47651;26455;21196;432;20764;LONC François;M;LONC;François;DIV;139
Législatives 2017 - 1er tour;Législatives;2017;1;5;5ème circonscription;44;LEVALLOIS PERRET;92044;41751;17632;24119;255;23864;LOEMBA Déborah;F;LOEMBA;Déborah;DIV;23
Législatives 2017 - 1er tour;Législatives;2017;1;6;6ème circonscription;26;COURBEVOIE;92026;8107;4228;3879;107;3772;FLORIN Samuel;M;FLORIN;Samuel;FI;364
Législatives 2017 - 1er tour;Législatives;2017;1;3;3ème circonscription;9;BOIS COLOMBES;92009;17921;7869;10052;437;9615;FRANCOIS-DAINVILLE Grégoire;M;FRANCOIS-DAINVILLE;Grégoire;DVD;366
Législatives 2017 - 1er tour;Législatives;2017;1;3;3ème circonscription;9;BOIS COLOMBES;92009;17921;7869;10052;437;9615;SPIRI Jean;M;SPIRI;Jean;LR;2059
Législatives 2017 - 1er tour;Législatives;2017;1;11;11ème circonscription;49;MONTROUGE;92049;28914;12071;16843;175;16668;GUYOMARD Sandra;F;GUYOMARD;Sandra;DIV;281
Législatives 2017 - 1er tour;Législatives;2017;1;12;12ème circonscription;23;CLAMART;92023;35342;15954;19388;238;19150;BAHLOUL Madeleine;F;BAHLOUL;Madeleine;FI;1892
Législatives 2017 - 1er tour;Législatives;2017;1;13;13ème circonscription;14;BOURG LA REINE;92014;13736;5356;8380;81;8299;FARCY-BRIANT Laurent;M;FARCY-BRIANT;Laurent;DIV;19
Législatives 2017 - 1er tour;Législatives;2017;1;13;13ème circonscription;19;CHATENAY MALABRY;92019;18752;8166;10586;245;10341;PINÇON-CHARLOT Monique;F;PINÇON-CHARLOT;Monique;DVG;356
Législatives 2017 - 1er tour;Législatives;2017;1;1;1ère circonscription;78;VILLENEUVE LA GARENNE;92078;12445;8430;4015;143;3872;LE GAL Anna;F;LE GAL;Anna;ECO;49
Législatives 2017 - 1er tour;Législatives;2017;1;2;2ème circonscription;4;ASNIERES SUR SEINE;92004;48340;22557;25783;414;25369;DERRIEN Amand;M;DERRIEN;Amand;DIV;286
Législatives 2017 - 1er tour;Législatives;2017;1;9;9ème circonscription;12;BOULOGNE BILLANCOURT;92012;64984;30321;34663;987;33676;SOLÈRE Thierry;M;SOLÈRE;Thierry;LR;14346
Législatives 2017 - 1er tour;Législatives;2017;1;8;8ème circonscription;76;VAUCRESSON;92076;6187;2474;3713;42;3671;THOMAS Marc;M;THOMAS;Marc;FN;136
Législatives 2017 - 1er tour;Législatives;2017;1;8;8ème circonscription;47;MARNES LA COQUETTE;92047;1215;451;764;4;760;HÉNIQUE Philippe;M;HÉNIQUE;Philippe;EXG;1
Législatives 2017 - 1er tour;Législatives;2017;1;8;8ème circonscription;72;SEVRES;92072;15144;6343;8801;149;8652;MACHILLOT Alexandre;M;MACHILLOT;Alexandre;DIV;51
Législatives 2017 - 1er tour;Législatives;2017;1;8;8ème circonscription;22;CHAVILLE;92022;13523;5385;8138;93;8045;THOMAS Marc;M;THOMAS;Marc;FN;426
Législatives 2017 - 1er tour;Législatives;2017;1;6;6ème circonscription;62;PUTEAUX;92062;28983;11794;17189;436;16753;LE GRIP Constance;F;LE GRIP;Constance;LR;3468
Législatives 2017 - 1er tour;Législatives;2017;1;10;10ème circonscription;12;BOULOGNE BILLANCOURT;92012;9082;4562;4520;114;4406;MALEYRE Anne-Laure;F;MALEYRE;Anne-Laure;FN;175
Législatives 2017 - 1er tour;Législatives;2017;1;10;10ème circonscription;40;ISSY LES MOULINEAUX;92040;45375;19009;26366;517;25849;DAHAN Gérald;M;DAHAN;Gérald;FI;1940
Présidentielles 1995 - 1er tour;Présidentielles;1995;1;;;2;ANTONY;92002;37894;9274;28620;590;28030;CHIRAC JACQUES;M;CHIRAC;JACQUES;;7040
Présidentielles 2002 - 1er tour;Présidentielles;2002;1;;;4;ASNIERES SUR SEINE;92004;35702;11271;24431;515;23916;TAUBIRA CHRISTIANE;F;TAUBIRA;CHRISTIANE;;912
Présidentielles 2002 - 1er tour;Présidentielles;2002;1;;;4;ASNIERES SUR SEINE;92004;35702;11271;24431;515;23916;LAGUILLER ARLETTE;F;LAGUILLER;ARLETTE;;973
Présidentielles 2002 - 1er tour;Présidentielles;2002;1;;;7;BAGNEUX;92007;18489;5873;12616;519;12097;LE PEN JEAN-MARIE;M;LE PEN;JEAN-MARIE;;1596
Présidentielles 2002 - 1er tour;Présidentielles;2002;1;;;9;BOIS COLOMBES;92009;13996;4554;9442;200;9242;JOSPIN LIONEL;M;JOSPIN;LIONEL;;1494
Présidentielles 2002 - 1er tour;Présidentielles;2002;1;;;12;BOULOGNE BILLANCOURT;92012;57382;17570;39812;645;39167;LAGUILLER ARLETTE;F;LAGUILLER;ARLETTE;;1027
Présidentielles 2002 - 1er tour;Présidentielles;2002;1;;;40;ISSY LES MOULINEAUX;92040;32059;9424;22635;510;22125;LE PEN JEAN-MARIE;M;LE PEN;JEAN-MARIE;;2251
Présidentielles 2002 - 1er tour;Présidentielles;2002;1;;;49;MONTROUGE;92049;23382;8142;15240;301;14939;JOSPIN LIONEL;M;JOSPIN;LIONEL;;2937
Présidentielles 2002 - 1er tour;Présidentielles;2002;1;;;51;NEUILLY SUR SEINE;92051;34066;10108;23958;309;23649;BAYROU FRANCOIS;M;BAYROU;FRANCOIS;;2327
Présidentielles 2002 - 1er tour;Présidentielles;2002;1;;;51;NEUILLY SUR SEINE;92051;34066;10108;23958;309;23649;BOUTIN CHRISTINE;F;BOUTIN;CHRISTINE;;567
Présidentielles 2002 - 1er tour;Présidentielles;2002;1;;;60;LE PLESSIS ROBINSON;92060;14503;4736;9767;230;9537;BESANCENOT OLIVIER;M;BESANCENOT;OLIVIER;;313
Présidentielles 2002 - 1er tour;Présidentielles;2002;1;;;72;SEVRES;92072;13367;4140;9227;153;9074;SAINT-JOSSE JEAN;M;SAINT-JOSSE;JEAN;;68
Présidentielles 2002 - 1er tour;Présidentielles;2002;1;;;77;VILLE D'AVRAY;92077;7251;2486;4765;70;4695;MADELIN ALAIN;M;MADELIN;ALAIN;;376
Présidentielles 2002 - 1er tour;Présidentielles;2002;1;;;78;VILLENEUVE LA GARENNE;92078;11406;4746;6660;180;6480;SAINT-JOSSE JEAN;M;SAINT-JOSSE;JEAN;;49
Présidentielles 2002 - 1er tour;Présidentielles;2002;1;;;78;VILLENEUVE LA GARENNE;92078;11406;4746;6660;180;6480;LAGUILLER ARLETTE;F;LAGUILLER;ARLETTE;;368
Présidentielles 2007 - 1er tour;Présidentielles;2007;1;;;2;ANTONY;92002;39316;4695;34621;413;34208;LAGUILLER Arlette;F;LAGUILLER;Arlette;;230
Présidentielles 2007 - 1er tour;Présidentielles;2007;1;;;14;BOURG LA REINE;92014;13108;1436;11672;90;11582;SCHIVARDI Gérard;M;SCHIVARDI;Gérard;;23
Présidentielles 2007 - 1er tour;Présidentielles;2007;1;;;19;CHATENAY MALABRY;92019;17598;2318;15280;229;15051;de VILLIERS Philippe;M;de VILLIERS;Philippe;;173
Présidentielles 2007 - 1er tour;Présidentielles;2007;1;;;20;CHATILLON;92020;20466;2231;18235;177;18058;SCHIVARDI Gérard;M;SCHIVARDI;Gérard;;39
Présidentielles 2007 - 1er tour;Présidentielles;2007;1;;;20;CHATILLON;92020;20466;2231;18235;177;18058;SARKOZY Nicolas;M;SARKOZY;Nicolas;;5913
Présidentielles 2007 - 1er tour;Présidentielles;2007;1;;;24;CLICHY;92024;28539;4472;24067;245;23822;ROYAL Ségolène;F;ROYAL;Ségolène;;8983
Présidentielles 2007 - 1er tour;Présidentielles;2007;1;;;24;CLICHY;92024;28539;4472;24067;245;23822;NIHOUS Frédéric;M;NIHOUS;Frédéric;;52
Présidentielles 2007 - 1er tour;Présidentielles;2007;1;;;26;COURBEVOIE;92026;48308;7118;41190;456;40734;ROYAL Ségolène;F;ROYAL;Ségolène;;9340
Présidentielles 2007 - 1er tour;Présidentielles;2007;1;;;26;COURBEVOIE;92026;48308;7118;41190;456;40734;NIHOUS Frédéric;M;NIHOUS;Frédéric;;78
Présidentielles 2007 - 1er tour;Présidentielles;2007;1;;;36;GENNEVILLIERS;92036;19890;3536;16354;259;16095;LE PEN Jean-Marie;M;LE PEN;Jean-Marie;;1217
Présidentielles 2007 - 1er tour;Présidentielles;2007;1;;;47;MARNES LA COQUETTE;92047;1054;91;963;9;954;BAYROU François;M;BAYROU;François;;161
Présidentielles 2007 - 1er tour;Présidentielles;2007;1;;;60;LE PLESSIS ROBINSON;92060;16571;1989;14582;159;14423;NIHOUS Frédéric;M;NIHOUS;Frédéric;;45
Présidentielles 2007 - 1er tour;Présidentielles;2007;1;;;63;RUEIL MALMAISON;92063;50540;5920;44620;393;44227;NIHOUS Frédéric;M;NIHOUS;Frédéric;;129
Présidentielles 2007 - 1er tour;Présidentielles;2007;1;;;63;RUEIL MALMAISON;92063;50540;5920;44620;393;44227;LE PEN Jean-Marie;M;LE PEN;Jean-Marie;;2358
Présidentielles 2007 - 1er tour;Présidentielles;2007;1;;;72;SEVRES;92072;14178;1738;12440;129;12311;de VILLIERS Philippe;M;de VILLIERS;Philippe;;147
Présidentielles 2007 - 1er tour;Présidentielles;2007;1;;;72;SEVRES;92072;14178;1738;12440;129;12311;ROYAL Ségolène;F;ROYAL;Ségolène;;3212
Présidentielles 1995 - 1er tour;Présidentielles;1995;1;;;14;BOURG LA REINE;92014;12770;3430;9340;135;9205;JOSPIN LIONEL;M;JOSPIN;LIONEL;;2243
Présidentielles 1995 - 1er tour;Présidentielles;1995;1;;;22;CHAVILLE;92022;12177;2870;9307;170;9137;JOSPIN LIONEL;M;JOSPIN;LIONEL;;2297
Présidentielles 1995 - 1er tour;Présidentielles;1995;1;;;24;CLICHY;92024;24688;6820;17868;364;17504;JOSPIN LIONEL;M;JOSPIN;LIONEL;;5067
Présidentielles 1995 - 1er tour;Présidentielles;1995;1;;;26;COURBEVOIE;92026;35812;8064;27748;468;27280;CHEMINADE JACQUES;M;CHEMINADE;JACQUES;;58
Présidentielles 1995 - 1er tour;Présidentielles;1995;1;;;26;COURBEVOIE;92026;35812;8064;27748;468;27280;BALLADUR EDOUARD;M;BALLADUR;EDOUARD;;6007
Présidentielles 1995 - 1er tour;Présidentielles;1995;1;;;44;LEVALLOIS PERRET;92044;29477;6881;22596;402;22194;LE PEN J.MARIE;M;LE PEN;J.MARIE;;2391
Présidentielles 1995 - 1er tour;Présidentielles;1995;1;;;46;MALAKOFF;92046;19489;5677;13812;258;13554;HUE ROBERT;M;HUE;ROBERT;;3248
Présidentielles 1995 - 1er tour;Présidentielles;1995;1;;;47;MARNES LA COQUETTE;92047;1003;227;776;11;765;LAGUILLER ARLETTE;F;LAGUILLER;ARLETTE;;22
Présidentielles 1995 - 1er tour;Présidentielles;1995;1;;;48;MEUDON;92048;29714;7851;21863;352;21511;VOYNET DOMINIQUE;F;VOYNET;DOMINIQUE;;750
Présidentielles 1995 - 1er tour;Présidentielles;1995;1;;;51;NEUILLY SUR SEINE;92051;35904;7798;28106;261;27845;CHEMINADE JACQUES;M;CHEMINADE;JACQUES;;32
Présidentielles 1995 - 1er tour;Présidentielles;1995;1;;;62;PUTEAUX;92062;24192;6165;18027;379;17648;HUE ROBERT;M;HUE;ROBERT;;958
Présidentielles 1995 - 1er tour;Présidentielles;1995;1;;;71;SCEAUX;92071;13371;3073;10298;170;10128;LE PEN J.MARIE;M;LE PEN;J.MARIE;;755
Présidentielles 1995 - 1er tour;Présidentielles;1995;1;;;75;VANVES;92075;15499;3343;12156;236;11920;LE PEN J.MARIE;M;LE PEN;J.MARIE;;1131
Présidentielles 1995 - 1er tour;Présidentielles;1995;1;;;77;VILLE D'AVRAY;92077;7139;1490;5649;74;5575;LE PEN J.MARIE;M;LE PEN;J.MARIE;;368
Présidentielles 1995 - 1er tour;Présidentielles;1995;1;;;77;VILLE D'AVRAY;92077;7139;1490;5649;74;5575;JOSPIN LIONEL;M;JOSPIN;LIONEL;;1019
Présidentielles 2002 - 2ème tour;Présidentielles;2002;2;;;32;FONTENAY AUX ROSES;92032;14148;2388;11760;372;11388;CHIRAC JACQUES;M;CHIRAC;JACQUES;;10143
Présidentielles 2002 - 2ème tour;Présidentielles;2002;2;;;33;GARCHES;92033;11709;2139;9570;234;9336;CHIRAC JACQUES;M;CHIRAC;JACQUES;;8166
Présidentielles 2002 - 2ème tour;Présidentielles;2002;2;;;51;NEUILLY SUR SEINE;92051;34164;5372;28792;508;28284;LE PEN JEAN-MARIE;M;LE PEN;JEAN-MARIE;;3233
Présidentielles 2002 - 2ème tour;Présidentielles;2002;2;;;62;PUTEAUX;92062;23868;4202;19666;726;18940;CHIRAC JACQUES;M;CHIRAC;JACQUES;;16306
Présidentielles 1995 - 2ème tour;Présidentielles;1995;2;;;2;ANTONY;92002;37894;7164;30730;1437;29293;CHIRAC JACQUES;M;CHIRAC;JACQUES;;16214
Présidentielles 1995 - 2ème tour;Présidentielles;1995;2;;;24;CLICHY;92024;24688;6360;18328;900;17428;CHIRAC JACQUES;M;CHIRAC;JACQUES;;8666
Présidentielles 1995 - 2ème tour;Présidentielles;1995;2;;;48;MEUDON;92048;29713;6526;23187;844;22343;JOSPIN LIONEL;M;JOSPIN;LIONEL;;9489
Présidentielles 1995 - 2ème tour;Présidentielles;1995;2;;;78;VILLENEUVE LA GARENNE;92078;11588;3148;8440;534;7906;CHIRAC JACQUES;M;CHIRAC;JACQUES;;4037
Présidentielles 1995 - 2ème tour;Présidentielles;1995;2;;;78;VILLENEUVE LA GARENNE;92078;11588;3148;8440;534;7906;JOSPIN LIONEL;M;JOSPIN;LIONEL;;3869
Présidentielles 1995 - 1er tour;Présidentielles;1995;1;;;4;ASNIERES SUR SEINE;92004;39050;10288;28762;594;28168;LE PEN J.MARIE;M;LE PEN;J.MARIE;;4338
Législatives 2007 - 1er tour;Législatives;2007;1;1;1ère circonscription;78;VILLENEUVE LA GARENNE;92078;13038;7211;5827;131;5696;KADUR Alexandre;M;KADUR;Alexandre;DVD;36
Législatives 2007 - 2ème tour;Législatives;2007;2;5;5ème circonscription;24;CLICHY;92024;28799;13470;15329;1007;14322;CATOIRE Gilles;M;CATOIRE;Gilles;SOC;8712
Législatives 2007 - 2ème tour;Législatives;2007;2;4;4ème circonscription;50;NANTERRE;92050;42631;19355;23276;593;22683;FRAYSSE Jacqueline;F;FRAYSSE;Jacqueline;COM;14580
Présidentielles 2017 - 1er tour;Présidentielles;2017;1;;;9;BOIS COLOMBES;92009;17896;3242;14654;318;14336;HAMON Benoît;M;HAMON;Benoît;;1152
Présidentielles 2017 - 1er tour;Présidentielles;2017;1;;;9;BOIS COLOMBES;92009;17896;3242;14654;318;14336;MACRON Emmanuel;M;MACRON;Emmanuel;;5064
Présidentielles 2017 - 1er tour;Présidentielles;2017;1;;;12;BOULOGNE BILLANCOURT;92012;77303;15227;62076;919;61157;MACRON Emmanuel;M;MACRON;Emmanuel;;20143
Présidentielles 2017 - 1er tour;Présidentielles;2017;1;;;12;BOULOGNE BILLANCOURT;92012;77303;15227;62076;919;61157;POUTOU Philippe;M;POUTOU;Philippe;;226
Présidentielles 2017 - 1er tour;Présidentielles;2017;1;;;19;CHATENAY MALABRY;92019;18708;3336;15372;454;14918;CHEMINADE Jacques;M;CHEMINADE;Jacques;;37
Présidentielles 2017 - 1er tour;Présidentielles;2017;1;;;19;CHATENAY MALABRY;92019;18708;3336;15372;454;14918;POUTOU Philippe;M;POUTOU;Philippe;;100
Présidentielles 2017 - 1er tour;Présidentielles;2017;1;;;24;CLICHY;92024;28553;5564;22989;498;22491;ASSELINEAU François;M;ASSELINEAU;François;;407
Présidentielles 2017 - 1er tour;Présidentielles;2017;1;;;25;COLOMBES;92025;47454;9714;37740;907;36833;FILLON François;M;FILLON;François;;7540
Présidentielles 2017 - 1er tour;Présidentielles;2017;1;;;26;COURBEVOIE;92026;52391;9609;42782;817;41965;HAMON Benoît;M;HAMON;Benoît;;2692
Présidentielles 2017 - 1er tour;Présidentielles;2017;1;;;26;COURBEVOIE;92026;52391;9609;42782;817;41965;MÉLENCHON Jean-Luc;M;MÉLENCHON;Jean-Luc;;6129
Présidentielles 2017 - 1er tour;Présidentielles;2017;1;;;46;MALAKOFF;92046;18434;3186;15248;268;14979;FILLON François;M;FILLON;François;;1716
Présidentielles 2017 - 1er tour;Présidentielles;2017;1;;;60;LE PLESSIS ROBINSON;92060;19141;2947;16194;344;15850;DUPONT-AIGNAN Nicolas;M;DUPONT-AIGNAN;Nicolas;;781
Présidentielles 2017 - 1er tour;Présidentielles;2017;1;;;62;PUTEAUX;92062;28950;4530;24420;549;23871;ASSELINEAU François;M;ASSELINEAU;François;;286
Présidentielles 2017 - 1er tour;Présidentielles;2017;1;;;63;RUEIL MALMAISON;92063;54426;9298;45128;713;44414;LASSALLE Jean;M;LASSALLE;Jean;;301
Présidentielles 2017 - 1er tour;Présidentielles;2017;1;;;71;SCEAUX;92071;15052;2914;12138;145;11993;DUPONT-AIGNAN Nicolas;M;DUPONT-AIGNAN;Nicolas;;286
Présidentielles 2017 - 1er tour;Présidentielles;2017;1;;;72;SEVRES;92072;15142;2166;12976;213;12763;DUPONT-AIGNAN Nicolas;M;DUPONT-AIGNAN;Nicolas;;310
Présidentielles 2017 - 1er tour;Présidentielles;2017;1;;;73;SURESNES;92073;28497;4342;24155;520;23635;CHEMINADE Jacques;M;CHEMINADE;Jacques;;43
Présidentielles 2017 - 1er tour;Présidentielles;2017;1;;;75;VANVES;92075;18500;3228;15272;248;15024;ARTHAUD Nathalie;F;ARTHAUD;Nathalie;;43
Présidentielles 2017 - 1er tour;Présidentielles;2017;1;;;78;VILLENEUVE LA GARENNE;92078;12429;3872;8557;315;8242;LE PEN Marine;F;LE PEN;Marine;;1054
Présidentielles 2012 - 1er tour;Présidentielles;2012;1;;;4;ASNIERES SUR SEINE;92004;45042;9279;35763;516;35247;LE PEN Marine;F;LE PEN;Marine;;2884
Présidentielles 2012 - 1er tour;Présidentielles;2012;1;;;7;BAGNEUX;92007;20608;4687;15921;281;15640;JOLY Eva;F;JOLY;Eva;;382
Présidentielles 2012 - 1er tour;Présidentielles;2012;1;;;26;COURBEVOIE;92026;50576;11277;39299;681;38618;ARTHAUD Nathalie;F;ARTHAUD;Nathalie;;90
Présidentielles 2012 - 1er tour;Présidentielles;2012;1;;;32;FONTENAY AUX ROSES;92032;15217;3289;11928;161;11767;SARKOZY Nicolas;M;SARKOZY;Nicolas;;3000
Présidentielles 2012 - 1er tour;Présidentielles;2012;1;;;46;MALAKOFF;92046;18852;4162;14690;207;14483;SARKOZY Nicolas;M;SARKOZY;Nicolas;;2367
Présidentielles 2012 - 1er tour;Présidentielles;2012;1;;;51;NEUILLY SUR SEINE;92051;37003;5964;31039;257;30782;JOLY Eva;F;JOLY;Eva;;409
Présidentielles 2012 - 1er tour;Présidentielles;2012;1;;;51;NEUILLY SUR SEINE;92051;37003;5964;31039;257;30782;MÉLENCHON Jean-Luc;M;MÉLENCHON;Jean-Luc;;649
Présidentielles 2012 - 1er tour;Présidentielles;2012;1;;;51;NEUILLY SUR SEINE;92051;37003;5964;31039;257;30782;CHEMINADE Jacques;M;CHEMINADE;Jacques;;57
Présidentielles 2012 - 1er tour;Présidentielles;2012;1;;;60;LE PLESSIS ROBINSON;92060;18767;3621;15146;260;14886;SARKOZY Nicolas;M;SARKOZY;Nicolas;;4893
Présidentielles 2012 - 1er tour;Présidentielles;2012;1;;;63;RUEIL MALMAISON;92063;52385;10540;41845;580;41265;MÉLENCHON Jean-Luc;M;MÉLENCHON;Jean-Luc;;3217
Présidentielles 2012 - 1er tour;Présidentielles;2012;1;;;71;SCEAUX;92071;14355;2941;11414;118;11296;MÉLENCHON Jean-Luc;M;MÉLENCHON;Jean-Luc;;929
Présidentielles 2012 - 1er tour;Présidentielles;2012;1;;;71;SCEAUX;92071;14355;2941;11414;118;11296;HOLLANDE François;M;HOLLANDE;François;;3339
Présidentielles 2012 - 1er tour;Présidentielles;2012;1;;;75;VANVES;92075;17512;3079;14433;161;14272;HOLLANDE François;M;HOLLANDE;François;;4997
Présidentielles 2017 - 2ème tour;Présidentielles;2017;2;;;63;RUEIL MALMAISON;92063;54428;12066;42362;3578;38784;LE PEN Marine;F;LE PEN;Marine;;5631
Présidentielles 2017 - 2ème tour;Présidentielles;2017;2;;;75;VANVES;92075;18500;4079;14421;1175;13246;MACRON Emmanuel;M;MACRON;Emmanuel;;11614
Présidentielles 2017 - 2ème tour;Présidentielles;2017;2;;;78;VILLENEUVE LA GARENNE;92078;12429;4419;8010;786;7224;MACRON Emmanuel;M;MACRON;Emmanuel;;5798
Présidentielles 2012 - 2ème tour;Présidentielles;2012;2;;;71;SCEAUX;92071;14378;2262;12116;403;11713;HOLLANDE François;M;HOLLANDE;François;;5572
Présidentielles 2007 - 2ème tour;Présidentielles;2007;2;;;2;ANTONY;92002;39361;5129;34232;1507;32725;SARKOZY Nicolas;M;SARKOZY;Nicolas;;17242
Présidentielles 2007 - 2ème tour;Présidentielles;2007;2;;;14;BOURG LA REINE;92014;13120;1590;11530;424;11106;SARKOZY Nicolas;M;SARKOZY;Nicolas;;6050
Présidentielles 2007 - 2ème tour;Présidentielles;2007;2;;;24;CLICHY;92024;28548;4867;23681;799;22882;SARKOZY Nicolas;M;SARKOZY;Nicolas;;9273
Présidentielles 2007 - 2ème tour;Présidentielles;2007;2;;;48;MEUDON;92048;29950;4524;25426;928;24498;SARKOZY Nicolas;M;SARKOZY;Nicolas;;13426
Présidentielles 2007 - 2ème tour;Présidentielles;2007;2;;;78;VILLENEUVE LA GARENNE;92078;12908;2961;9947;309;9638;SARKOZY Nicolas;M;SARKOZY;Nicolas;;4149
Législatives 2007 - 1er tour;Législatives;2007;1;12;12ème circonscription;60;LE PLESSIS ROBINSON;92060;16776;5588;11188;123;11065;SCHMITT Jean-Pierre;M;SCHMITT;Jean-Pierre;FN;223
Législatives 2007 - 1er tour;Législatives;2007;1;12;12ème circonscription;60;LE PLESSIS ROBINSON;92060;16776;5588;11188;123;11065;PEMEZEC Philippe;M;PEMEZEC;Philippe;UMP;6531
Législatives 2007 - 1er tour;Législatives;2007;1;12;12ème circonscription;60;LE PLESSIS ROBINSON;92060;16776;5588;11188;123;11065;LARCHER Robert;M;LARCHER;Robert;EXG;64
Législatives 2007 - 1er tour;Législatives;2007;1;11;11ème circonscription;49;MONTROUGE;92049;26595;9698;16897;213;16684;BOUKHEDIMI Patrick;M;BOUKHEDIMI;Patrick;EXG;51
Législatives 2007 - 1er tour;Législatives;2007;1;3;3ème circonscription;35;LA GARENNE COLOMBES;92035;16552;5947;10605;101;10504;RAGOT Jean-Louis;M;RAGOT;Jean-Louis;UDFD;1141
Législatives 2007 - 1er tour;Législatives;2007;1;1;1ère circonscription;36;GENNEVILLIERS;92036;20048;9522;10526;189;10337;BINDER Sylvain;M;BINDER;Sylvain;DIV;40
Législatives 2007 - 1er tour;Législatives;2007;1;1;1ère circonscription;36;GENNEVILLIERS;92036;20048;9522;10526;189;10337;BRETON Michel;M;BRETON;Michel;EXG;92
Législatives 2007 - 1er tour;Législatives;2007;1;12;12ème circonscription;32;FONTENAY AUX ROSES;92032;15468;5605;9863;84;9779;DELMATTO Geneviève;F;DELMATTO;Geneviève;EXD;47
Législatives 2007 - 1er tour;Législatives;2007;1;2;2ème circonscription;25;COLOMBES;92025;18336;7144;11192;207;10985;SALLES Laurent;M;SALLES;Laurent;FN;340
Législatives 2007 - 1er tour;Législatives;2007;1;7;7ème circonscription;33;GARCHES;92033;12286;4601;7685;112;7573;PIJOAN David;M;PIJOAN;David;EXG;68
Législatives 2007 - 1er tour;Législatives;2007;1;3;3ème circonscription;9;BOIS COLOMBES;92009;16245;6561;9684;288;9396;DORE Patricia;F;DORE;Patricia;ECO;139
Législatives 2007 - 1er tour;Législatives;2007;1;3;3ème circonscription;9;BOIS COLOMBES;92009;16245;6561;9684;288;9396;HERBIN Annick;F;HERBIN;Annick;COM;182
Législatives 2007 - 1er tour;Législatives;2007;1;13;13ème circonscription;19;CHATENAY MALABRY;92019;17835;6584;11251;211;11040;FONTAN Huguette;F;FONTAN;Huguette;DIV;14
Législatives 2007 - 1er tour;Législatives;2007;1;13;13ème circonscription;19;CHATENAY MALABRY;92019;17835;6584;11251;211;11040;BENLOLO Martine;F;BENLOLO;Martine;EXG;47
Législatives 2007 - 1er tour;Législatives;2007;1;13;13ème circonscription;14;BOURG LA REINE;92014;13381;4391;8990;78;8912;IORIO Catherine;F;IORIO;Catherine;FN;263
Législatives 2007 - 1er tour;Législatives;2007;1;12;12ème circonscription;20;CHATILLON;92020;20661;7083;13578;137;13441;PEMEZEC Philippe;M;PEMEZEC;Philippe;UMP;6111
Législatives 2007 - 1er tour;Législatives;2007;1;8;8ème circonscription;22;CHAVILLE;92022;12928;4682;8246;120;8126;LEHIDEUX Bernard;M;LEHIDEUX;Bernard;UDFD;1167
Législatives 2007 - 1er tour;Législatives;2007;1;1;1ère circonscription;25;COLOMBES;92025;26192;12273;13919;366;13553;JEAN Yves;M;JEAN;Yves;DVD;26
Législatives 2007 - 1er tour;Législatives;2007;1;8;8ème circonscription;76;VAUCRESSON;92076;6076;2206;3870;46;3824;BOUCHARD Renaud;M;BOUCHARD;Renaud;DIV;1
Législatives 2007 - 1er tour;Législatives;2007;1;4;4ème circonscription;73;SURESNES;92073;24666;8949;15717;206;15511;GOIN Catherine;F;GOIN;Catherine;EXG;34
Législatives 1993 - 1er tour;Législatives;1993;1;9;9ème circonscription;12;BOULOGNE BILLANCOURT;92012;53509;17387;36122;1224;34898;LAFFERRIERE JEAN;M;LAFFERRIERE;JEAN;EXG;191
Législatives 1993 - 1er tour;Législatives;1993;1;3;3ème circonscription;35;LA GARENNE COLOMBES;92035;13664;4290;9374;347;9027;HABY J.YVES;M;HABY;J.YVES;UDF;4049
Législatives 1993 - 1er tour;Législatives;1993;1;7;7ème circonscription;33;GARCHES;92033;11440;3330;8110;328;7782;WAGNER JACQUES;M;WAGNER;JACQUES;DVD;29
Législatives 1993 - 1er tour;Législatives;1993;1;3;3ème circonscription;26;COURBEVOIE;92026;34737;9916;24821;828;23993;HABY J.YVES;M;HABY;J.YVES;UDF;11976
Législatives 1993 - 1er tour;Législatives;1993;1;8;8ème circonscription;77;VILLE D'AVRAY;92077;7199;1786;5413;149;5264;LAURENT AMSALLEM EDDY;M;LAURENT AMSALLEM;EDDY;DIV;23
Législatives 1993 - 1er tour;Législatives;1993;1;8;8ème circonscription;77;VILLE D'AVRAY;92077;7199;1786;5413;149;5264;MARGUERITES HARRY;M;MARGUERITES;HARRY;MAJ;29
Législatives 1993 - 1er tour;Législatives;1993;1;9;9ème circonscription;12;BOULOGNE BILLANCOURT;92012;53509;17387;36122;1224;34898;PUCHEU PASCAL;M;PUCHEU;PASCAL;DVD;373
Législatives 1993 - 1er tour;Législatives;1993;1;12;12ème circonscription;23;CLAMART;92023;30899;9896;21003;704;20299;LEGOEUIL ANNETTE;F;LEGOEUIL;ANNETTE;SOC;168
Législatives 1993 - 1er tour;Législatives;1993;1;8;8ème circonscription;22;CHAVILLE;92022;12345;3904;8441;296;8145;KONOPNICKI GUY;M;KONOPNICKI;GUY;GEC;734
Législatives 1993 - 1er tour;Législatives;1993;1;1;1ère circonscription;78;VILLENEUVE LA GARENNE;92078;11604;4168;7436;212;7224;MUSSAT PHILIPPE;M;MUSSAT;PHILIPPE;EXG;24
Législatives 1993 - 1er tour;Législatives;1993;1;11;11ème circonscription;49;MONTROUGE;92049;22632;7554;15078;554;14524;BASSINET PHILIPPE;M;BASSINET;PHILIPPE;SOC;3244
Législatives 1993 - 1er tour;Législatives;1993;1;11;11ème circonscription;49;MONTROUGE;92049;22632;7554;15078;554;14524;BONELLI PIERRE;M;BONELLI;PIERRE;MAJ;312
Législatives 1993 - 1er tour;Législatives;1993;1;10;10ème circonscription;48;MEUDON;92048;4225;1396;2829;92;2737;KERMIN J.CHARLES;M;KERMIN;J.CHARLES;EXG;20
Législatives 1993 - 1er tour;Législatives;1993;1;8;8ème circonscription;76;VAUCRESSON;92076;5515;1574;3941;93;3848;KONOPNICKI GUY;M;KONOPNICKI;GUY;GEC;332
Législatives 1993 - 1er tour;Législatives;1993;1;4;4ème circonscription;73;SURESNES;92073;21292;6457;14835;522;14313;SCHWARTZ ANNE;F;SCHWARTZ;ANNE;EXG;160
Législatives 1993 - 1er tour;Législatives;1993;1;8;8ème circonscription;76;VAUCRESSON;92076;5515;1574;3941;93;3848;WOLF HENRY;M;WOLF;HENRY;UDF;840
Législatives 1993 - 1er tour;Législatives;1993;1;13;13ème circonscription;71;SCEAUX;92071;13127;3574;9553;306;9247;AUBRY ANDRE;M;AUBRY;ANDRE;COM;383
Législatives 1993 - 1er tour;Législatives;1993;1;9;9ème circonscription;12;BOULOGNE BILLANCOURT;92012;53509;17387;36122;1224;34898;RICARD BRUNO;M;RICARD;BRUNO;DIV;502
Législatives 1993 - 1er tour;Législatives;1993;1;12;12ème circonscription;20;CHATILLON;92020;15705;4455;11250;435;10815;MOURIER J.PIERRE;M;MOURIER;J.PIERRE;DIV;190
Législatives 1993 - 1er tour;Législatives;1993;1;11;11ème circonscription;7;BAGNEUX;92007;21150;7754;13396;474;12922;NGUYEN M.FRANCE;F;NGUYEN;M.FRANCE;DIV;344
Législatives 1993 - 1er tour;Législatives;1993;1;12;12ème circonscription;60;LE PLESSIS ROBINSON;92060;13118;4266;8852;315;8537;COUTAT RICHARD;M;COUTAT;RICHARD;EXG;83
Législatives 1993 - 1er tour;Législatives;1993;1;11;11ème circonscription;49;MONTROUGE;92049;22632;7554;15078;554;14524;AYOUB SERGE;M;AYOUB;SERGE;EXD;31
Législatives 1993 - 1er tour;Législatives;1993;1;3;3ème circonscription;35;LA GARENNE COLOMBES;92035;13664;4290;9374;347;9027;PEREZ CHRISTIAN;M;PEREZ;CHRISTIAN;FRN;1315
Législatives 1993 - 1er tour;Législatives;1993;1;5;5ème circonscription;44;LEVALLOIS PERRET;92044;27392;7486;19906;624;19282;WILLIG PATRICK;M;WILLIG;PATRICK;DIV;257
Législatives 1993 - 1er tour;Législatives;1993;1;8;8ème circonscription;48;MEUDON;92048;25126;7628;17498;529;16969;LAURENT AMSALLEM EDDY;M;LAURENT AMSALLEM;EDDY;DIV;150
Législatives 2012 - 1er tour;Législatives;2012;1;11;11ème circonscription;7;BAGNEUX;92007;20609;9648;10961;145;10816;LEGENDRE Cédric;M;LEGENDRE;Cédric;DVD;46
Législatives 2012 - 1er tour;Législatives;2012;1;3;3ème circonscription;9;BOIS COLOMBES;92009;16783;6763;10020;331;9689;PARRY Jean-Marie;M;PARRY;Jean-Marie;EXG;22
Législatives 2012 - 1er tour;Législatives;2012;1;3;3ème circonscription;9;BOIS COLOMBES;92009;16783;6763;10020;331;9689;LAUPIES Pierre-Louis;M;LAUPIES;Pierre-Louis;DVD;43
Législatives 2012 - 1er tour;Législatives;2012;1;9;9ème circonscription;12;BOULOGNE BILLANCOURT;92012;61020;24579;36441;340;36101;GUEANT Claude;M;GUEANT;Claude;UMP;10978
Législatives 2012 - 1er tour;Législatives;2012;1;12;12ème circonscription;20;CHATILLON;92020;21681;8265;13416;122;13294;DELOM Christian;M;DELOM;Christian;CEN;413
Législatives 2012 - 1er tour;Législatives;2012;1;12;12ème circonscription;23;CLAMART;92023;34173;13440;20733;193;20540;LARCHER Robert;M;LARCHER;Robert;EXG;67
Législatives 2012 - 1er tour;Législatives;2012;1;12;12ème circonscription;23;CLAMART;92023;34173;13440;20733;193;20540;DELOM Christian;M;DELOM;Christian;CEN;940
Législatives 2012 - 1er tour;Législatives;2012;1;1;1ère circonscription;25;COLOMBES;92025;26337;13144;13193;209;12984;BUTAYE Denis;M;BUTAYE;Denis;DVD;818
Législatives 2012 - 1er tour;Législatives;2012;1;3;3ème circonscription;26;COURBEVOIE;92026;42456;16939;25517;317;25200;LAUPIES Pierre-Louis;M;LAUPIES;Pierre-Louis;DVD;73
Législatives 2012 - 1er tour;Législatives;2012;1;6;6ème circonscription;26;COURBEVOIE;92026;8123;3742;4381;140;4241;NEKKAZ Rachid;M;NEKKAZ;Rachid;DVG;7
Législatives 2012 - 1er tour;Législatives;2012;1;3;3ème circonscription;35;LA GARENNE COLOMBES;92035;17314;7036;10278;79;10199;EISENBERG Mathilde;F;EISENBERG;Mathilde;EXG;30
Législatives 2012 - 1er tour;Législatives;2012;1;10;10ème circonscription;40;ISSY LES MOULINEAUX;92040;42014;16484;25530;277;25253;RONCHINI Vanessa;F;RONCHINI;Vanessa;EXG;61
Législatives 2012 - 1er tour;Législatives;2012;1;10;10ème circonscription;40;ISSY LES MOULINEAUX;92040;42014;16484;25530;277;25253;BERGER Véronique;F;BERGER;Véronique;DVD;167
Législatives 2012 - 1er tour;Législatives;2012;1;11;11ème circonscription;46;MALAKOFF;92046;18858;7608;11250;119;11131;BENHABRI Mehdi;M;BENHABRI;Mehdi;CEN;137
Législatives 2012 - 1er tour;Législatives;2012;1;8;8ème circonscription;47;MARNES LA COQUETTE;92047;1085;330;755;2;753;SEGUI Miguel;M;SEGUI;Miguel;EXG;0
Législatives 2012 - 1er tour;Législatives;2012;1;8;8ème circonscription;48;MEUDON;92048;25002;9709;15293;150;15143;LIME-BIFFE Catherine;F;LIME-BIFFE;Catherine;SOC;5474
Législatives 2012 - 1er tour;Législatives;2012;1;4;4ème circonscription;50;NANTERRE;92050;44344;21046;23298;337;22961;BOUKHEDIMI Yvonne;F;BOUKHEDIMI;Yvonne;EXG;85
Législatives 2012 - 1er tour;Législatives;2012;1;4;4ème circonscription;50;NANTERRE;92050;44344;21046;23298;337;22961;FOULLON Laure;F;FOULLON;Laure;VEC;739
Législatives 2012 - 1er tour;Législatives;2012;1;12;12ème circonscription;60;LE PLESSIS ROBINSON;92060;18785;6274;12511;101;12410;CHIVILO Isabelle;F;CHIVILO;Isabelle;ECO;67
Législatives 2012 - 1er tour;Législatives;2012;1;6;6ème circonscription;62;PUTEAUX;92062;28253;11141;17112;441;16671;BRANNENS Marie;F;BRANNENS;Marie;SOC;5417
Législatives 2012 - 1er tour;Législatives;2012;1;6;6ème circonscription;62;PUTEAUX;92062;28253;11141;17112;441;16671;FAVEUR Franck;M;FAVEUR;Franck;CEN;739
Législatives 2012 - 1er tour;Législatives;2012;1;6;6ème circonscription;62;PUTEAUX;92062;28253;11141;17112;441;16671;CABRERA Julien;M;CABRERA;Julien;DVD;154
Législatives 2012 - 1er tour;Législatives;2012;1;10;10ème circonscription;75;VANVES;92075;17559;6347;11212;104;11108;HESSE Frédéric;M;HESSE;Frédéric;AUT;3
Législatives 2012 - 1er tour;Législatives;2012;1;8;8ème circonscription;77;VILLE D'AVRAY;92077;7169;2468;4701;48;4653;GRILLARD Jean;M;GRILLARD;Jean;AUT;5
Législatives 2012 - 1er tour;Législatives;2012;1;1;1ère circonscription;78;VILLENEUVE LA GARENNE;92078;12349;6903;5446;131;5315;BUTAYE Denis;M;BUTAYE;Denis;DVD;189
Législatives 2002 - 1er tour;Législatives;2002;1;11;11ème circonscription;7;BAGNEUX;92007;20520;8538;11982;178;11804;PICARD Catherine;F;PICARD;Catherine;SOC;1910
Législatives 2002 - 1er tour;Législatives;2002;1;3;3ème circonscription;9;BOIS COLOMBES;92009;16245;6561;9684;288;9396;KOSSOWSKI Jacques;M;KOSSOWSKI;Jacques;UMP;4917
Législatives 1997 - 1er tour;Législatives;1997;1;2;2ème circonscription;25;COLOMBES;92025;17603;6110;11493;415;11078;LAIGLE CATHERINE;F;LAIGLE;CATHERINE;COM;1112
Présidentielles 2017 - 2ème tour;Présidentielles;2017;2;;;9;BOIS COLOMBES;92009;17896;4085;13811;1216;12595;LE PEN Marine;F;LE PEN;Marine;;1639
Législatives 1997 - 1er tour;Législatives;1997;1;10;10ème circonscription;48;MEUDON;92048;4118;1375;2743;67;2676;JANVIER GUY;M;JANVIER;GUY;SOC;632
Présidentielles 2012 - 2ème tour;Présidentielles;2012;2;;;23;CLAMART;92023;34151;5501;28650;1270;27380;HOLLANDE François;M;HOLLANDE;François;;14520
Législatives 1997 - 1er tour;Législatives;1997;1;11;11ème circonscription;7;BAGNEUX;92007;20284;7388;12896;374;12522;RAKETITCH RAOUL;M;RAKETITCH;RAOUL;FRN;1628
Législatives 1993 - 1er tour;Législatives;1993;1;5;5ème circonscription;24;CLICHY;92024;25172;9290;15882;514;15368;CONVERSY LAURENT;M;CONVERSY;LAURENT;DIV;187
Législatives 1997 - 1er tour;Législatives;1997;1;13;13ème circonscription;71;SCEAUX;92071;13168;3887;9281;266;9015;PEURIERE GERARD;M;PEURIERE;GERARD;ECO;382
Législatives 1993 - 1er tour;Législatives;1993;1;5;5ème circonscription;24;CLICHY;92024;25172;9290;15882;514;15368;CATOIRE GILLES;M;CATOIRE;GILLES;SOC;3824
Législatives 1997 - 1er tour;Législatives;1997;1;7;7ème circonscription;63;RUEIL MALMAISON;92063;44715;14813;29902;1094;28808;BAUMEL JACQUES;M;BAUMEL;JACQUES;RPR;13771
Législatives 1997 - 1er tour;Législatives;1997;1;7;7ème circonscription;63;RUEIL MALMAISON;92063;44715;14813;29902;1094;28808;ARIA D LUIGI;M;ARIA D;LUIGI;DIV;0
Législatives 1993 - 1er tour;Législatives;1993;1;2;2ème circonscription;25;COLOMBES;92025;18324;5870;12454;434;12020;MONEL MARTINE;F;MONEL;MARTINE;DIV;317
Législatives 1997 - 1er tour;Législatives;1997;1;10;10ème circonscription;75;VANVES;92075;15446;4682;10764;329;10435;SANTINI ANDRE;M;SANTINI;ANDRE;UDF;4158
Législatives 1993 - 1er tour;Législatives;1993;1;2;2ème circonscription;25;COLOMBES;92025;18324;5870;12454;434;12020;MACE J.PAUL;M;MACE;J.PAUL;EXG;164
Législatives 1997 - 1er tour;Législatives;1997;1;8;8ème circonscription;48;MEUDON;92048;24248;8136;16112;629;15483;AMSALLEM EDDY;M;AMSALLEM;EDDY;EXG;265
Législatives 1993 - 1er tour;Législatives;1993;1;12;12ème circonscription;60;LE PLESSIS ROBINSON;92060;13118;4266;8852;315;8537;MOURIER J.PIERRE;M;MOURIER;J.PIERRE;DIV;132
Législatives 1997 - 1er tour;Législatives;1997;1;6;6ème circonscription;51;NEUILLY SUR SEINE;92051;35571;12347;23224;570;22654;SARKOZY NICOLAS;M;SARKOZY;NICOLAS;RPR;14961
Législatives 1993 - 1er tour;Législatives;1993;1;8;8ème circonscription;77;VILLE D'AVRAY;92077;7199;1786;5413;149;5264;ROY CAROLINE;F;ROY;CAROLINE;RDG;630
Législatives 1997 - 1er tour;Législatives;1997;1;4;4ème circonscription;50;NANTERRE;92050;38533;13799;24734;766;23968;KERSUZAN NICOLE;F;KERSUZAN;NICOLE;DIV;200
Législatives 1993 - 1er tour;Législatives;1993;1;11;11ème circonscription;46;MALAKOFF;92046;19559;6951;12608;416;12192;BOURDIN YVES;M;BOURDIN;YVES;EXG;60
Législatives 1997 - 1er tour;Législatives;1997;1;1;1ère circonscription;78;VILLENEUVE LA GARENNE;92078;11471;4645;6826;211;6615;MERRA RICHARD;M;MERRA;RICHARD;EXG;53
Législatives 1993 - 1er tour;Législatives;1993;1;8;8ème circonscription;72;SEVRES;92072;13536;3690;9846;336;9510;GREGOIRE MAURICE;M;GREGOIRE;MAURICE;DIV;115
Législatives 1997 - 2ème tour;Législatives;1997;2;12;12ème circonscription;32;FONTENAY AUX ROSES;92032;14748;4006;10742;406;10336;FOUCHER J.PIERRE;M;FOUCHER;J.PIERRE;UDF;5071
Législatives 1993 - 1er tour;Législatives;1993;1;8;8ème circonscription;72;SEVRES;92072;13536;3690;9846;336;9510;BRISSAUD SOPHIE;F;BRISSAUD;SOPHIE;FRN;930
Législatives 2012 - 1er tour;Législatives;2012;1;13;13ème circonscription;14;BOURG LA REINE;92014;13305;4436;8869;87;8782;ROLLOT Franck;M;ROLLOT;Franck;EXG;14
Législatives 2012 - 1er tour;Législatives;2012;1;13;13ème circonscription;19;CHATENAY MALABRY;92019;17908;6775;11133;210;10923;DE LAMBILLY Gaëtan;M;DE LAMBILLY;Gaëtan;DVD;47
Législatives 2002 - 1er tour;Législatives;2002;1;2;2ème circonscription;4;ASNIERES SUR SEINE;92004;44110;17783;26327;312;26015;ETCHEBERRY Michèle;F;ETCHEBERRY;Michèle;SOC;5799
Législatives 2012 - 1er tour;Législatives;2012;1;1;1ère circonscription;25;COLOMBES;92025;26337;13144;13193;209;12984;MOURRE Odile;F;MOURRE;Odile;EXG;20
Législatives 2002 - 1er tour;Législatives;2002;1;13;13ème circonscription;14;BOURG LA REINE;92014;13381;4391;8990;78;8912;LEPEUVE Stéphane;M;LEPEUVE;Stéphane;EXG;170
Législatives 2012 - 1er tour;Législatives;2012;1;3;3ème circonscription;26;COURBEVOIE;92026;42456;16939;25517;317;25200;GOURDOL Aimée;F;GOURDOL;Aimée;DVG;164
Législatives 2002 - 1er tour;Législatives;2002;1;13;13ème circonscription;19;CHATENAY MALABRY;92019;17835;6584;11251;211;11040;GOURDOL Aimée;F;GOURDOL;Aimée;DVG;66
Législatives 2012 - 1er tour;Législatives;2012;1;6;6ème circonscription;26;COURBEVOIE;92026;8123;3742;4381;140;4241;GAUJARD Caroline;F;GAUJARD;Caroline;EXG;10
Législatives 2002 - 1er tour;Législatives;2002;1;8;8ème circonscription;22;CHAVILLE;92022;12928;4682;8246;120;8126;BLANCHARD Luc;M;BLANCHARD;Luc;VEC;332
Législatives 2012 - 1er tour;Législatives;2012;1;6;6ème circonscription;26;COURBEVOIE;92026;8123;3742;4381;140;4241;FROMANTIN Jean-Christophe;M;FROMANTIN;Jean-Christophe;DVD;653
Législatives 2002 - 1er tour;Législatives;2002;1;5;5ème circonscription;24;CLICHY;92024;28799;12380;16419;297;16122;MENDEZ Annie;F;MENDEZ;Annie;COM;528
Législatives 2012 - 1er tour;Législatives;2012;1;12;12ème circonscription;32;FONTENAY AUX ROSES;92032;15230;5971;9259;85;9174;CHIVILO Isabelle;F;CHIVILO;Isabelle;ECO;98
Législatives 2002 - 1er tour;Législatives;2002;1;1;1ère circonscription;25;COLOMBES;92025;26192;12273;13919;366;13553;DARRACQ Michel;M;DARRACQ;Michel;DIV;8
Législatives 2012 - 1er tour;Législatives;2012;1;1;1ère circonscription;36;GENNEVILLIERS;92036;20795;10523;10272;192;10080;BOURDU Anne;F;BOURDU;Anne;DVD;30
Législatives 2002 - 1er tour;Législatives;2002;1;3;3ème circonscription;35;LA GARENNE COLOMBES;92035;16552;5947;10605;101;10504;BARNONCEL Michel;M;BARNONCEL;Michel;VEC;287
Législatives 2012 - 1er tour;Législatives;2012;1;5;5ème circonscription;44;LEVALLOIS PERRET;92044;39546;14667;24879;238;24641;LEPRINCE-RINGUET Loïc;M;LEPRINCE-RINGUET;Loïc;DVD;3214
Législatives 2002 - 1er tour;Législatives;2002;1;4;4ème circonscription;50;NANTERRE;92050;42631;18721;23910;314;23596;GOIN Catherine;F;GOIN;Catherine;EXG;116
Législatives 2012 - 1er tour;Législatives;2012;1;8;8ème circonscription;47;MARNES LA COQUETTE;92047;1085;330;755;2;753;CANDELIER Catherine;F;CANDELIER;Catherine;VEC;20
Législatives 2002 - 1er tour;Législatives;2002;1;4;4ème circonscription;50;NANTERRE;92050;42631;18721;23910;314;23596;MARDOCH Brigitte;F;MARDOCH;Brigitte;ECO;131
Législatives 2012 - 1er tour;Législatives;2012;1;10;10ème circonscription;48;MEUDON;92048;5576;2083;3493;26;3467;VIGUIE Laurence;F;VIGUIE;Laurence;EXG;13
Législatives 2002 - 1er tour;Législatives;2002;1;6;6ème circonscription;62;PUTEAUX;92062;26791;8829;17962;396;17566;CECCALDI-RAYNAUD Joëlle;F;CECCALDI-RAYNAUD;Joëlle;UMP;8656
Législatives 2012 - 1er tour;Législatives;2012;1;12;12ème circonscription;60;LE PLESSIS ROBINSON;92060;18785;6274;12511;101;12410;PEMEZEC Philippe;M;PEMEZEC;Philippe;UMP;6798
Législatives 2002 - 1er tour;Législatives;2002;1;10;10ème circonscription;75;VANVES;92075;17351;5929;11422;137;11285;SANTINI André;M;SANTINI;André;MAJ;4808
Législatives 2012 - 1er tour;Législatives;2012;1;6;6ème circonscription;62;PUTEAUX;92062;28253;11141;17112;441;16671;PRUVOST Emmanuel;M;PRUVOST;Emmanuel;ECO;412
Législatives 2002 - 1er tour;Législatives;2002;1;8;8ème circonscription;76;VAUCRESSON;92076;6076;2206;3870;46;3824;LUCET Francis;M;LUCET;Francis;EXG;8
Législatives 2012 - 1er tour;Législatives;2012;1;8;8ème circonscription;76;VAUCRESSON;92076;6093;2463;3630;39;3591;BOUCHARD Renaud;M;BOUCHARD;Renaud;DVD;1
Législatives 2012 - 1er tour;Législatives;2012;1;1;1ère circonscription;78;VILLENEUVE LA GARENNE;92078;12349;6903;5446;131;5315;BACHELAY Alexis;M;BACHELAY;Alexis;SOC;2004
Législatives 2012 - 2ème tour;Législatives;2012;2;3;3ème circonscription;9;BOIS COLOMBES;92009;16783;7127;9656;288;9368;LASSERRE Jean-André;M;LASSERRE;Jean-André;SOC;4372
Législatives 2012 - 2ème tour;Législatives;2012;2;13;13ème circonscription;19;CHATENAY MALABRY;92019;17908;6693;11215;367;10848;LANDFRIED Julien;M;LANDFRIED;Julien;DVG;5772
Législatives 2012 - 2ème tour;Législatives;2012;2;1;1ère circonscription;36;GENNEVILLIERS;92036;20795;13902;6893;1635;5258;BACHELAY Alexis;M;BACHELAY;Alexis;SOC;5258
Législatives 1997 - 1er tour;Législatives;1997;1;10;10ème circonscription;12;BOULOGNE BILLANCOURT;92012;4529;1717;2812;99;2713;VIDAL ISABELLE;F;VIDAL;ISABELLE;EXG;21
Législatives 2012 - 2ème tour;Législatives;2012;2;4;4ème circonscription;73;SURESNES;92073;26492;11179;15313;554;14759;FRAYSSE Jacqueline;F;FRAYSSE;Jacqueline;FG;6209
Législatives 1997 - 1er tour;Législatives;1997;1;13;13ème circonscription;14;BOURG LA REINE;92014;12587;4431;8156;266;7890;ORHAN LOUIS;M;ORHAN;LOUIS;EXG;201
Législatives 2002 - 2ème tour;Législatives;2002;2;7;7ème circonscription;63;RUEIL MALMAISON;92063;48901;20615;28286;986;27300;OLLIER PATRICK;M;OLLIER;PATRICK;UMP;17714
Législatives 2017 - 1er tour;Législatives;2017;1;6;6ème circonscription;62;PUTEAUX;92062;28983;11794;17189;436;16753;BRANNENS Marie;F;BRANNENS;Marie;SOC;751
Législatives 2017 - 1er tour;Législatives;2017;1;5;5ème circonscription;44;LEVALLOIS PERRET;92044;41751;17632;24119;255;23864;DE COURSON Arnaud;M;DE COURSON;Arnaud;LR;4133
Législatives 2017 - 1er tour;Législatives;2017;1;3;3ème circonscription;26;COURBEVOIE;92026;44322;19890;24432;415;24017;DUMONT Eugénie;F;DUMONT;Eugénie;DIV;184
Législatives 2017 - 1er tour;Législatives;2017;1;11;11ème circonscription;49;MONTROUGE;92049;28914;12071;16843;175;16668;ROSSI Laurianne;F;ROSSI;Laurianne;REM;7437
Législatives 2017 - 1er tour;Législatives;2017;1;12;12ème circonscription;20;CHATILLON;92020;22311;9527;12784;186;12598;BERNARD Yann;M;BERNARD;Yann;EXG;57
Législatives 2017 - 1er tour;Législatives;2017;1;13;13ème circonscription;19;CHATENAY MALABRY;92019;18752;8166;10586;245;10341;LASGI Nicolas;M;LASGI;Nicolas;FI;1090
Législatives 2017 - 1er tour;Législatives;2017;1;13;13ème circonscription;19;CHATENAY MALABRY;92019;18752;8166;10586;245;10341;LANIER Benjamin;M;LANIER;Benjamin;SOC;451
Législatives 2017 - 2ème tour;Législatives;2017;2;1;1ère circonscription;25;COLOMBES;92025;27867;17939;9928;902;9026;FAUCILLON Elsa;F;FAUCILLON;Elsa;COM;4101
Législatives 2017 - 2ème tour;Législatives;2017;2;3;3ème circonscription;9;BOIS COLOMBES;92009;17921;9466;8455;816;7639;HENNION Christine;F;HENNION;Christine;REM;4831
Législatives 2017 - 2ème tour;Législatives;2017;2;3;3ème circonscription;26;COURBEVOIE;92026;44322;23241;21081;1513;19568;SPIRI Jean;M;SPIRI;Jean;LR;8285
Législatives 2017 - 2ème tour;Législatives;2017;2;8;8ème circonscription;77;VILLE D'AVRAY;92077;7440;3586;3854;221;3633;MAIRE Jacques;M;MAIRE;Jacques;REM;2255
Législatives 2017 - 2ème tour;Législatives;2017;2;9;9ème circonscription;12;BOULOGNE BILLANCOURT;92012;64985;36143;28842;2663;26179;SOLÈRE Thierry;M;SOLÈRE;Thierry;LR;14800
Législatives 2017 - 2ème tour;Législatives;2017;2;10;10ème circonscription;12;BOULOGNE BILLANCOURT;92012;9082;5325;3757;423;3334;ATTAL Gabriel;M;ATTAL;Gabriel;REM;2289
Législatives 2017 - 2ème tour;Législatives;2017;2;10;10ème circonscription;40;ISSY LES MOULINEAUX;92040;45375;22953;22422;2198;20224;ATTAL Gabriel;M;ATTAL;Gabriel;REM;11637
Législatives 2017 - 1er tour;Législatives;2017;1;10;10ème circonscription;12;BOULOGNE BILLANCOURT;92012;9082;4562;4520;114;4406;DAHAN Gérald;M;DAHAN;Gérald;FI;373
Législatives 2017 - 1er tour;Législatives;2017;1;8;8ème circonscription;72;SEVRES;92072;15144;6343;8801;149;8652;PASQUELIN Nelly;F;PASQUELIN;Nelly;FI;672
Législatives 2017 - 1er tour;Législatives;2017;1;10;10ème circonscription;12;BOULOGNE BILLANCOURT;92012;9082;4562;4520;114;4406;CROS Stéphane;M;CROS;Stéphane;DIV;42
Législatives 2017 - 1er tour;Législatives;2017;1;10;10ème circonscription;75;VANVES;92075;18507;7626;10881;125;10756;PUIJALON Thomas;M;PUIJALON;Thomas;SOC;652
Législatives 2017 - 1er tour;Législatives;2017;1;2;2ème circonscription;25;COLOMBES;92025;19668;8354;11314;229;11085;AESCHLIMANN Marie-Do;F;AESCHLIMANN;Marie-Do;LR;2166
Présidentielles 1995 - 1er tour;Présidentielles;1995;1;;;20;CHATILLON;92020;16579;4065;12514;245;12269;JOSPIN LIONEL;M;JOSPIN;LIONEL;;3140
Présidentielles 1995 - 1er tour;Présidentielles;1995;1;;;23;CLAMART;92023;31229;8419;22810;457;22353;VOYNET DOMINIQUE;F;VOYNET;DOMINIQUE;;805
Présidentielles 1995 - 1er tour;Présidentielles;1995;1;;;25;COLOMBES;92025;44864;11966;32898;703;32195;VILLIERS DE PHILIPPE;M;VILLIERS DE;PHILIPPE;;995
Présidentielles 1995 - 1er tour;Présidentielles;1995;1;;;25;COLOMBES;92025;44864;11966;32898;703;32195;BALLADUR EDOUARD;M;BALLADUR;EDOUARD;;4914
Présidentielles 1995 - 1er tour;Présidentielles;1995;1;;;26;COURBEVOIE;92026;35812;8064;27748;468;27280;JOSPIN LIONEL;M;JOSPIN;LIONEL;;5939
Présidentielles 1995 - 1er tour;Présidentielles;1995;1;;;32;FONTENAY AUX ROSES;92032;14917;3559;11358;196;11162;HUE ROBERT;M;HUE;ROBERT;;804
Présidentielles 1995 - 1er tour;Présidentielles;1995;1;;;36;GENNEVILLIERS;92036;19543;5563;13980;326;13654;VILLIERS DE PHILIPPE;M;VILLIERS DE;PHILIPPE;;323
Présidentielles 1995 - 1er tour;Présidentielles;1995;1;;;36;GENNEVILLIERS;92036;19543;5563;13980;326;13654;BALLADUR EDOUARD;M;BALLADUR;EDOUARD;;1185
Présidentielles 1995 - 1er tour;Présidentielles;1995;1;;;60;LE PLESSIS ROBINSON;92060;13056;3285;9771;199;9572;CHEMINADE JACQUES;M;CHEMINADE;JACQUES;;24
Présidentielles 1995 - 1er tour;Présidentielles;1995;1;;;76;VAUCRESSON;92076;5529;1334;4195;65;4130;VOYNET DOMINIQUE;F;VOYNET;DOMINIQUE;;115
Présidentielles 1995 - 2ème tour;Présidentielles;1995;2;;;9;BOIS COLOMBES;92009;14923;3184;11739;539;11200;CHIRAC JACQUES;M;CHIRAC;JACQUES;;7090
Présidentielles 1995 - 2ème tour;Présidentielles;1995;2;;;12;BOULOGNE BILLANCOURT;92012;58255;11792;46463;1522;44941;JOSPIN LIONEL;M;JOSPIN;LIONEL;;14153
Présidentielles 1995 - 2ème tour;Présidentielles;1995;2;;;19;CHATENAY MALABRY;92019;18197;4260;13937;653;13284;CHIRAC JACQUES;M;CHIRAC;JACQUES;;6703
Présidentielles 1995 - 2ème tour;Présidentielles;1995;2;;;26;COURBEVOIE;92026;35809;6813;28996;1171;27825;CHIRAC JACQUES;M;CHIRAC;JACQUES;;18098
Présidentielles 1995 - 1er tour;Présidentielles;1995;1;;;12;BOULOGNE BILLANCOURT;92012;58255;14334;43921;656;43265;BALLADUR EDOUARD;M;BALLADUR;EDOUARD;;10017
Présidentielles 1995 - 1er tour;Présidentielles;1995;1;;;12;BOULOGNE BILLANCOURT;92012;58255;14334;43921;656;43265;VOYNET DOMINIQUE;F;VOYNET;DOMINIQUE;;1147
Législatives 2007 - 1er tour;Législatives;2007;1;10;10ème circonscription;75;VANVES;92075;17351;5929;11422;137;11285;NAVIAUX Catherine;F;NAVIAUX;Catherine;VEC;527
Législatives 2007 - 1er tour;Législatives;2007;1;4;4ème circonscription;73;SURESNES;92073;24666;8949;15717;206;15511;PELLET Tony;M;PELLET;Tony;EXG;107
Législatives 2007 - 1er tour;Législatives;2007;1;8;8ème circonscription;77;VILLE D'AVRAY;92077;7475;2429;5046;60;4986;GONNET Nicolas;M;GONNET;Nicolas;COM;37
Législatives 2007 - 2ème tour;Législatives;2007;2;2;2ème circonscription;4;ASNIERES SUR SEINE;92004;44102;20511;23591;887;22704;AESCHLIMANN Manuel;M;AESCHLIMANN;Manuel;UMP;12850
Législatives 2007 - 1er tour;Législatives;2007;1;1;1ère circonscription;78;VILLENEUVE LA GARENNE;92078;13038;7211;5827;131;5696;MOURRE Odile;F;MOURRE;Odile;EXG;28
Législatives 2007 - 2ème tour;Législatives;2007;2;4;4ème circonscription;73;SURESNES;92073;24666;10165;14501;476;14025;DUPUY Christian;M;DUPUY;Christian;UMP;8620
Législatives 2007 - 1er tour;Législatives;2007;1;13;13ème circonscription;2;ANTONY;92002;39807;13942;25865;456;25409;DEVEDJIAN Patrick;M;DEVEDJIAN;Patrick;UMP;12052
Législatives 2007 - 1er tour;Législatives;2007;1;13;13ème circonscription;2;ANTONY;92002;39807;13942;25865;456;25409;LEPEUVE Stéphane;M;LEPEUVE;Stéphane;EXG;496
Législatives 2007 - 1er tour;Législatives;2007;1;3;3ème circonscription;9;BOIS COLOMBES;92009;16245;6561;9684;288;9396;SOUILLART Marie-Jeanne;F;SOUILLART;Marie-Jeanne;EXD;33
Législatives 2007 - 1er tour;Législatives;2007;1;13;13ème circonscription;14;BOURG LA REINE;92014;13381;4391;8990;78;8912;SARFATI André;M;SARFATI;André;DIV;85
Législatives 2007 - 1er tour;Législatives;2007;1;11;11ème circonscription;7;BAGNEUX;92007;20520;8538;11982;178;11804;MORILLERE Denis;M;MORILLERE;Denis;DIV;0
Législatives 2007 - 1er tour;Législatives;2007;1;5;5ème circonscription;44;LEVALLOIS PERRET;92044;39466;14724;24742;404;24338;REBATO Stéphanie;F;REBATO;Stéphanie;DIV;131
Législatives 2007 - 1er tour;Législatives;2007;1;5;5ème circonscription;44;LEVALLOIS PERRET;92044;39466;14724;24742;404;24338;DUTHEIL Daniel;M;DUTHEIL;Daniel;EXG;27
Législatives 2007 - 1er tour;Législatives;2007;1;1;1ère circonscription;36;GENNEVILLIERS;92036;20048;9522;10526;189;10337;MOURRE Odile;F;MOURRE;Odile;EXG;41
Législatives 2007 - 1er tour;Législatives;2007;1;8;8ème circonscription;48;MEUDON;92048;25427;9683;15744;202;15542;BEZAULT Christine;F;BEZAULT;Christine;DIV;96
Législatives 2007 - 1er tour;Législatives;2007;1;10;10ème circonscription;48;MEUDON;92048;5066;1864;3202;29;3173;DROUET Valérie;F;DROUET;Valérie;EXD;9
Législatives 2007 - 1er tour;Législatives;2007;1;10;10ème circonscription;48;MEUDON;92048;5066;1864;3202;29;3173;BINDER Sabrina;F;BINDER;Sabrina;DIV;36
Législatives 2007 - 1er tour;Législatives;2007;1;8;8ème circonscription;48;MEUDON;92048;25427;9683;15744;202;15542;GONNET Nicolas;M;GONNET;Nicolas;COM;334
Législatives 2007 - 1er tour;Législatives;2007;1;8;8ème circonscription;48;MEUDON;92048;25427;9683;15744;202;15542;ROY Caroline;F;ROY;Caroline;RDG;3546
Législatives 2007 - 1er tour;Législatives;2007;1;4;4ème circonscription;50;NANTERRE;92050;42631;18721;23910;314;23596;MEYER Marie-Laure;F;MEYER;Marie-Laure;SOC;3383
Législatives 2007 - 1er tour;Législatives;2007;1;11;11ème circonscription;49;MONTROUGE;92049;26595;9698;16897;213;16684;METTON Jean-Loup;M;METTON;Jean-Loup;MAJ;8030
Législatives 2007 - 1er tour;Législatives;2007;1;4;4ème circonscription;50;NANTERRE;92050;42631;18721;23910;314;23596;PELLET Tony;M;PELLET;Tony;EXG;360
Législatives 2007 - 1er tour;Législatives;2007;1;8;8ème circonscription;72;SEVRES;92072;14460;5279;9181;151;9030;FILLOUX Delphine;F;FILLOUX;Delphine;DIV;120
Présidentielles 2002 - 1er tour;Présidentielles;2002;1;;;2;ANTONY;92002;36989;11047;25942;517;25425;LE PEN JEAN-MARIE;M;LE PEN;JEAN-MARIE;;2655
Présidentielles 2002 - 1er tour;Présidentielles;2002;1;;;4;ASNIERES SUR SEINE;92004;35702;11271;24431;515;23916;MADELIN ALAIN;M;MADELIN;ALAIN;;1250
Présidentielles 2002 - 1er tour;Présidentielles;2002;1;;;23;CLAMART;92023;31130;10977;20153;427;19726;SAINT-JOSSE JEAN;M;SAINT-JOSSE;JEAN;;180
Présidentielles 2002 - 1er tour;Présidentielles;2002;1;;;26;COURBEVOIE;92026;39941;11959;27982;520;27462;TAUBIRA CHRISTIANE;F;TAUBIRA;CHRISTIANE;;830
Présidentielles 2002 - 1er tour;Présidentielles;2002;1;;;32;FONTENAY AUX ROSES;92032;14148;4309;9839;204;9635;BOUTIN CHRISTINE;F;BOUTIN;CHRISTINE;;120
Présidentielles 2002 - 1er tour;Présidentielles;2002;1;;;35;LA GARENNE COLOMBES;92035;15006;5167;9839;227;9612;CHIRAC JACQUES;M;CHIRAC;JACQUES;;2406
Présidentielles 2002 - 1er tour;Présidentielles;2002;1;;;40;ISSY LES MOULINEAUX;92040;32059;9424;22635;510;22125;BOUTIN CHRISTINE;F;BOUTIN;CHRISTINE;;367
Présidentielles 2002 - 1er tour;Présidentielles;2002;1;;;44;LEVALLOIS PERRET;92044;33618;9640;23978;575;23403;LAGUILLER ARLETTE;F;LAGUILLER;ARLETTE;;736
Présidentielles 2002 - 1er tour;Présidentielles;2002;1;;;47;MARNES LA COQUETTE;92047;997;272;725;7;718;CHEVENEMENT JEAN-PIERRE;M;CHEVENEMENT;JEAN-PIERRE;;37
Présidentielles 2002 - 1er tour;Présidentielles;2002;1;;;48;MEUDON;92048;28283;9341;18942;321;18621;MADELIN ALAIN;M;MADELIN;ALAIN;;973
Présidentielles 2002 - 1er tour;Présidentielles;2002;1;;;49;MONTROUGE;92049;23382;8142;15240;301;14939;BAYROU FRANCOIS;M;BAYROU;FRANCOIS;;1300
Présidentielles 2002 - 1er tour;Présidentielles;2002;1;;;51;NEUILLY SUR SEINE;92051;34066;10108;23958;309;23649;LEPAGE CORINNE;F;LEPAGE;CORINNE;;592
Présidentielles 2002 - 1er tour;Présidentielles;2002;1;;;60;LE PLESSIS ROBINSON;92060;14503;4736;9767;230;9537;GLUCKSTEIN DANIEL;M;GLUCKSTEIN;DANIEL;;34
Présidentielles 2002 - 1er tour;Présidentielles;2002;1;;;60;LE PLESSIS ROBINSON;92060;14503;4736;9767;230;9537;LE PEN JEAN-MARIE;M;LE PEN;JEAN-MARIE;;1322
Présidentielles 2002 - 1er tour;Présidentielles;2002;1;;;72;SEVRES;92072;13367;4140;9227;153;9074;BOUTIN CHRISTINE;F;BOUTIN;CHRISTINE;;176
Présidentielles 2002 - 1er tour;Présidentielles;2002;1;;;73;SURESNES;92073;22099;7156;14943;329;14614;SAINT-JOSSE JEAN;M;SAINT-JOSSE;JEAN;;122
Présidentielles 2002 - 1er tour;Présidentielles;2002;1;;;75;VANVES;92075;15493;4648;10845;221;10624;TAUBIRA CHRISTIANE;F;TAUBIRA;CHRISTIANE;;404
Présidentielles 2002 - 1er tour;Présidentielles;2002;1;;;75;VANVES;92075;15493;4648;10845;221;10624;SAINT-JOSSE JEAN;M;SAINT-JOSSE;JEAN;;99
Présidentielles 2002 - 1er tour;Présidentielles;2002;1;;;76;VAUCRESSON;92076;5861;2048;3813;62;3751;MEGRET BRUNO;M;MEGRET;BRUNO;;69
Présidentielles 2012 - 1er tour;Présidentielles;2012;1;;;2;ANTONY;92002;40169;7755;32414;674;31740;BAYROU François;M;BAYROU;François;;4082
Présidentielles 2012 - 1er tour;Présidentielles;2012;1;;;7;BAGNEUX;92007;20608;4687;15921;281;15640;MÉLENCHON Jean-Luc;M;MÉLENCHON;Jean-Luc;;3298
Présidentielles 2012 - 1er tour;Présidentielles;2012;1;;;9;BOIS COLOMBES;92009;16746;3612;13134;231;12903;POUTOU Philippe;M;POUTOU;Philippe;;76
Présidentielles 2012 - 1er tour;Présidentielles;2012;1;;;9;BOIS COLOMBES;92009;16746;3612;13134;231;12903;HOLLANDE François;M;HOLLANDE;François;;3739
Présidentielles 2012 - 1er tour;Présidentielles;2012;1;;;12;BOULOGNE BILLANCOURT;92012;67579;13310;54269;818;53451;HOLLANDE François;M;HOLLANDE;François;;12699
Présidentielles 2012 - 1er tour;Présidentielles;2012;1;;;14;BOURG LA REINE;92014;13300;2381;10919;132;10787;POUTOU Philippe;M;POUTOU;Philippe;;48
Présidentielles 2012 - 1er tour;Présidentielles;2012;1;;;20;CHATILLON;92020;21656;4298;17358;265;17093;SARKOZY Nicolas;M;SARKOZY;Nicolas;;4884
Présidentielles 2012 - 1er tour;Présidentielles;2012;1;;;26;COURBEVOIE;92026;50576;11277;39299;681;38618;LE PEN Marine;F;LE PEN;Marine;;3216
Présidentielles 2012 - 1er tour;Présidentielles;2012;1;;;33;GARCHES;92033;12388;2501;9887;167;9720;DUPONT-AIGNAN Nicolas;M;DUPONT-AIGNAN;Nicolas;;112
Présidentielles 2012 - 1er tour;Présidentielles;2012;1;;;36;GENNEVILLIERS;92036;20990;5264;15726;342;15384;POUTOU Philippe;M;POUTOU;Philippe;;163
Présidentielles 2012 - 1er tour;Présidentielles;2012;1;;;40;ISSY LES MOULINEAUX;92040;41994;9488;32506;521;31985;ARTHAUD Nathalie;F;ARTHAUD;Nathalie;;84
Présidentielles 2012 - 1er tour;Présidentielles;2012;1;;;44;LEVALLOIS PERRET;92044;39497;7296;32201;438;31763;HOLLANDE François;M;HOLLANDE;François;;7371
Présidentielles 2012 - 1er tour;Présidentielles;2012;1;;;47;MARNES LA COQUETTE;92047;1082;163;919;8;911;HOLLANDE François;M;HOLLANDE;François;;116
Présidentielles 2012 - 1er tour;Présidentielles;2012;1;;;48;MEUDON;92048;30572;6341;24231;318;23913;BAYROU François;M;BAYROU;François;;2763
Présidentielles 2012 - 1er tour;Présidentielles;2012;1;;;49;MONTROUGE;92049;27851;5527;22324;289;22035;JOLY Eva;F;JOLY;Eva;;825
Présidentielles 2012 - 1er tour;Présidentielles;2012;1;;;49;MONTROUGE;92049;27851;5527;22324;289;22035;ARTHAUD Nathalie;F;ARTHAUD;Nathalie;;86
Présidentielles 2012 - 1er tour;Présidentielles;2012;1;;;49;MONTROUGE;92049;27851;5527;22324;289;22035;BAYROU François;M;BAYROU;François;;2416
Présidentielles 2012 - 1er tour;Présidentielles;2012;1;;;50;NANTERRE;92050;44307;10435;33872;654;33218;JOLY Eva;F;JOLY;Eva;;847
Présidentielles 2012 - 1er tour;Présidentielles;2012;1;;;62;PUTEAUX;92062;28189;5597;22592;470;22122;POUTOU Philippe;M;POUTOU;Philippe;;182
Présidentielles 2012 - 1er tour;Présidentielles;2012;1;;;64;SAINT CLOUD;92064;18973;3529;15444;153;15291;SARKOZY Nicolas;M;SARKOZY;Nicolas;;7934
Présidentielles 2012 - 1er tour;Présidentielles;2012;1;;;77;VILLE D'AVRAY;92077;7132;1060;6072;80;5992;SARKOZY Nicolas;M;SARKOZY;Nicolas;;2910
Présidentielles 2007 - 1er tour;Présidentielles;2007;1;;;4;ASNIERES SUR SEINE;92004;43605;5665;37940;436;37504;BAYROU François;M;BAYROU;François;;8048
Présidentielles 2007 - 1er tour;Présidentielles;2007;1;;;14;BOURG LA REINE;92014;13108;1436;11672;90;11582;BOVÉ José;M;BOVÉ;José;;75
Présidentielles 2007 - 1er tour;Présidentielles;2007;1;;;22;CHAVILLE;92022;12743;1700;11043;119;10924;BOVÉ José;M;BOVÉ;José;;87
Présidentielles 2007 - 1er tour;Présidentielles;2007;1;;;22;CHAVILLE;92022;12743;1700;11043;119;10924;NIHOUS Frédéric;M;NIHOUS;Frédéric;;31
Présidentielles 2007 - 1er tour;Présidentielles;2007;1;;;25;COLOMBES;92025;44025;7536;36489;501;35988;SARKOZY Nicolas;M;SARKOZY;Nicolas;;10909
Présidentielles 2007 - 1er tour;Présidentielles;2007;1;;;35;LA GARENNE COLOMBES;92035;16350;1826;14524;117;14407;BOVÉ José;M;BOVÉ;José;;76
Présidentielles 2007 - 1er tour;Présidentielles;2007;1;;;44;LEVALLOIS PERRET;92044;38708;4734;33974;296;33678;ROYAL Ségolène;F;ROYAL;Ségolène;;6433
Présidentielles 2007 - 1er tour;Présidentielles;2007;1;;;50;NANTERRE;92050;42083;6117;35966;477;35489;LAGUILLER Arlette;F;LAGUILLER;Arlette;;384
Présidentielles 2007 - 1er tour;Présidentielles;2007;1;;;72;SEVRES;92072;14178;1738;12440;129;12311;BUFFET Marie-George;F;BUFFET;Marie-George;;145
Présidentielles 2017 - 1er tour;Présidentielles;2017;1;;;7;BAGNEUX;92007;21873;5369;16504;428;16076;LASSALLE Jean;M;LASSALLE;Jean;;97
Présidentielles 2017 - 1er tour;Présidentielles;2017;1;;;19;CHATENAY MALABRY;92019;18708;3336;15372;454;14918;ASSELINEAU François;M;ASSELINEAU;François;;180
Présidentielles 2017 - 1er tour;Présidentielles;2017;1;;;25;COLOMBES;92025;47454;9714;37740;907;36833;MACRON Emmanuel;M;MACRON;Emmanuel;;11238
Présidentielles 2017 - 1er tour;Présidentielles;2017;1;;;26;COURBEVOIE;92026;52391;9609;42782;817;41965;ARTHAUD Nathalie;F;ARTHAUD;Nathalie;;95
Présidentielles 2017 - 1er tour;Présidentielles;2017;1;;;47;MARNES LA COQUETTE;92047;1215;171;1044;5;1039;LASSALLE Jean;M;LASSALLE;Jean;;9
Présidentielles 2017 - 1er tour;Présidentielles;2017;1;;;48;MEUDON;92048;31280;5715;25565;405;25160;MÉLENCHON Jean-Luc;M;MÉLENCHON;Jean-Luc;;4225
Présidentielles 2017 - 1er tour;Présidentielles;2017;1;;;50;NANTERRE;92050;47568;10655;36913;884;36029;FILLON François;M;FILLON;François;;4759
Présidentielles 2017 - 1er tour;Présidentielles;2017;1;;;63;RUEIL MALMAISON;92063;54426;9298;45128;713;44414;POUTOU Philippe;M;POUTOU;Philippe;;229
Présidentielles 2017 - 1er tour;Présidentielles;2017;1;;;64;SAINT CLOUD;92064;19370;2628;16742;186;16556;DUPONT-AIGNAN Nicolas;M;DUPONT-AIGNAN;Nicolas;;348
Présidentielles 2017 - 1er tour;Présidentielles;2017;1;;;76;VAUCRESSON;92076;6176;835;5341;72;5269;LASSALLE Jean;M;LASSALLE;Jean;;28
Présidentielles 2002 - 2ème tour;Présidentielles;2002;2;;;36;GENNEVILLIERS;92036;18215;4731;13484;577;12907;LE PEN JEAN-MARIE;M;LE PEN;JEAN-MARIE;;1791
Présidentielles 2002 - 2ème tour;Présidentielles;2002;2;;;60;LE PLESSIS ROBINSON;92060;14505;2930;11575;479;11096;LE PEN JEAN-MARIE;M;LE PEN;JEAN-MARIE;;1527
Présidentielles 2002 - 2ème tour;Présidentielles;2002;2;;;75;VANVES;92075;15504;2463;13041;460;12581;CHIRAC JACQUES;M;CHIRAC;JACQUES;;11285
Présidentielles 2007 - 2ème tour;Présidentielles;2007;2;;;33;GARCHES;92033;11961;1553;10408;396;10012;ROYAL Ségolène;F;ROYAL;Ségolène;;3002
Présidentielles 2007 - 2ème tour;Présidentielles;2007;2;;;40;ISSY LES MOULINEAUX;92040;37971;5265;32706;1404;31302;ROYAL Ségolène;F;ROYAL;Ségolène;;14575
Présidentielles 2007 - 2ème tour;Présidentielles;2007;2;;;44;LEVALLOIS PERRET;92044;38751;5311;33440;1158;32282;SARKOZY Nicolas;M;SARKOZY;Nicolas;;21561
Présidentielles 2007 - 2ème tour;Présidentielles;2007;2;;;46;MALAKOFF;92046;18269;2915;15354;551;14803;ROYAL Ségolène;F;ROYAL;Ségolène;;9336
Présidentielles 2007 - 2ème tour;Présidentielles;2007;2;;;60;LE PLESSIS ROBINSON;92060;16574;2193;14381;560;13821;SARKOZY Nicolas;M;SARKOZY;Nicolas;;7539
Présidentielles 2007 - 2ème tour;Présidentielles;2007;2;;;63;RUEIL MALMAISON;92063;50540;6613;43927;1660;42267;ROYAL Ségolène;F;ROYAL;Ségolène;;16368
Présidentielles 2007 - 2ème tour;Présidentielles;2007;2;;;72;SEVRES;92072;14169;1834;12335;525;11810;ROYAL Ségolène;F;ROYAL;Ségolène;;5149
Présidentielles 2017 - 2ème tour;Présidentielles;2017;2;;;36;GENNEVILLIERS;92036;22151;6800;15351;1611;13740;MACRON Emmanuel;M;MACRON;Emmanuel;;11388
Présidentielles 2017 - 2ème tour;Présidentielles;2017;2;;;47;MARNES LA COQUETTE;92047;1215;249;966;96;870;LE PEN Marine;F;LE PEN;Marine;;139
Présidentielles 2012 - 2ème tour;Présidentielles;2012;2;;;4;ASNIERES SUR SEINE;92004;45078;7965;37113;1429;35684;HOLLANDE François;M;HOLLANDE;François;;18655
Présidentielles 2012 - 2ème tour;Présidentielles;2012;2;;;9;BOIS COLOMBES;92009;16756;3008;13748;607;13141;SARKOZY Nicolas;M;SARKOZY;Nicolas;;6876
Présidentielles 2012 - 2ème tour;Présidentielles;2012;2;;;44;LEVALLOIS PERRET;92044;39523;6219;33304;1154;32150;HOLLANDE François;M;HOLLANDE;François;;11791
Présidentielles 2012 - 2ème tour;Présidentielles;2012;2;;;46;MALAKOFF;92046;18865;3800;15065;590;14475;HOLLANDE François;M;HOLLANDE;François;;10234
Législatives 1997 - 1er tour;Législatives;1997;1;2;2ème circonscription;25;COLOMBES;92025;17603;6110;11493;415;11078;MASSOL HUBERT;M;MASSOL;HUBERT;FRN;1740
Législatives 1997 - 1er tour;Législatives;1997;1;8;8ème circonscription;22;CHAVILLE;92022;12268;3930;8338;262;8076;MULLERIS KONOPNICKI A.PAULE;F;MULLERIS KONOPNICKI;A.PAULE;ECO;359
Législatives 1993 - 1er tour;Législatives;1993;1;5;5ème circonscription;24;CLICHY;92024;25172;9290;15882;514;15368;LE GALL EMMANUELLE;F;LE GALL;EMMANUELLE;DIV;199
Législatives 1993 - 1er tour;Législatives;1993;1;12;12ème circonscription;20;CHATILLON;92020;15705;4455;11250;435;10815;BUCHET PASCAL;M;BUCHET;PASCAL;SOC;2034
Législatives 1993 - 1er tour;Législatives;1993;1;12;12ème circonscription;60;LE PLESSIS ROBINSON;92060;13118;4266;8852;315;8537;FOUCHER J.PIERRE;M;FOUCHER;J.PIERRE;UDF;3846
Législatives 1993 - 1er tour;Législatives;1993;1;6;6ème circonscription;62;PUTEAUX;92062;23271;6636;16635;697;15938;BLANCHARD MICHEL;M;BLANCHARD;MICHEL;DIV;427
Législatives 1997 - 1er tour;Législatives;1997;1;7;7ème circonscription;64;SAINT CLOUD;92064;18908;7095;11813;417;11396;BAUMEL JACQUES;M;BAUMEL;JACQUES;RPR;6189
Législatives 1993 - 1er tour;Législatives;1993;1;12;12ème circonscription;20;CHATILLON;92020;15705;4455;11250;435;10815;BUFFET M.GEORGE;F;BUFFET;M.GEORGE;COM;969
Législatives 1993 - 1er tour;Législatives;1993;1;3;3ème circonscription;9;BOIS COLOMBES;92009;14392;4251;10141;422;9719;POYER DIDIER;M;POYER;DIDIER;DVD;45
Législatives 1993 - 1er tour;Législatives;1993;1;11;11ème circonscription;46;MALAKOFF;92046;19559;6951;12608;416;12192;LE CORGUILLE VIVETTE;F;LE CORGUILLE;VIVETTE;EXG;58
Législatives 1997 - 1er tour;Législatives;1997;1;5;5ème circonscription;44;LEVALLOIS PERRET;92044;28281;9315;18966;650;18316;LALUMIERE CATHERINE;F;LALUMIERE;CATHERINE;PRS;4023
Législatives 1997 - 1er tour;Législatives;1997;1;10;10ème circonscription;12;BOULOGNE BILLANCOURT;92012;4529;1717;2812;99;2713;BELLAIRE VALERIE;F;BELLAIRE;VALERIE;DIV;0
Législatives 1993 - 2ème tour;Législatives;1993;2;12;12ème circonscription;60;LE PLESSIS ROBINSON;92060;13118;4419;8699;611;8088;FOUCHER J.PIERRE;M;FOUCHER;J.PIERRE;UDF;4744
Législatives 1993 - 2ème tour;Législatives;1993;2;1;1ère circonscription;78;VILLENEUVE LA GARENNE;92078;11604;4389;7215;415;6800;BRUNHES JACQUES;M;BRUNHES;JACQUES;COM;2586
Législatives 1997 - 1er tour;Législatives;1997;1;2;2ème circonscription;4;ASNIERES SUR SEINE;92004;37154;13729;23425;737;22688;FRAGER DOMINIQUE;M;FRAGER;DOMINIQUE;ECO;4947
Législatives 1993 - 2ème tour;Législatives;1993;2;10;10ème circonscription;40;ISSY LES MOULINEAUX;92040;29377;10522;18855;1072;17783;SANTINI ANDRE;M;SANTINI;ANDRE;UDF;11532
Législatives 1997 - 1er tour;Législatives;1997;1;2;2ème circonscription;4;ASNIERES SUR SEINE;92004;37154;13729;23425;737;22688;HOUZEL ALAIN;M;HOUZEL;ALAIN;ECO;935
Législatives 2002 - 1er tour;Législatives;2002;1;3;3ème circonscription;9;BOIS COLOMBES;92009;16245;6561;9684;288;9396;HERBIN Annick;F;HERBIN;Annick;COM;182
Législatives 2002 - 1er tour;Législatives;2002;1;9;9ème circonscription;12;BOULOGNE BILLANCOURT;92012;60773;22422;38351;535;37816;THOUVENOT Mireille;F;THOUVENOT;Mireille;EXG;372
Législatives 2002 - 1er tour;Législatives;2002;1;9;9ème circonscription;12;BOULOGNE BILLANCOURT;92012;60773;22422;38351;535;37816;DU REAU Eric;M;DU REAU;Eric;FN;854
Législatives 2002 - 1er tour;Législatives;2002;1;10;10ème circonscription;12;BOULOGNE BILLANCOURT;92012;5551;2367;3184;78;3106;SCHMID Lucille;F;SCHMID;Lucille;SOC;857
Législatives 1997 - 1er tour;Législatives;1997;1;11;11ème circonscription;46;MALAKOFF;92046;19124;7233;11891;338;11553;GARO MICHELE;F;GARO;MICHELE;EXG;68
Législatives 1997 - 1er tour;Législatives;1997;1;8;8ème circonscription;48;MEUDON;92048;24248;8136;16112;629;15483;JOURNE SILIAN;M;JOURNE;SILIAN;DVD;678
Législatives 1997 - 1er tour;Législatives;1997;1;12;12ème circonscription;60;LE PLESSIS ROBINSON;92060;13002;3860;9142;204;8938;LARCHER ROBERT;M;LARCHER;ROBERT;EXG;209
Législatives 1997 - 1er tour;Législatives;1997;1;1;1ère circonscription;78;VILLENEUVE LA GARENNE;92078;11471;4645;6826;211;6615;HAMON HENRI;M;HAMON;HENRI;DVD;29
Législatives 2002 - 1er tour;Législatives;2002;1;8;8ème circonscription;76;VAUCRESSON;92076;6076;2206;3870;46;3824;BOUCHARD Renaud;M;BOUCHARD;Renaud;DIV;1
Législatives 2012 - 1er tour;Législatives;2012;1;13;13ème circonscription;2;ANTONY;92002;40941;15088;25853;361;25492;ROLLOT Franck;M;ROLLOT;Franck;EXG;79
Législatives 2012 - 1er tour;Législatives;2012;1;2;2ème circonscription;4;ASNIERES SUR SEINE;92004;45114;18545;26569;310;26259;OLIVIER Bruno;M;OLIVIER;Bruno;AUT;43
Législatives 1997 - 1er tour;Législatives;1997;1;9;9ème circonscription;12;BOULOGNE BILLANCOURT;92012;53287;18902;34385;948;33437;CHOISEL FRANCIS;M;CHOISEL;FRANCIS;DVD;1086
Législatives 2012 - 1er tour;Législatives;2012;1;9;9ème circonscription;12;BOULOGNE BILLANCOURT;92012;61020;24579;36441;340;36101;SOLERE Thierry;M;SOLERE;Thierry;DVD;9709
Législatives 2012 - 1er tour;Législatives;2012;1;10;10ème circonscription;12;BOULOGNE BILLANCOURT;92012;6600;2912;3688;126;3562;LACOMBE Maxime;M;LACOMBE;Maxime;ECO;32
Législatives 2012 - 1er tour;Législatives;2012;1;12;12ème circonscription;23;CLAMART;92023;34173;13440;20733;193;20540;GERMAIN Jean-Marc;M;GERMAIN;Jean-Marc;SOC;7362
Législatives 2012 - 1er tour;Législatives;2012;1;5;5ème circonscription;24;CLICHY;92024;29276;13521;15755;274;15481;LEPRINCE-RINGUET Loïc;M;LEPRINCE-RINGUET;Loïc;DVD;701
Législatives 2012 - 1er tour;Législatives;2012;1;12;12ème circonscription;32;FONTENAY AUX ROSES;92032;15230;5971;9259;85;9174;LARCHER Robert;M;LARCHER;Robert;EXG;44
Législatives 2012 - 1er tour;Législatives;2012;1;7;7ème circonscription;33;GARCHES;92033;12412;5093;7319;98;7221;BLANCHARD Laurent;M;BLANCHARD;Laurent;AUT;70
Législatives 2012 - 1er tour;Législatives;2012;1;1;1ère circonscription;36;GENNEVILLIERS;92036;20795;10523;10272;192;10080;SABAN Muriel;F;SABAN;Muriel;NCE;0
Législatives 2012 - 1er tour;Législatives;2012;1;10;10ème circonscription;40;ISSY LES MOULINEAUX;92040;42014;16484;25530;277;25253;HESSE Frédéric;M;HESSE;Frédéric;AUT;11
Législatives 2012 - 1er tour;Législatives;2012;1;5;5ème circonscription;44;LEVALLOIS PERRET;92044;39546;14667;24879;238;24641;DELALLEAU François;M;DELALLEAU;François;FG;606
Législatives 2012 - 1er tour;Législatives;2012;1;11;11ème circonscription;46;MALAKOFF;92046;18858;7608;11250;119;11131;ROUILLAC Jean-Paul;M;ROUILLAC;Jean-Paul;EXG;30
Législatives 2012 - 1er tour;Législatives;2012;1;11;11ème circonscription;49;MONTROUGE;92049;27889;10680;17209;123;17086;ROUILLAC Jean-Paul;M;ROUILLAC;Jean-Paul;EXG;25
Législatives 2012 - 1er tour;Législatives;2012;1;11;11ème circonscription;49;MONTROUGE;92049;27889;10680;17209;123;17086;AARSSE Rodéric;M;AARSSE;Rodéric;VEC;654
Législatives 2012 - 1er tour;Législatives;2012;1;11;11ème circonscription;49;MONTROUGE;92049;27889;10680;17209;123;17086;BOURHIS Nadine;F;BOURHIS;Nadine;ECO;101
Législatives 2012 - 1er tour;Législatives;2012;1;11;11ème circonscription;49;MONTROUGE;92049;27889;10680;17209;123;17086;MARCEL Baptiste;M;MARCEL;Baptiste;AUT;307
Législatives 2012 - 1er tour;Législatives;2012;1;11;11ème circonscription;49;MONTROUGE;92049;27889;10680;17209;123;17086;METTON Jean-Loup;M;METTON;Jean-Loup;NCE;6153
Législatives 2012 - 1er tour;Législatives;2012;1;11;11ème circonscription;49;MONTROUGE;92049;27889;10680;17209;123;17086;HAUJARD Sébastien;M;HAUJARD;Sébastien;DVD;21
Législatives 2012 - 1er tour;Législatives;2012;1;4;4ème circonscription;50;NANTERRE;92050;44344;21046;23298;337;22961;PUJOL Nicolas;M;PUJOL;Nicolas;AUT;136
Législatives 2012 - 1er tour;Législatives;2012;1;6;6ème circonscription;62;PUTEAUX;92062;28253;11141;17112;441;16671;CARREAU Georges;M;CARREAU;Georges;AUT;42
Législatives 2012 - 1er tour;Législatives;2012;1;13;13ème circonscription;71;SCEAUX;92071;14395;5253;9142;70;9072;LE NEOUANNIC Pascale;F;LE NEOUANNIC;Pascale;FG;407
Législatives 2012 - 1er tour;Législatives;2012;1;8;8ème circonscription;72;SEVRES;92072;14861;5785;9076;101;8975;VIERA Lydia;F;VIERA;Lydia;ECO;5
Législatives 2012 - 1er tour;Législatives;2012;1;4;4ème circonscription;73;SURESNES;92073;26492;10723;15769;302;15467;PERRIN-BIDAN Stéphane;M;PERRIN-BIDAN;Stéphane;ECO;117
Législatives 2012 - 1er tour;Législatives;2012;1;8;8ème circonscription;76;VAUCRESSON;92076;6093;2463;3630;39;3591;LE BAUT Anne;F;LE BAUT;Anne;FN;245
Législatives 2012 - 1er tour;Législatives;2012;1;8;8ème circonscription;77;VILLE D'AVRAY;92077;7169;2468;4701;48;4653;PAILLARD Christophe;M;PAILLARD;Christophe;AUT;12
Législatives 2012 - 1er tour;Législatives;2012;1;1;1ère circonscription;78;VILLENEUVE LA GARENNE;92078;12349;6903;5446;131;5315;BEN M'BAREK Hassan;M;BEN M'BAREK;Hassan;AUT;82
Législatives 2012 - 2ème tour;Législatives;2012;2;7;7ème circonscription;33;GARCHES;92033;12412;5747;6665;240;6425;OLLIER Patrick;M;OLLIER;Patrick;UMP;4339
Législatives 2012 - 2ème tour;Législatives;2012;2;8;8ème circonscription;48;MEUDON;92048;25003;9964;15039;336;14703;LIME-BIFFE Catherine;F;LIME-BIFFE;Catherine;SOC;7346
Législatives 2002 - 2ème tour;Législatives;2002;2;2;2ème circonscription;25;COLOMBES;92025;16443;6093;10350;347;10003;AESCHLIMANN MANUEL;M;AESCHLIMANN;MANUEL;UMP;5966
Législatives 2002 - 2ème tour;Législatives;2002;2;11;11ème circonscription;49;MONTROUGE;92049;23590;9229;14361;389;13972;METTON JEAN-LOUP;M;METTON;JEAN-LOUP;UDF;7778
Présidentielles 1995 - 2ème tour;Présidentielles;1995;2;;;33;GARCHES;92033;11689;2199;9490;345;9145;JOSPIN LIONEL;M;JOSPIN;LIONEL;;6479
Présidentielles 1995 - 2ème tour;Présidentielles;1995;2;;;35;LA GARENNE COLOMBES;92035;14104;3230;10874;544;10330;CHIRAC JACQUES;M;CHIRAC;JACQUES;;4038
Présidentielles 1995 - 2ème tour;Présidentielles;1995;2;;;47;MARNES LA COQUETTE;92047;1003;153;850;41;809;CHIRAC JACQUES;M;CHIRAC;JACQUES;;661
Présidentielles 1995 - 2ème tour;Présidentielles;1995;2;;;72;SEVRES;92072;13745;2191;11554;433;11121;JOSPIN LIONEL;M;JOSPIN;LIONEL;;4607
Présidentielles 2002 - 2ème tour;Présidentielles;2002;2;;;2;ANTONY;92002;37045;5846;31199;1081;30118;CHIRAC JACQUES;M;CHIRAC;JACQUES;;26843
Présidentielles 2002 - 2ème tour;Présidentielles;2002;2;;;23;CLAMART;92023;31134;6910;24224;815;23409;CHIRAC JACQUES;M;CHIRAC;JACQUES;;20618
Présidentielles 2002 - 2ème tour;Présidentielles;2002;2;;;46;MALAKOFF;92046;17268;3858;13410;529;12881;CHIRAC JACQUES;M;CHIRAC;JACQUES;;11362
Présidentielles 2002 - 2ème tour;Présidentielles;2002;2;;;50;NANTERRE;92050;37592;8741;28851;1099;27752;CHIRAC JACQUES;M;CHIRAC;JACQUES;;23984
Présidentielles 1995 - 1er tour;Présidentielles;1995;1;;;75;VANVES;92075;15499;3343;12156;236;11920;CHEMINADE JACQUES;M;CHEMINADE;JACQUES;;37
Législatives 1993 - 1er tour;Législatives;1993;1;2;2ème circonscription;4;ASNIERES SUR SEINE;92004;37314;11544;25770;852;24918;MASSOL HUBERT;M;MASSOL;HUBERT;FRN;4459
Législatives 1993 - 1er tour;Législatives;1993;1;12;12ème circonscription;32;FONTENAY AUX ROSES;92032;15091;4963;10128;341;9787;DUMAS J.FRANCOIS;M;DUMAS;J.FRANCOIS;VEC;1076
Législatives 1993 - 1er tour;Législatives;1993;1;12;12ème circonscription;32;FONTENAY AUX ROSES;92032;15091;4963;10128;341;9787;COUTAT RICHARD;M;COUTAT;RICHARD;EXG;87
Législatives 1993 - 1er tour;Législatives;1993;1;1;1ère circonscription;25;COLOMBES;92025;26594;9512;17082;693;16389;GUICHARROUSSE HUBERT;M;GUICHARROUSSE;HUBERT;VEC;1426
Législatives 1993 - 1er tour;Législatives;1993;1;7;7ème circonscription;33;GARCHES;92033;11440;3330;8110;328;7782;DARBEL MADELEINE;F;DARBEL;MADELEINE;SOC;949
Législatives 1993 - 1er tour;Législatives;1993;1;8;8ème circonscription;47;MARNES LA COQUETTE;92047;1006;246;760;21;739;MARGUERITES HARRY;M;MARGUERITES;HARRY;MAJ;5
Législatives 1993 - 1er tour;Législatives;1993;1;11;11ème circonscription;46;MALAKOFF;92046;19559;6951;12608;416;12192;ROBERT ALAIN;M;ROBERT;ALAIN;RPR;3187
Législatives 1993 - 1er tour;Législatives;1993;1;7;7ème circonscription;63;RUEIL MALMAISON;92063;42219;12104;30115;1049;29066;DARBEL MADELEINE;F;DARBEL;MADELEINE;SOC;4205
Législatives 1993 - 1er tour;Législatives;1993;1;7;7ème circonscription;64;SAINT CLOUD;92064;19166;6250;12916;429;12487;GENSANNE MARIE;F;GENSANNE;MARIE;DIV;264
Législatives 1993 - 1er tour;Législatives;1993;1;7;7ème circonscription;64;SAINT CLOUD;92064;19166;6250;12916;429;12487;TRON ROGER;M;TRON;ROGER;DVD;333
Législatives 1993 - 1er tour;Législatives;1993;1;6;6ème circonscription;51;NEUILLY SUR SEINE;92051;35806;10146;25660;620;25040;GOUREVITCH ELISABETH;F;GOUREVITCH;ELISABETH;SOC;1791
Législatives 1993 - 1er tour;Législatives;1993;1;6;6ème circonscription;51;NEUILLY SUR SEINE;92051;35806;10146;25660;620;25040;ABECASSIS DENIS;M;ABECASSIS;DENIS;GEC;1302
Législatives 1993 - 1er tour;Législatives;1993;1;12;12ème circonscription;60;LE PLESSIS ROBINSON;92060;13118;4266;8852;315;8537;DUNG JURGEN;M;DUNG;JURGEN;MAJ;108
Législatives 1993 - 1er tour;Législatives;1993;1;3;3ème circonscription;9;BOIS COLOMBES;92009;14392;4251;10141;422;9719;MORIN GABRIEL;M;MORIN;GABRIEL;DIV;186
Législatives 1993 - 1er tour;Législatives;1993;1;13;13ème circonscription;14;BOURG LA REINE;92014;12754;4085;8669;303;8366;AUBRY ANDRE;M;AUBRY;ANDRE;COM;417
Législatives 1993 - 1er tour;Législatives;1993;1;3;3ème circonscription;9;BOIS COLOMBES;92009;14392;4251;10141;422;9719;HABY J.YVES;M;HABY;J.YVES;UDF;4302
Législatives 1993 - 1er tour;Législatives;1993;1;12;12ème circonscription;20;CHATILLON;92020;15705;4455;11250;435;10815;DUNG JURGEN;M;DUNG;JURGEN;MAJ;130
Législatives 1993 - 2ème tour;Législatives;1993;2;10;10ème circonscription;40;ISSY LES MOULINEAUX;92040;29377;10522;18855;1072;17783;BITON MARLENE;F;BITON;MARLENE;SOC;6251
Législatives 1993 - 2ème tour;Législatives;1993;2;10;10ème circonscription;48;MEUDON;92048;4225;1555;2670;149;2521;BITON MARLENE;F;BITON;MARLENE;SOC;1029
Législatives 1993 - 2ème tour;Législatives;1993;2;1;1ère circonscription;78;VILLENEUVE LA GARENNE;92078;11604;4389;7215;415;6800;PREVOT ROGER;M;PREVOT;ROGER;UDF;4214
Législatives 2017 - 1er tour;Législatives;2017;1;1;1ère circonscription;25;COLOMBES;92025;27867;16420;11447;405;11042;BRETON Michel;M;BRETON;Michel;EXG;124
Législatives 2017 - 1er tour;Législatives;2017;1;7;7ème circonscription;64;SAINT CLOUD;92064;19410;7490;11920;102;11818;MARILOSSIAN Jacques;M;MARILOSSIAN;Jacques;REM;5095
Législatives 2017 - 1er tour;Législatives;2017;1;8;8ème circonscription;72;SEVRES;92072;15144;6343;8801;149;8652;BOYER Gilles;M;BOYER;Gilles;LR;1819
Législatives 2017 - 1er tour;Législatives;2017;1;9;9ème circonscription;12;BOULOGNE BILLANCOURT;92012;64984;30321;34663;987;33676;DE THÉZY Claire;F;DE THÉZY;Claire;DVD;657
Législatives 2017 - 1er tour;Législatives;2017;1;10;10ème circonscription;40;ISSY LES MOULINEAUX;92040;45375;19009;26366;517;25849;AMOROZ Boris;M;AMOROZ;Boris;COM;220
Législatives 2017 - 1er tour;Législatives;2017;1;10;10ème circonscription;40;ISSY LES MOULINEAUX;92040;45375;19009;26366;517;25849;MALEYRE Anne-Laure;F;MALEYRE;Anne-Laure;FN;836
Législatives 2017 - 1er tour;Législatives;2017;1;10;10ème circonscription;75;VANVES;92075;18507;7626;10881;125;10756;LECOCQ Laurence;F;LECOCQ;Laurence;DIV;43
Législatives 2017 - 1er tour;Législatives;2017;1;11;11ème circonscription;46;MALAKOFF;92046;18448;8148;10300;133;10167;DE PABLO Carmelina;F;DE PABLO;Carmelina;ECO;343
Législatives 2017 - 1er tour;Législatives;2017;1;11;11ème circonscription;49;MONTROUGE;92049;28914;12071;16843;175;16668;DE PABLO Carmelina;F;DE PABLO;Carmelina;ECO;657
Législatives 2017 - 1er tour;Législatives;2017;1;12;12ème circonscription;20;CHATILLON;92020;22311;9527;12784;186;12598;GARCIA-BADIN Théo;M;GARCIA-BADIN;Théo;ECO;507
Législatives 2017 - 1er tour;Législatives;2017;1;12;12ème circonscription;20;CHATILLON;92020;22311;9527;12784;186;12598;PERDRIAULT Mathieu;M;PERDRIAULT;Mathieu;DIV;11
Législatives 2017 - 1er tour;Législatives;2017;1;12;12ème circonscription;23;CLAMART;92023;35342;15954;19388;238;19150;CANTAT Julien;M;CANTAT;Julien;DIV;94
Législatives 2017 - 1er tour;Législatives;2017;1;12;12ème circonscription;32;FONTENAY AUX ROSES;92032;16049;7756;8293;93;8200;PREVEL Guillaume;M;PREVEL;Guillaume;DIV;145
Législatives 2017 - 1er tour;Législatives;2017;1;12;12ème circonscription;32;FONTENAY AUX ROSES;92032;16049;7756;8293;93;8200;CANTAT Julien;M;CANTAT;Julien;DIV;45
Législatives 2017 - 1er tour;Législatives;2017;1;12;12ème circonscription;60;LE PLESSIS ROBINSON;92060;19154;7496;11658;130;11528;LEROY Christophe;M;LEROY;Christophe;COM;220
Législatives 2017 - 1er tour;Législatives;2017;1;13;13ème circonscription;14;BOURG LA REINE;92014;13736;5356;8380;81;8299;LANIER Benjamin;M;LANIER;Benjamin;SOC;442
Législatives 2017 - 1er tour;Législatives;2017;1;13;13ème circonscription;71;SCEAUX;92071;15078;6395;8683;84;8599;NICOLAS Cédric;M;NICOLAS;Cédric;DVD;99
Législatives 2017 - 2ème tour;Législatives;2017;2;2;2ème circonscription;25;COLOMBES;92025;19668;10150;9518;971;8547;TAQUET Adrien;M;TAQUET;Adrien;REM;5701
Législatives 2017 - 2ème tour;Législatives;2017;2;2;2ème circonscription;25;COLOMBES;92025;19668;10150;9518;971;8547;AESCHLIMANN Marie-Do;F;AESCHLIMANN;Marie-Do;LR;2846
Législatives 2017 - 2ème tour;Législatives;2017;2;3;3ème circonscription;35;LA GARENNE COLOMBES;92035;18829;9723;9106;579;8527;SPIRI Jean;M;SPIRI;Jean;LR;3679
Législatives 2017 - 1er tour;Législatives;2017;1;2;2ème circonscription;25;COLOMBES;92025;19668;8354;11314;229;11085;BEKKOUCHE Ilhame;F;BEKKOUCHE;Ilhame;DIV;72
Législatives 2017 - 1er tour;Législatives;2017;1;3;3ème circonscription;35;LA GARENNE COLOMBES;92035;18829;8238;10591;114;10477;PARRY Jean-Marie;M;PARRY;Jean-Marie;EXG;23
Législatives 2017 - 1er tour;Législatives;2017;1;4;4ème circonscription;50;NANTERRE;92050;47651;26455;21196;432;20764;EISENBERG Mathilde;F;EISENBERG;Mathilde;EXG;91
Législatives 2017 - 1er tour;Législatives;2017;1;3;3ème circonscription;9;BOIS COLOMBES;92009;17921;7869;10052;437;9615;DUMONT Eugénie;F;DUMONT;Eugénie;DIV;54
Législatives 2017 - 1er tour;Législatives;2017;1;3;3ème circonscription;9;BOIS COLOMBES;92009;17921;7869;10052;437;9615;ALLANIC Solène;F;ALLANIC;Solène;DIV;14
Législatives 2017 - 1er tour;Législatives;2017;1;1;1ère circonscription;78;VILLENEUVE LA GARENNE;92078;12445;8430;4015;143;3872;BORDREUIL Myriam;F;BORDREUIL;Myriam;DVD;9
Législatives 2017 - 1er tour;Législatives;2017;1;4;4ème circonscription;50;NANTERRE;92050;47651;26455;21196;432;20764;MORAIN Rossana;F;MORAIN;Rossana;FI;2289
Législatives 2017 - 1er tour;Législatives;2017;1;5;5ème circonscription;44;LEVALLOIS PERRET;92044;41751;17632;24119;255;23864;MONJOU Jean-Jacques;M;MONJOU;Jean-Jacques;DVD;218
Législatives 2017 - 1er tour;Législatives;2017;1;7;7ème circonscription;63;RUEIL MALMAISON;92063;54498;24335;30163;377;29786;POIZAT Vincent;M;POIZAT;Vincent;ECO;1737
Présidentielles 2002 - 1er tour;Présidentielles;2002;1;;;25;COLOMBES;92025;39608;13654;25954;571;25383;TAUBIRA CHRISTIANE;F;TAUBIRA;CHRISTIANE;;1095
Présidentielles 2002 - 1er tour;Présidentielles;2002;1;;;26;COURBEVOIE;92026;39941;11959;27982;520;27462;SAINT-JOSSE JEAN;M;SAINT-JOSSE;JEAN;;189
Présidentielles 2002 - 1er tour;Présidentielles;2002;1;;;32;FONTENAY AUX ROSES;92032;14148;4309;9839;204;9635;LE PEN JEAN-MARIE;M;LE PEN;JEAN-MARIE;;1036
Présidentielles 2002 - 1er tour;Présidentielles;2002;1;;;32;FONTENAY AUX ROSES;92032;14148;4309;9839;204;9635;BESANCENOT OLIVIER;M;BESANCENOT;OLIVIER;;340
Présidentielles 2002 - 1er tour;Présidentielles;2002;1;;;35;LA GARENNE COLOMBES;92035;15006;5167;9839;227;9612;LE PEN JEAN-MARIE;M;LE PEN;JEAN-MARIE;;1363
Présidentielles 2002 - 1er tour;Présidentielles;2002;1;;;35;LA GARENNE COLOMBES;92035;15006;5167;9839;227;9612;CHEVENEMENT JEAN-PIERRE;M;CHEVENEMENT;JEAN-PIERRE;;675
Présidentielles 2002 - 1er tour;Présidentielles;2002;1;;;44;LEVALLOIS PERRET;92044;33618;9640;23978;575;23403;TAUBIRA CHRISTIANE;F;TAUBIRA;CHRISTIANE;;575
Présidentielles 2002 - 2ème tour;Présidentielles;2002;2;;;35;LA GARENNE COLOMBES;92035;15006;3305;11701;396;11305;CHIRAC JACQUES;M;CHIRAC;JACQUES;;9785
Présidentielles 2002 - 2ème tour;Présidentielles;2002;2;;;35;LA GARENNE COLOMBES;92035;15006;3305;11701;396;11305;LE PEN JEAN-MARIE;M;LE PEN;JEAN-MARIE;;1520
Présidentielles 2002 - 2ème tour;Présidentielles;2002;2;;;49;MONTROUGE;92049;23382;5345;18037;640;17397;LE PEN JEAN-MARIE;M;LE PEN;JEAN-MARIE;;1979
Présidentielles 2002 - 2ème tour;Présidentielles;2002;2;;;76;VAUCRESSON;92076;5854;1104;4750;105;4645;CHIRAC JACQUES;M;CHIRAC;JACQUES;;4106
Présidentielles 2017 - 2ème tour;Présidentielles;2017;2;;;22;CHAVILLE;92022;13493;2674;10819;949;9870;MACRON Emmanuel;M;MACRON;Emmanuel;;8456
Présidentielles 2017 - 2ème tour;Présidentielles;2017;2;;;32;FONTENAY AUX ROSES;92032;16037;4490;11547;953;10594;MACRON Emmanuel;M;MACRON;Emmanuel;;9009
Présidentielles 2017 - 2ème tour;Présidentielles;2017;2;;;35;LA GARENNE COLOMBES;92035;18826;4037;14789;1357;13432;LE PEN Marine;F;LE PEN;Marine;;1972
Présidentielles 2017 - 2ème tour;Présidentielles;2017;2;;;77;VILLE D'AVRAY;92077;7433;1235;6198;479;5719;MACRON Emmanuel;M;MACRON;Emmanuel;;5053
Présidentielles 2007 - 2ème tour;Présidentielles;2007;2;;;24;CLICHY;92024;28548;4867;23681;799;22882;ROYAL Ségolène;F;ROYAL;Ségolène;;13609
Présidentielles 2007 - 2ème tour;Présidentielles;2007;2;;;48;MEUDON;92048;29950;4524;25426;928;24498;ROYAL Ségolène;F;ROYAL;Ségolène;;11072
Présidentielles 2007 - 2ème tour;Présidentielles;2007;2;;;64;SAINT CLOUD;92064;18486;2227;16259;511;15748;ROYAL Ségolène;F;ROYAL;Ségolène;;4067
Présidentielles 2012 - 2ème tour;Présidentielles;2012;2;;;24;CLICHY;92024;29241;6073;23168;958;22210;SARKOZY Nicolas;M;SARKOZY;Nicolas;;7343
Présidentielles 2012 - 2ème tour;Présidentielles;2012;2;;;40;ISSY LES MOULINEAUX;92040;41994;8151;33843;1548;32295;SARKOZY Nicolas;M;SARKOZY;Nicolas;;15609
Présidentielles 2012 - 2ème tour;Présidentielles;2012;2;;;48;MEUDON;92048;30598;5278;25320;925;24395;HOLLANDE François;M;HOLLANDE;François;;12273
Présidentielles 2012 - 2ème tour;Présidentielles;2012;2;;;62;PUTEAUX;92062;28241;4967;23274;1020;22254;SARKOZY Nicolas;M;SARKOZY;Nicolas;;11780
Législatives 2007 - 2ème tour;Législatives;2007;2;12;12ème circonscription;23;CLAMART;92023;32915;12101;20814;545;20269;KALTENBACH Philippe;M;KALTENBACH;Philippe;SOC;9888
Législatives 2007 - 1er tour;Législatives;2007;1;8;8ème circonscription;77;VILLE D'AVRAY;92077;7475;2429;5046;60;4986;DEQUEANT Annie;F;DEQUEANT;Annie;FN;111
Législatives 2007 - 1er tour;Législatives;2007;1;11;11ème circonscription;7;BAGNEUX;92007;20520;8538;11982;178;11804;DADARE Sébastien;M;DADARE;Sébastien;DIV;122
Législatives 2007 - 1er tour;Législatives;2007;1;3;3ème circonscription;9;BOIS COLOMBES;92009;16245;6561;9684;288;9396;CARILLON Rémi;M;CARILLON;Rémi;FN;247
Législatives 2007 - 1er tour;Législatives;2007;1;7;7ème circonscription;64;SAINT CLOUD;92064;19115;6812;12303;93;12210;BITTERLIN Anne;F;BITTERLIN;Anne;ECO;64
Législatives 2007 - 1er tour;Législatives;2007;1;3;3ème circonscription;26;COURBEVOIE;92026;49151;19345;29806;541;29265;DERAMBARSH Arash;M;DERAMBARSH;Arash;DVD;538
Législatives 2007 - 1er tour;Législatives;2007;1;11;11ème circonscription;49;MONTROUGE;92049;26595;9698;16897;213;16684;GALATEAU Marie-Thérèse;F;GALATEAU;Marie-Thérèse;EXD;162
Législatives 2007 - 1er tour;Législatives;2007;1;6;6ème circonscription;51;NEUILLY SUR SEINE;92051;39134;14738;24396;185;24211;CORTI Martine;F;CORTI;Martine;ECO;123
Législatives 2007 - 1er tour;Législatives;2007;1;5;5ème circonscription;44;LEVALLOIS PERRET;92044;39466;14724;24742;404;24338;DUTILLOY Marie-Catherine;F;DUTILLOY;Marie-Catherine;ECO;191
Législatives 2007 - 1er tour;Législatives;2007;1;11;11ème circonscription;46;MALAKOFF;92046;18478;7045;11433;204;11229;SAUVANAUD Juliette;F;SAUVANAUD;Juliette;EXG;54
Législatives 2007 - 1er tour;Législatives;2007;1;1;1ère circonscription;25;COLOMBES;92025;26192;12273;13919;366;13553;RABIER Marie-Cécile;F;RABIER;Marie-Cécile;FN;497
Législatives 2007 - 1er tour;Législatives;2007;1;12;12ème circonscription;23;CLAMART;92023;32916;11487;21429;154;21275;DIAZ GOMEZ Elisabeth;F;DIAZ GOMEZ;Elisabeth;DIV;0
Législatives 2007 - 1er tour;Législatives;2007;1;12;12ème circonscription;20;CHATILLON;92020;20661;7083;13578;137;13441;SCHMITT Jean-Pierre;M;SCHMITT;Jean-Pierre;FN;347
Législatives 2007 - 1er tour;Législatives;2007;1;2;2ème circonscription;25;COLOMBES;92025;18336;7144;11192;207;10985;VALLET Guillaume;M;VALLET;Guillaume;DIV;10
Législatives 2007 - 1er tour;Législatives;2007;1;1;1ère circonscription;25;COLOMBES;92025;26192;12273;13919;366;13553;BINDER Sylvain;M;BINDER;Sylvain;DIV;44
Législatives 2007 - 1er tour;Législatives;2007;1;5;5ème circonscription;24;CLICHY;92024;28799;12380;16419;297;16122;BOUAKKA Lakdar;M;BOUAKKA;Lakdar;DIV;169
Législatives 2007 - 1er tour;Législatives;2007;1;10;10ème circonscription;12;BOULOGNE BILLANCOURT;92012;5551;2367;3184;78;3106;GINISTY Christophe;M;GINISTY;Christophe;UDFD;304
Législatives 2007 - 1er tour;Législatives;2007;1;10;10ème circonscription;12;BOULOGNE BILLANCOURT;92012;5551;2367;3184;78;3106;BOTTET Philippe;M;BOTTET;Philippe;EXG;17
Législatives 2007 - 1er tour;Législatives;2007;1;13;13ème circonscription;14;BOURG LA REINE;92014;13381;4391;8990;78;8912;GOURDOL Aimée;F;GOURDOL;Aimée;DVG;79
Législatives 2007 - 1er tour;Législatives;2007;1;12;12ème circonscription;20;CHATILLON;92020;20661;7083;13578;137;13441;CHABRAN Isabelle;F;CHABRAN;Isabelle;VEC;510
Législatives 2007 - 1er tour;Législatives;2007;1;12;12ème circonscription;60;LE PLESSIS ROBINSON;92060;16776;5588;11188;123;11065;DELVITTO Denis;M;DELVITTO;Denis;DIV;0
Législatives 2007 - 1er tour;Législatives;2007;1;6;6ème circonscription;62;PUTEAUX;92062;26791;8829;17962;396;17566;STRAUSS Anne-Christine;F;STRAUSS;Anne-Christine;FN;652
Législatives 2007 - 1er tour;Législatives;2007;1;7;7ème circonscription;63;RUEIL MALMAISON;92063;51481;18902;32579;337;32242;NAERT Jeannine;F;NAERT;Jeannine;FN;848
Législatives 2007 - 1er tour;Législatives;2007;1;10;10ème circonscription;40;ISSY LES MOULINEAUX;92040;38520;14017;24503;359;24144;NAVIAUX Catherine;F;NAVIAUX;Catherine;VEC;836
Législatives 2007 - 1er tour;Législatives;2007;1;10;10ème circonscription;40;ISSY LES MOULINEAUX;92040;38520;14017;24503;359;24144;VIGUIE Laurence;F;VIGUIE;Laurence;EXG;97
Législatives 2007 - 1er tour;Législatives;2007;1;1;1ère circonscription;36;GENNEVILLIERS;92036;20048;9522;10526;189;10337;VIGNON Véronique;F;VIGNON;Véronique;UMP;1914
Législatives 2007 - 1er tour;Législatives;2007;1;10;10ème circonscription;48;MEUDON;92048;5066;1864;3202;29;3173;VENTURINI Jean-Michel;M;VENTURINI;Jean-Michel;DIV;0
Législatives 2007 - 1er tour;Législatives;2007;1;8;8ème circonscription;48;MEUDON;92048;25427;9683;15744;202;15542;BOUCHARD Renaud;M;BOUCHARD;Renaud;DIV;12
Législatives 2007 - 2ème tour;Législatives;2007;2;12;12ème circonscription;60;LE PLESSIS ROBINSON;92060;16773;6008;10765;223;10542;KALTENBACH Philippe;M;KALTENBACH;Philippe;SOC;3885
Législatives 2017 - 1er tour;Législatives;2017;1;2;2ème circonscription;4;ASNIERES SUR SEINE;92004;48340;22557;25783;414;25369;BEKKOUCHE Ilhame;F;BEKKOUCHE;Ilhame;DIV;172
Législatives 2017 - 2ème tour;Législatives;2017;2;3;3ème circonscription;26;COURBEVOIE;92026;44322;23241;21081;1513;19568;HENNION Christine;F;HENNION;Christine;REM;11283
Législatives 2017 - 2ème tour;Législatives;2017;2;8;8ème circonscription;72;SEVRES;92072;15144;7789;7355;638;6717;MAIRE Jacques;M;MAIRE;Jacques;REM;4351
Législatives 2007 - 1er tour;Législatives;2007;1;4;4ème circonscription;73;SURESNES;92073;24666;8949;15717;206;15511;BONNECHERE Nathalie;F;BONNECHERE;Nathalie;FN;501
Législatives 2007 - 1er tour;Législatives;2007;1;8;8ème circonscription;76;VAUCRESSON;92076;6076;2206;3870;46;3824;ROY Caroline;F;ROY;Caroline;RDG;426
Législatives 2002 - 1er tour;Législatives;2002;1;6;6ème circonscription;62;PUTEAUX;92062;26791;8829;17962;396;17566;JEANNE Nadine;F;JEANNE;Nadine;SOC;3422
Législatives 2002 - 1er tour;Législatives;2002;1;13;13ème circonscription;71;SCEAUX;92071;14129;4679;9450;74;9376;BENLOLO Martine;F;BENLOLO;Martine;EXG;26
Législatives 2002 - 1er tour;Législatives;2002;1;13;13ème circonscription;71;SCEAUX;92071;14129;4679;9450;74;9376;BASTIDE Anne;F;BASTIDE;Anne;ECO;85
Législatives 2002 - 1er tour;Législatives;2002;1;4;4ème circonscription;73;SURESNES;92073;24666;8949;15717;206;15511;DUPUY Christian;M;DUPUY;Christian;UMP;8209
Législatives 2002 - 1er tour;Législatives;2002;1;8;8ème circonscription;76;VAUCRESSON;92076;6076;2206;3870;46;3824;SUCHARD Sophie;F;SUCHARD;Sophie;EXG;2
Législatives 2002 - 1er tour;Législatives;2002;1;8;8ème circonscription;77;VILLE D'AVRAY;92077;7475;2429;5046;60;4986;GUILLET Jean-Jacques;M;GUILLET;Jean-Jacques;UMP;2933
Législatives 2002 - 2ème tour;Législatives;2002;2;11;11ème circonscription;7;BAGNEUX;92007;18569;7336;11233;358;10875;METTON JEAN-LOUP;M;METTON;JEAN-LOUP;UDF;4763
Législatives 2002 - 2ème tour;Législatives;2002;2;4;4ème circonscription;73;SURESNES;92073;22358;8411;13947;387;13560;FRAYSSE JACQUELINE;F;FRAYSSE;JACQUELINE;COM;5133
Législatives 1997 - 2ème tour;Législatives;1997;2;13;13ème circonscription;71;SCEAUX;92071;13168;3546;9622;450;9172;MERLE J.FRANCOIS;M;MERLE;J.FRANCOIS;SOC;3415
Législatives 2012 - 1er tour;Législatives;2012;1;4;4ème circonscription;73;SURESNES;92073;26492;10723;15769;302;15467;MARTIN Brieuc;M;MARTIN;Brieuc;AUT;50
Législatives 2012 - 1er tour;Législatives;2012;1;8;8ème circonscription;77;VILLE D'AVRAY;92077;7169;2468;4701;48;4653;LIME-BIFFE Catherine;F;LIME-BIFFE;Catherine;SOC;1212
Législatives 1997 - 2ème tour;Législatives;1997;2;8;8ème circonscription;76;VAUCRESSON;92076;5541;1696;3845;155;3690;LEVAIN JEAN;M;LEVAIN;JEAN;PRS;877
Législatives 2012 - 2ème tour;Législatives;2012;2;13;13ème circonscription;19;CHATENAY MALABRY;92019;17908;6693;11215;367;10848;DEVEDJIAN Patrick;M;DEVEDJIAN;Patrick;UMP;5076
Législatives 2012 - 2ème tour;Législatives;2012;2;8;8ème circonscription;22;CHAVILLE;92022;12808;4743;8065;184;7881;GUILLET Jean-Jacques;M;GUILLET;Jean-Jacques;UMP;3994
Législatives 2012 - 2ème tour;Législatives;2012;2;12;12ème circonscription;32;FONTENAY AUX ROSES;92032;15232;6027;9205;223;8982;GERMAIN Jean-Marc;M;GERMAIN;Jean-Marc;SOC;5275
Législatives 2012 - 2ème tour;Législatives;2012;2;11;11ème circonscription;49;MONTROUGE;92049;27889;11155;16734;283;16451;METTON Jean-Loup;M;METTON;Jean-Loup;NCE;7475
Législatives 2002 - 1er tour;Législatives;2002;1;2;2ème circonscription;4;ASNIERES SUR SEINE;92004;44110;17783;26327;312;26015;FISCHER Josiane;F;FISCHER;Josiane;DVD;953
Législatives 2002 - 1er tour;Législatives;2002;1;11;11ème circonscription;7;BAGNEUX;92007;20520;8538;11982;178;11804;AMIABLE Marie-Hélène;F;AMIABLE;Marie-Hélène;COM;4753
Législatives 2002 - 1er tour;Législatives;2002;1;11;11ème circonscription;7;BAGNEUX;92007;20520;8538;11982;178;11804;BONJEAN Hubert;M;BONJEAN;Hubert;FN;433
Législatives 2002 - 1er tour;Législatives;2002;1;10;10ème circonscription;12;BOULOGNE BILLANCOURT;92012;5551;2367;3184;78;3106;VIGUIE Laurence;F;VIGUIE;Laurence;EXG;38
Législatives 2002 - 1er tour;Législatives;2002;1;13;13ème circonscription;19;CHATENAY MALABRY;92019;17835;6584;11251;211;11040;FONTAN Huguette;F;FONTAN;Huguette;DIV;14
Législatives 2002 - 1er tour;Législatives;2002;1;13;13ème circonscription;19;CHATENAY MALABRY;92019;17835;6584;11251;211;11040;BRAULT Chantal;F;BRAULT;Chantal;UDFD;1394
Législatives 2012 - 1er tour;Législatives;2012;1;13;13ème circonscription;2;ANTONY;92002;40941;15088;25853;361;25492;FEUILLADE Fabien;M;FEUILLADE;Fabien;VEC;2846
Législatives 2012 - 1er tour;Législatives;2012;1;9;9ème circonscription;12;BOULOGNE BILLANCOURT;92012;61020;24579;36441;340;36101;BLANC Philippe;M;BLANC;Philippe;AUT;465
Législatives 2012 - 1er tour;Législatives;2012;1;10;10ème circonscription;12;BOULOGNE BILLANCOURT;92012;6600;2912;3688;126;3562;KNITTEL Gautier;M;KNITTEL;Gautier;AUT;33
Législatives 2012 - 1er tour;Législatives;2012;1;13;13ème circonscription;14;BOURG LA REINE;92014;13305;4436;8869;87;8782;LE NEOUANNIC Pascale;F;LE NEOUANNIC;Pascale;FG;433
Législatives 2012 - 1er tour;Législatives;2012;1;13;13ème circonscription;19;CHATENAY MALABRY;92019;17908;6775;11133;210;10923;ROLLOT Franck;M;ROLLOT;Franck;EXG;39
Législatives 2012 - 1er tour;Législatives;2012;1;13;13ème circonscription;19;CHATENAY MALABRY;92019;17908;6775;11133;210;10923;LANDFRIED Julien;M;LANDFRIED;Julien;DVG;3729
Législatives 2012 - 1er tour;Législatives;2012;1;5;5ème circonscription;24;CLICHY;92024;29276;13521;15755;274;15481;DUTILLOY Marie-Catherine;F;DUTILLOY;Marie-Catherine;ECO;153
Législatives 2012 - 1er tour;Législatives;2012;1;1;1ère circonscription;25;COLOMBES;92025;26337;13144;13193;209;12984;AZIZOUDINE Yasmine;F;AZIZOUDINE;Yasmine;AUT;109
Législatives 2012 - 1er tour;Législatives;2012;1;2;2ème circonscription;25;COLOMBES;92025;18458;7115;11343;114;11229;AESCHLIMANN Manuel;M;AESCHLIMANN;Manuel;UMP;2799
Législatives 2012 - 1er tour;Législatives;2012;1;6;6ème circonscription;26;COURBEVOIE;92026;8123;3742;4381;140;4241;MAYHEAD Ioanna;F;MAYHEAD;Ioanna;FG;173
Législatives 2012 - 1er tour;Législatives;2012;1;7;7ème circonscription;33;GARCHES;92033;12412;5093;7319;98;7221;CHAUDON Anne-Laure;F;CHAUDON;Anne-Laure;EXG;25
Législatives 2012 - 1er tour;Législatives;2012;1;1;1ère circonscription;36;GENNEVILLIERS;92036;20795;10523;10272;192;10080;BRETON Michel;M;BRETON;Michel;EXG;55
Législatives 2012 - 1er tour;Législatives;2012;1;1;1ère circonscription;36;GENNEVILLIERS;92036;20795;10523;10272;192;10080;DESACHY Anne-Marie;F;DESACHY;Anne-Marie;AUT;24
Législatives 2012 - 1er tour;Législatives;2012;1;10;10ème circonscription;40;ISSY LES MOULINEAUX;92040;42014;16484;25530;277;25253;PIEUCHOT Laurent;M;PIEUCHOT;Laurent;DVG;4231
Législatives 2012 - 1er tour;Législatives;2012;1;11;11ème circonscription;46;MALAKOFF;92046;18858;7608;11250;119;11131;LE DEVEHAT Jean-Luc;M;LE DEVEHAT;Jean-Luc;EXG;25
Législatives 2012 - 1er tour;Législatives;2012;1;10;10ème circonscription;48;MEUDON;92048;5576;2083;3493;26;3467;PIEUCHOT Laurent;M;PIEUCHOT;Laurent;DVG;372
Législatives 2012 - 1er tour;Législatives;2012;1;4;4ème circonscription;50;NANTERRE;92050;44344;21046;23298;337;22961;PERRIN-BIDAN Stéphane;M;PERRIN-BIDAN;Stéphane;ECO;100
Législatives 2012 - 1er tour;Législatives;2012;1;6;6ème circonscription;51;NEUILLY SUR SEINE;92051;37031;14672;22359;177;22182;GAUJARD Caroline;F;GAUJARD;Caroline;EXG;21
Législatives 2012 - 1er tour;Législatives;2012;1;7;7ème circonscription;63;RUEIL MALMAISON;92063;52518;20526;31992;298;31694;LAPORTE Lucia;F;LAPORTE;Lucia;FN;2168
Législatives 2012 - 1er tour;Législatives;2012;1;4;4ème circonscription;73;SURESNES;92073;26492;10723;15769;302;15467;FRAYSSE Jacqueline;F;FRAYSSE;Jacqueline;FG;2347
Législatives 2002 - 1er tour;Législatives;2002;1;5;5ème circonscription;24;CLICHY;92024;28799;12380;16419;297;16122;LAMBERT Mireille;F;LAMBERT;Mireille;EXG;148
Législatives 2002 - 1er tour;Législatives;2002;1;2;2ème circonscription;25;COLOMBES;92025;18336;7144;11192;207;10985;TRUPIN Laurent;M;TRUPIN;Laurent;UDFD;1193
Législatives 2002 - 1er tour;Législatives;2002;1;12;12ème circonscription;32;FONTENAY AUX ROSES;92032;15468;5605;9863;84;9779;BENARD Paul;M;BENARD;Paul;EXG;44
Législatives 2002 - 1er tour;Législatives;2002;1;7;7ème circonscription;33;GARCHES;92033;12286;4601;7685;112;7573;TERRAZZONI Valérie;F;TERRAZZONI;Valérie;DIV;36
Législatives 2002 - 1er tour;Législatives;2002;1;7;7ème circonscription;33;GARCHES;92033;12286;4601;7685;112;7573;DE VAUREIX Anne;F;DE VAUREIX;Anne;MPF;83
Législatives 2002 - 1er tour;Législatives;2002;1;7;7ème circonscription;33;GARCHES;92033;12286;4601;7685;112;7573;NAERT Jeannine;F;NAERT;Jeannine;FN;237
Législatives 2002 - 1er tour;Législatives;2002;1;3;3ème circonscription;35;LA GARENNE COLOMBES;92035;16552;5947;10605;101;10504;LASSERRE Jean-André;M;LASSERRE;Jean-André;SOC;1882
Législatives 2002 - 1er tour;Législatives;2002;1;5;5ème circonscription;44;LEVALLOIS PERRET;92044;39466;14724;24742;404;24338;CUCULIERE Roger;M;CUCULIERE;Roger;EXD;79
Législatives 2002 - 1er tour;Législatives;2002;1;11;11ème circonscription;46;MALAKOFF;92046;18478;7045;11433;204;11229;DE PABLO Carmelina;F;DE PABLO;Carmelina;VEC;465
Législatives 2002 - 1er tour;Législatives;2002;1;10;10ème circonscription;48;MEUDON;92048;5066;1864;3202;29;3173;BINDER Sabrina;F;BINDER;Sabrina;DIV;36
Législatives 2002 - 1er tour;Législatives;2002;1;11;11ème circonscription;49;MONTROUGE;92049;26595;9698;16897;213;16684;TEIXEIRA Dominique;M;TEIXEIRA;Dominique;EXG;45
Législatives 2002 - 1er tour;Législatives;2002;1;6;6ème circonscription;62;PUTEAUX;92062;26791;8829;17962;396;17566;HARMAND Alexandre;M;HARMAND;Alexandre;UDFD;1921
Législatives 2002 - 1er tour;Législatives;2002;1;7;7ème circonscription;63;RUEIL MALMAISON;92063;51481;18902;32579;337;32242;NAERT Jeannine;F;NAERT;Jeannine;FN;848
Législatives 2002 - 1er tour;Législatives;2002;1;7;7ème circonscription;64;SAINT CLOUD;92064;19115;6812;12303;93;12210;DE VAUREIX Anne;F;DE VAUREIX;Anne;MPF;133
Législatives 2002 - 1er tour;Législatives;2002;1;7;7ème circonscription;64;SAINT CLOUD;92064;19115;6812;12303;93;12210;NAERT Jeannine;F;NAERT;Jeannine;FN;503
Législatives 2002 - 1er tour;Législatives;2002;1;13;13ème circonscription;71;SCEAUX;92071;14129;4679;9450;74;9376;FIE Dominique;M;FIE;Dominique;COM;134
Législatives 2002 - 1er tour;Législatives;2002;1;8;8ème circonscription;72;SEVRES;92072;14460;5279;9181;151;9030;CYROULNIK Marie-France;F;CYROULNIK;Marie-France;EXG;127
Législatives 1997 - 1er tour;Législatives;1997;1;11;11ème circonscription;46;MALAKOFF;92046;19124;7233;11891;338;11553;SABATIE FRANCOISE;F;SABATIE;FRANCOISE;DVG;16
Législatives 1997 - 1er tour;Législatives;1997;1;1;1ère circonscription;36;GENNEVILLIERS;92036;19277;7226;12051;295;11756;ORGET GERARD;M;ORGET;GERARD;EXD;73
Législatives 1997 - 1er tour;Législatives;1997;1;5;5ème circonscription;44;LEVALLOIS PERRET;92044;28281;9315;18966;650;18316;BENOIT LUC;M;BENOIT;LUC;EXG;62
Législatives 1997 - 1er tour;Législatives;1997;1;2;2ème circonscription;25;COLOMBES;92025;17603;6110;11493;415;11078;TAITTINGER FRANTZ;M;TAITTINGER;FRANTZ;RPR;3868
Législatives 1997 - 1er tour;Législatives;1997;1;13;13ème circonscription;71;SCEAUX;92071;13168;3887;9281;266;9015;RIVIERE ALAIN;M;RIVIERE;ALAIN;DVD;395
Législatives 1997 - 1er tour;Législatives;1997;1;8;8ème circonscription;72;SEVRES;92072;13776;4413;9363;352;9011;AMSALLEM EDDY;M;AMSALLEM;EDDY;EXG;139
Législatives 1997 - 1er tour;Législatives;1997;1;13;13ème circonscription;14;BOURG LA REINE;92014;12587;4431;8156;266;7890;LE NET HERVE;M;LE NET;HERVE;DVD;54
Législatives 1997 - 1er tour;Législatives;1997;1;1;1ère circonscription;78;VILLENEUVE LA GARENNE;92078;11471;4645;6826;211;6615;MUSSAT PHILIPPE;M;MUSSAT;PHILIPPE;EXG;62
Législatives 1997 - 1er tour;Législatives;1997;1;1;1ère circonscription;78;VILLENEUVE LA GARENNE;92078;11471;4645;6826;211;6615;ROBERT ALAIN;M;ROBERT;ALAIN;RPR;1306
Législatives 1997 - 1er tour;Législatives;1997;1;8;8ème circonscription;77;VILLE D'AVRAY;92077;7112;2283;4829;139;4690;LEVAIN JEAN;M;LEVAIN;JEAN;PRS;796
Législatives 1997 - 2ème tour;Législatives;1997;2;11;11ème circonscription;7;BAGNEUX;92007;20284;7017;13267;700;12567;METTON J.LOUP;M;METTON;J.LOUP;UDF;4748
Législatives 1997 - 1er tour;Législatives;1997;1;12;12ème circonscription;32;FONTENAY AUX ROSES;92032;14748;4655;10093;259;9834;BREITBURD NICOLAS;M;BREITBURD;NICOLAS;DVD;137
Législatives 1997 - 1er tour;Législatives;1997;1;4;4ème circonscription;73;SURESNES;92073;20985;7217;13768;441;13327;DEMERCASTEL CHRISTIAN;M;DEMERCASTEL;CHRISTIAN;ECO;469
Législatives 1997 - 1er tour;Législatives;1997;1;4;4ème circonscription;73;SURESNES;92073;20985;7217;13768;441;13327;DUPUY CHRISTIAN;M;DUPUY;CHRISTIAN;RPR;5303
Législatives 1997 - 1er tour;Législatives;1997;1;4;4ème circonscription;73;SURESNES;92073;20985;7217;13768;441;13327;TREPPOZ ROMAIN;M;TREPPOZ;ROMAIN;EXG;40
Législatives 1997 - 1er tour;Législatives;1997;1;10;10ème circonscription;75;VANVES;92075;15446;4682;10764;329;10435;HERVO DIDIER;M;HERVO;DIDIER;ECO;435
Législatives 2002 - 2ème tour;Législatives;2002;2;10;10ème circonscription;12;BOULOGNE BILLANCOURT;92012;4747;2219;2528;80;2448;SCHMID LUCILE;F;SCHMID;LUCILE;SOC;1152
Législatives 2002 - 2ème tour;Législatives;2002;2;12;12ème circonscription;20;CHATILLON;92020;18170;6361;11809;330;11479;BAVAY FRANCINE;F;BAVAY;FRANCINE;VEC;5446
Législatives 2002 - 2ème tour;Législatives;2002;2;10;10ème circonscription;75;VANVES;92075;15596;5503;10093;285;9808;SCHMID LUCILE;F;SCHMID;LUCILE;SOC;4338
Législatives 2002 - 2ème tour;Législatives;2002;2;8;8ème circonscription;77;VILLE D'AVRAY;92077;7417;2822;4595;216;4379;GUILLET J.JACQUES;M;GUILLET;J.JACQUES;UMP;3040
Législatives 1997 - 1er tour;Législatives;1997;1;3;3ème circonscription;35;LA GARENNE COLOMBES;92035;13992;5163;8829;294;8535;MERRHEIM J.CHRISTOPHE;M;MERRHEIM;J.CHRISTOPHE;DIV;0
Législatives 1997 - 1er tour;Législatives;1997;1;8;8ème circonscription;47;MARNES LA COQUETTE;92047;985;289;696;19;677;BALLOT LENA CAROLINE;F;BALLOT LENA;CAROLINE;DVD;31
Législatives 1997 - 1er tour;Législatives;1997;1;10;10ème circonscription;40;ISSY LES MOULINEAUX;92040;30164;10899;19265;543;18722;WELLENSTEIN CYRIL;M;WELLENSTEIN;CYRIL;DVD;211
Législatives 1997 - 1er tour;Législatives;1997;1;7;7ème circonscription;63;RUEIL MALMAISON;92063;44715;14813;29902;1094;28808;GIROUD JEAN;M;GIROUD;JEAN;DVG;622
Législatives 1997 - 2ème tour;Législatives;1997;2;5;5ème circonscription;44;LEVALLOIS PERRET;92044;28281;8240;20041;1147;18894;LALUMIERE CATHERINE;F;LALUMIERE;CATHERINE;PRS;8109
Législatives 1997 - 1er tour;Législatives;1997;1;1;1ère circonscription;36;GENNEVILLIERS;92036;19277;7226;12051;295;11756;DRUYER J.JACQUES;M;DRUYER;J.JACQUES;DVG;167
Législatives 1997 - 2ème tour;Législatives;1997;2;1;1ère circonscription;25;COLOMBES;92025;26234;9506;16728;1637;15091;LE GALLOU J.YVES;M;LE GALLOU;J.YVES;FRN;5126
Législatives 1997 - 2ème tour;Législatives;1997;2;2;2ème circonscription;25;COLOMBES;92025;17596;5371;12225;649;11576;FRAGER DOMINIQUE;M;FRAGER;DOMINIQUE;ECO;4988
Législatives 1997 - 1er tour;Législatives;1997;1;11;11ème circonscription;7;BAGNEUX;92007;20284;7388;12896;374;12522;BASSINET PHILIPPE;M;BASSINET;PHILIPPE;SOC;2168
Législatives 1993 - 2ème tour;Législatives;1993;2;4;4ème circonscription;50;NANTERRE;92050;38008;11176;26832;1311;25521;DUPUY CHRISTIAN;M;DUPUY;CHRISTIAN;RPR;12118
Législatives 2012 - 2ème tour;Législatives;2012;2;9;9ème circonscription;12;BOULOGNE BILLANCOURT;92012;61020;25102;35918;564;35354;SOLERE Thierry;M;SOLERE;Thierry;DVD;13912
Législatives 1997 - 1er tour;Législatives;1997;1;9;9ème circonscription;12;BOULOGNE BILLANCOURT;92012;53287;18902;34385;948;33437;QUILGARS J.PIERRE;M;QUILGARS;J.PIERRE;COM;1128
Législatives 2012 - 1er tour;Législatives;2012;1;7;7ème circonscription;33;GARCHES;92033;12412;5093;7319;98;7221;HOSTEINS Olivier;M;HOSTEINS;Olivier;CEN;287
Législatives 2012 - 1er tour;Législatives;2012;1;11;11ème circonscription;46;MALAKOFF;92046;18858;7608;11250;119;11131;AARSSE Rodéric;M;AARSSE;Rodéric;VEC;436
Législatives 2012 - 1er tour;Législatives;2012;1;10;10ème circonscription;48;MEUDON;92048;5576;2083;3493;26;3467;KNITTEL Gautier;M;KNITTEL;Gautier;AUT;44
Législatives 2012 - 1er tour;Législatives;2012;1;4;4ème circonscription;50;NANTERRE;92050;44344;21046;23298;337;22961;DJAZIRI Yacine;M;DJAZIRI;Yacine;SOC;5036
Législatives 2012 - 1er tour;Législatives;2012;1;6;6ème circonscription;51;NEUILLY SUR SEINE;92051;37031;14672;22359;177;22182;LECLERC Monique;F;LECLERC;Monique;EXG;14
Législatives 2012 - 1er tour;Législatives;2012;1;12;12ème circonscription;60;LE PLESSIS ROBINSON;92060;18785;6274;12511;101;12410;CARRASCO Julia;F;CARRASCO;Julia;DVD;56
Législatives 2012 - 1er tour;Législatives;2012;1;6;6ème circonscription;62;PUTEAUX;92062;28253;11141;17112;441;16671;GRANGER Marie;F;GRANGER;Marie;AUT;0
Législatives 2012 - 1er tour;Législatives;2012;1;8;8ème circonscription;72;SEVRES;92072;14861;5785;9076;101;8975;MORDELET-CARRIERE Nadia;F;MORDELET-CARRIERE;Nadia;CEN;314
Législatives 2012 - 1er tour;Législatives;2012;1;8;8ème circonscription;76;VAUCRESSON;92076;6093;2463;3630;39;3591;SEGUI Miguel;M;SEGUI;Miguel;EXG;3
Législatives 2012 - 1er tour;Législatives;2012;1;8;8ème circonscription;77;VILLE D'AVRAY;92077;7169;2468;4701;48;4653;MORDELET-CARRIERE Nadia;F;MORDELET-CARRIERE;Nadia;CEN;240
Législatives 2012 - 1er tour;Législatives;2012;1;1;1ère circonscription;78;VILLENEUVE LA GARENNE;92078;12349;6903;5446;131;5315;MOURRE Odile;F;MOURRE;Odile;EXG;7
Législatives 2012 - 1er tour;Législatives;2012;1;1;1ère circonscription;78;VILLENEUVE LA GARENNE;92078;12349;6903;5446;131;5315;HALEM Taoufik;M;HALEM;Taoufik;VEC;85
Législatives 1997 - 1er tour;Législatives;1997;1;12;12ème circonscription;32;FONTENAY AUX ROSES;92032;14748;4655;10093;259;9834;SCRIVE SIMON;M;SCRIVE;SIMON;ECO;463
Législatives 1997 - 1er tour;Législatives;1997;1;11;11ème circonscription;49;MONTROUGE;92049;21975;7943;14032;388;13644;RAKETITCH RAOUL;M;RAKETITCH;RAOUL;FRN;1624
Législatives 1997 - 1er tour;Législatives;1997;1;4;4ème circonscription;50;NANTERRE;92050;38533;13799;24734;766;23968;SCHMIT MICHEL;M;SCHMIT;MICHEL;FRN;3580
Législatives 1997 - 1er tour;Législatives;1997;1;6;6ème circonscription;51;NEUILLY SUR SEINE;92051;35571;12347;23224;570;22654;BUTON LUCIENNE;F;BUTON;LUCIENNE;SOC;2083
Législatives 1997 - 1er tour;Législatives;1997;1;6;6ème circonscription;51;NEUILLY SUR SEINE;92051;35571;12347;23224;570;22654;RIBES GILBERT;M;RIBES;GILBERT;DVD;153
Législatives 1997 - 1er tour;Législatives;1997;1;7;7ème circonscription;64;SAINT CLOUD;92064;18908;7095;11813;417;11396;SUJEVIC J.GABRIEL;M;SUJEVIC;J.GABRIEL;DVD;19
Législatives 1997 - 1er tour;Législatives;1997;1;13;13ème circonscription;71;SCEAUX;92071;13168;3887;9281;266;9015;PARLANGE AGNES;F;PARLANGE;AGNES;EXG;22
Législatives 2012 - 1er tour;Législatives;2012;1;2;2ème circonscription;4;ASNIERES SUR SEINE;92004;45114;18545;26569;310;26259;AESCHLIMANN Manuel;M;AESCHLIMANN;Manuel;UMP;7558
Législatives 2012 - 1er tour;Législatives;2012;1;9;9ème circonscription;12;BOULOGNE BILLANCOURT;92012;61020;24579;36441;340;36101;JANISSET Hélène;F;JANISSET;Hélène;EXG;37
Législatives 2012 - 1er tour;Législatives;2012;1;8;8ème circonscription;22;CHAVILLE;92022;12808;4688;8120;75;8045;MORDELET-CARRIERE Nadia;F;MORDELET-CARRIERE;Nadia;CEN;327
Législatives 2012 - 1er tour;Législatives;2012;1;8;8ème circonscription;22;CHAVILLE;92022;12808;4688;8120;75;8045;LE BAUT Anne;F;LE BAUT;Anne;FN;537
Législatives 1997 - 1er tour;Législatives;1997;1;13;13ème circonscription;19;CHATENAY MALABRY;92019;17859;6462;11397;367;11030;PARLANGE AGNES;F;PARLANGE;AGNES;EXG;68
Législatives 1997 - 1er tour;Législatives;1997;1;10;10ème circonscription;75;VANVES;92075;15446;4682;10764;329;10435;LOUSTAU AXEL;M;LOUSTAU;AXEL;FRN;1048
Législatives 1997 - 2ème tour;Législatives;1997;2;5;5ème circonscription;24;CLICHY;92024;23725;7917;15808;893;14915;LALUMIERE CATHERINE;F;LALUMIERE;CATHERINE;PRS;8368
Législatives 2012 - 2ème tour;Législatives;2012;2;10;10ème circonscription;48;MEUDON;92048;5576;2204;3372;54;3318;SANTINI André;M;SANTINI;André;NCE;1653
Législatives 2002 - 1er tour;Législatives;2002;1;2;2ème circonscription;4;ASNIERES SUR SEINE;92004;44110;17783;26327;312;26015;VILLIERS Claire;F;VILLIERS;Claire;EXG;439
Législatives 2002 - 1er tour;Législatives;2002;1;2;2ème circonscription;4;ASNIERES SUR SEINE;92004;44110;17783;26327;312;26015;VALLET Guillaume;M;VALLET;Guillaume;DIV;0
Législatives 2002 - 1er tour;Législatives;2002;1;2;2ème circonscription;4;ASNIERES SUR SEINE;92004;44110;17783;26327;312;26015;POURBAGHER Francis;M;POURBAGHER;Francis;DVD;647
Législatives 2002 - 1er tour;Législatives;2002;1;11;11ème circonscription;7;BAGNEUX;92007;20520;8538;11982;178;11804;DADARE Sébastien;M;DADARE;Sébastien;DIV;122
Législatives 2002 - 1er tour;Législatives;2002;1;3;3ème circonscription;9;BOIS COLOMBES;92009;16245;6561;9684;288;9396;BARNONCEL Michel;M;BARNONCEL;Michel;VEC;245
Législatives 2002 - 1er tour;Législatives;2002;1;3;3ème circonscription;9;BOIS COLOMBES;92009;16245;6561;9684;288;9396;DERAMBARSH Arash;M;DERAMBARSH;Arash;DVD;87
Législatives 2002 - 1er tour;Législatives;2002;1;9;9ème circonscription;12;BOULOGNE BILLANCOURT;92012;60773;22422;38351;535;37816;LORBER Anne-Charlotte;F;LORBER;Anne-Charlotte;MPF;420
Législatives 2002 - 1er tour;Législatives;2002;1;13;13ème circonscription;14;BOURG LA REINE;92014;13381;4391;8990;78;8912;HOLLEBEKE Dominique;F;HOLLEBEKE;Dominique;MPF;126
Législatives 2002 - 1er tour;Législatives;2002;1;13;13ème circonscription;19;CHATENAY MALABRY;92019;17835;6584;11251;211;11040;DEVEDJIAN Patrick;M;DEVEDJIAN;Patrick;UMP;4938
Législatives 2002 - 1er tour;Législatives;2002;1;8;8ème circonscription;22;CHAVILLE;92022;12928;4682;8246;120;8126;SUCHARD Sophie;F;SUCHARD;Sophie;EXG;38
Législatives 2002 - 1er tour;Législatives;2002;1;8;8ème circonscription;22;CHAVILLE;92022;12928;4682;8246;120;8126;RAFFALI Danielle;F;RAFFALI;Danielle;ECO;81
Législatives 2002 - 1er tour;Législatives;2002;1;5;5ème circonscription;24;CLICHY;92024;28799;12380;16419;297;16122;BALKANY Patrick;M;BALKANY;Patrick;UMP;3709
Législatives 2002 - 1er tour;Législatives;2002;1;5;5ème circonscription;24;CLICHY;92024;28799;12380;16419;297;16122;MUZEAU Rémi;M;MUZEAU;Rémi;DVD;1848
Législatives 2002 - 1er tour;Législatives;2002;1;5;5ème circonscription;24;CLICHY;92024;28799;12380;16419;297;16122;CUCULIERE Roger;M;CUCULIERE;Roger;EXD;53
Législatives 2002 - 1er tour;Législatives;2002;1;1;1ère circonscription;25;COLOMBES;92025;26192;12273;13919;366;13553;MUZEAU Roland;M;MUZEAU;Roland;COM;2003
Législatives 2002 - 1er tour;Législatives;2002;1;1;1ère circonscription;25;COLOMBES;92025;26192;12273;13919;366;13553;LEGHMARA Leïla;F;LEGHMARA;Leïla;UDFD;1154
Législatives 2002 - 1er tour;Législatives;2002;1;3;3ème circonscription;26;COURBEVOIE;92026;49151;19345;29806;541;29265;BARNONCEL Michel;M;BARNONCEL;Michel;VEC;882
Législatives 2002 - 1er tour;Législatives;2002;1;12;12ème circonscription;32;FONTENAY AUX ROSES;92032;15468;5605;9863;84;9779;DELVITTO Denis;M;DELVITTO;Denis;DIV;0
Législatives 2002 - 1er tour;Législatives;2002;1;7;7ème circonscription;33;GARCHES;92033;12286;4601;7685;112;7573;CHOLLOU Sylvia;F;CHOLLOU;Sylvia;DIV;5
Législatives 2002 - 1er tour;Législatives;2002;1;3;3ème circonscription;35;LA GARENNE COLOMBES;92035;16552;5947;10605;101;10504;ROYON Francine;F;ROYON;Francine;EXG;208
Législatives 2002 - 1er tour;Législatives;2002;1;10;10ème circonscription;40;ISSY LES MOULINEAUX;92040;38520;14017;24503;359;24144;HOCINI Malek;M;HOCINI;Malek;DIV;88
Législatives 2002 - 1er tour;Législatives;2002;1;8;8ème circonscription;47;MARNES LA COQUETTE;92047;1074;316;758;5;753;LUCET Francis;M;LUCET;Francis;EXG;0
Législatives 2002 - 1er tour;Législatives;2002;1;4;4ème circonscription;50;NANTERRE;92050;42631;18721;23910;314;23596;ZEBDI-GHORAB Faouzia;F;ZEBDI-GHORAB;Faouzia;DIV;692
Législatives 2002 - 1er tour;Législatives;2002;1;12;12ème circonscription;60;LE PLESSIS ROBINSON;92060;16776;5588;11188;123;11065;KALTENBACH Philippe;M;KALTENBACH;Philippe;SOC;2450
Législatives 2002 - 1er tour;Législatives;2002;1;12;12ème circonscription;60;LE PLESSIS ROBINSON;92060;16776;5588;11188;123;11065;SCHMITT Jean-Pierre;M;SCHMITT;Jean-Pierre;FN;223
Législatives 2002 - 1er tour;Législatives;2002;1;7;7ème circonscription;64;SAINT CLOUD;92064;19115;6812;12303;93;12210;OLLIER Patrick;M;OLLIER;Patrick;UMP;7942
Législatives 2002 - 1er tour;Législatives;2002;1;1;1ère circonscription;78;VILLENEUVE LA GARENNE;92078;13038;7211;5827;131;5696;DENJEAN Jean-Marc;M;DENJEAN;Jean-Marc;VEC;151
Législatives 2002 - 2ème tour;Législatives;2002;2;13;13ème circonscription;14;BOURG LA REINE;92014;12244;4159;8085;226;7859;DEVEDJIAN PATRICK;M;DEVEDJIAN;PATRICK;UMP;4634
Législatives 2002 - 2ème tour;Législatives;2002;2;5;5ème circonscription;44;LEVALLOIS PERRET;92044;34014;10618;23396;339;23057;CHAZEAUX DE OLIVIER;M;CHAZEAUX DE;OLIVIER;UMP;8077
Législatives 2002 - 2ème tour;Législatives;2002;2;13;13ème circonscription;71;SCEAUX;92071;13108;4352;8756;232;8524;DEVEDJIAN PATRICK;M;DEVEDJIAN;PATRICK;UMP;5220
Législatives 2002 - 2ème tour;Législatives;2002;2;10;10ème circonscription;75;VANVES;92075;15596;5503;10093;285;9808;SANTINI ANDRE;M;SANTINI;ANDRE;UDF;5470
Législatives 1997 - 1er tour;Législatives;1997;1;8;8ème circonscription;48;MEUDON;92048;24248;8136;16112;629;15483;GUILLET J.JACQUES;M;GUILLET;J.JACQUES;RPR;5663
Législatives 1997 - 2ème tour;Législatives;1997;2;8;8ème circonscription;47;MARNES LA COQUETTE;92047;985;279;706;33;673;LEVAIN JEAN;M;LEVAIN;JEAN;PRS;132
Législatives 1997 - 1er tour;Législatives;1997;1;7;7ème circonscription;33;GARCHES;92033;11323;3745;7578;290;7288;ARIA D LUIGI;M;ARIA D;LUIGI;DIV;0
Législatives 1997 - 1er tour;Législatives;1997;1;12;12ème circonscription;32;FONTENAY AUX ROSES;92032;14748;4655;10093;259;9834;MORILLERE DENIS;M;MORILLERE;DENIS;DIV;0
Législatives 1997 - 1er tour;Législatives;1997;1;1;1ère circonscription;36;GENNEVILLIERS;92036;19277;7226;12051;295;11756;GAZEAU STEPHANE;M;GAZEAU;STEPHANE;DIV;0
Législatives 1997 - 1er tour;Législatives;1997;1;1;1ère circonscription;36;GENNEVILLIERS;92036;19277;7226;12051;295;11756;MICHON SYLVAIN;M;MICHON;SYLVAIN;EXG;74
Législatives 1997 - 2ème tour;Législatives;1997;2;4;4ème circonscription;73;SURESNES;92073;20985;6153;14832;688;14144;DUPUY CHRISTIAN;M;DUPUY;CHRISTIAN;RPR;8183
Présidentielles 2017 - 1er tour;Présidentielles;2017;1;;;9;BOIS COLOMBES;92009;17896;3242;14654;318;14336;FILLON François;M;FILLON;François;;4139
Présidentielles 2017 - 1er tour;Présidentielles;2017;1;;;25;COLOMBES;92025;47454;9714;37740;907;36833;MÉLENCHON Jean-Luc;M;MÉLENCHON;Jean-Luc;;9346
Présidentielles 2017 - 1er tour;Présidentielles;2017;1;;;35;LA GARENNE COLOMBES;92035;18828;3121;15707;289;15418;ASSELINEAU François;M;ASSELINEAU;François;;158
Présidentielles 2017 - 1er tour;Présidentielles;2017;1;;;35;LA GARENNE COLOMBES;92035;18828;3121;15707;289;15418;FILLON François;M;FILLON;François;;5043
Présidentielles 2017 - 1er tour;Présidentielles;2017;1;;;44;LEVALLOIS PERRET;92044;41716;6107;35609;511;35098;MACRON Emmanuel;M;MACRON;Emmanuel;;11062
Présidentielles 2017 - 1er tour;Présidentielles;2017;1;;;64;SAINT CLOUD;92064;19370;2628;16742;186;16556;LASSALLE Jean;M;LASSALLE;Jean;;100
Présidentielles 2017 - 1er tour;Présidentielles;2017;1;;;73;SURESNES;92073;28497;4342;24155;520;23635;FILLON François;M;FILLON;François;;6984
Présidentielles 2017 - 1er tour;Présidentielles;2017;1;;;75;VANVES;92075;18500;3228;15272;248;15024;POUTOU Philippe;M;POUTOU;Philippe;;84
Présidentielles 2017 - 1er tour;Présidentielles;2017;1;;;78;VILLENEUVE LA GARENNE;92078;12429;3872;8557;315;8242;ASSELINEAU François;M;ASSELINEAU;François;;154
Présidentielles 2017 - 2ème tour;Présidentielles;2017;2;;;4;ASNIERES SUR SEINE;92004;48242;11098;37144;2982;34162;MACRON Emmanuel;M;MACRON;Emmanuel;;29710
Législatives 2007 - 1er tour;Législatives;2007;1;2;2ème circonscription;4;ASNIERES SUR SEINE;92004;44110;17783;26327;312;26015;ECH-CHETOUANI Zouhairr;M;ECH-CHETOUANI;Zouhairr;DIV;365
Législatives 2007 - 1er tour;Législatives;2007;1;2;2ème circonscription;4;ASNIERES SUR SEINE;92004;44110;17783;26327;312;26015;MASSOL Hubert;M;MASSOL;Hubert;EXD;282
Législatives 2007 - 1er tour;Législatives;2007;1;13;13ème circonscription;2;ANTONY;92002;39807;13942;25865;456;25409;CANET Michèle;F;CANET;Michèle;SOC;5861
Législatives 2007 - 1er tour;Législatives;2007;1;13;13ème circonscription;2;ANTONY;92002;39807;13942;25865;456;25409;FIE Dominique;M;FIE;Dominique;COM;791
Législatives 2007 - 1er tour;Législatives;2007;1;11;11ème circonscription;46;MALAKOFF;92046;18478;7045;11433;204;11229;KADRI Malika;F;KADRI;Malika;DIV;56
Législatives 2007 - 1er tour;Législatives;2007;1;8;8ème circonscription;47;MARNES LA COQUETTE;92047;1074;316;758;5;753;RAFFALI Danielle;F;RAFFALI;Danielle;ECO;6
Législatives 2007 - 1er tour;Législatives;2007;1;11;11ème circonscription;49;MONTROUGE;92049;26595;9698;16897;213;16684;SAUVANAUD Juliette;F;SAUVANAUD;Juliette;EXG;58
Législatives 2007 - 1er tour;Législatives;2007;1;4;4ème circonscription;50;NANTERRE;92050;42631;18721;23910;314;23596;BONNECHERE Nathalie;F;BONNECHERE;Nathalie;FN;902
Législatives 2007 - 1er tour;Législatives;2007;1;7;7ème circonscription;63;RUEIL MALMAISON;92063;51481;18902;32579;337;32242;ROCHERON Bertrand;M;ROCHERON;Bertrand;SOC;5632
Législatives 2007 - 1er tour;Législatives;2007;1;10;10ème circonscription;75;VANVES;92075;17351;5929;11422;137;11285;BOTTET Philippe;M;BOTTET;Philippe;EXG;52
Législatives 2007 - 1er tour;Législatives;2007;1;8;8ème circonscription;76;VAUCRESSON;92076;6076;2206;3870;46;3824;GONNET Nicolas;M;GONNET;Nicolas;COM;20
Législatives 2007 - 1er tour;Législatives;2007;1;8;8ème circonscription;77;VILLE D'AVRAY;92077;7475;2429;5046;60;4986;LEGRAND Pauline;F;LEGRAND;Pauline;EXD;28
Législatives 2007 - 1er tour;Législatives;2007;1;1;1ère circonscription;78;VILLENEUVE LA GARENNE;92078;13038;7211;5827;131;5696;JEAN Yves;M;JEAN;Yves;DVD;18
Législatives 2007 - 2ème tour;Législatives;2007;2;13;13ème circonscription;14;BOURG LA REINE;92014;13381;5115;8266;250;8016;CANET Michèle;F;CANET;Michèle;SOC;3666
Législatives 2007 - 2ème tour;Législatives;2007;2;13;13ème circonscription;14;BOURG LA REINE;92014;13381;5115;8266;250;8016;DEVEDJIAN Patrick;M;DEVEDJIAN;Patrick;UMP;4350
Législatives 2007 - 2ème tour;Législatives;2007;2;1;1ère circonscription;25;COLOMBES;92025;26192;13032;13160;475;12685;MUZEAU Roland;M;MUZEAU;Roland;COM;7508
Législatives 2007 - 2ème tour;Législatives;2007;2;12;12ème circonscription;32;FONTENAY AUX ROSES;92032;15467;6190;9277;173;9104;KALTENBACH Philippe;M;KALTENBACH;Philippe;SOC;4881
Législatives 2007 - 1er tour;Législatives;2007;1;7;7ème circonscription;33;GARCHES;92033;12286;4601;7685;112;7573;BORNETTE Bernard;M;BORNETTE;Bernard;EXD;25
Législatives 2007 - 1er tour;Législatives;2007;1;7;7ème circonscription;33;GARCHES;92033;12286;4601;7685;112;7573;OLLIER Patrick;M;OLLIER;Patrick;UMP;4768
Législatives 2007 - 1er tour;Législatives;2007;1;9;9ème circonscription;12;BOULOGNE BILLANCOURT;92012;60773;22422;38351;535;37816;BRUNET Françoise;F;BRUNET;Françoise;EXG;101
Législatives 2007 - 1er tour;Législatives;2007;1;2;2ème circonscription;25;COLOMBES;92025;18336;7144;11192;207;10985;SEMOUN Jean-Jacques;M;SEMOUN;Jean-Jacques;DVD;50
Législatives 2007 - 1er tour;Législatives;2007;1;12;12ème circonscription;23;CLAMART;92023;32916;11487;21429;154;21275;DELMATTO Geneviève;F;DELMATTO;Geneviève;EXD;64
Législatives 2007 - 1er tour;Législatives;2007;1;1;1ère circonscription;25;COLOMBES;92025;26192;12273;13919;366;13553;KADUR Alexandre;M;KADUR;Alexandre;DVD;42
Législatives 2007 - 1er tour;Législatives;2007;1;12;12ème circonscription;23;CLAMART;92023;32916;11487;21429;154;21275;LARCHER Robert;M;LARCHER;Robert;EXG;88
Législatives 2007 - 1er tour;Législatives;2007;1;12;12ème circonscription;23;CLAMART;92023;32916;11487;21429;154;21275;BRILLON Freddy;M;BRILLON;Freddy;DVD;73
Législatives 2007 - 1er tour;Législatives;2007;1;5;5ème circonscription;44;LEVALLOIS PERRET;92044;39466;14724;24742;404;24338;LAMBERT Mireille;F;LAMBERT;Mireille;EXG;80
Législatives 2007 - 1er tour;Législatives;2007;1;13;13ème circonscription;14;BOURG LA REINE;92014;13381;4391;8990;78;8912;DEVEDJIAN Patrick;M;DEVEDJIAN;Patrick;UMP;3910
Législatives 2007 - 1er tour;Législatives;2007;1;9;9ème circonscription;12;BOULOGNE BILLANCOURT;92012;60773;22422;38351;535;37816;PAGEARD Michel;M;PAGEARD;Michel;EXD;89
Législatives 2007 - 1er tour;Législatives;2007;1;13;13ème circonscription;19;CHATENAY MALABRY;92019;17835;6584;11251;211;11040;DELRIEU Denis;M;DELRIEU;Denis;VEC;427
Législatives 2007 - 1er tour;Législatives;2007;1;12;12ème circonscription;20;CHATILLON;92020;20661;7083;13578;137;13441;DELVITTO Denis;M;DELVITTO;Denis;DIV;0
Présidentielles 2002 - 1er tour;Présidentielles;2002;1;;;2;ANTONY;92002;36989;11047;25942;517;25425;JOSPIN LIONEL;M;JOSPIN;LIONEL;;4705
Présidentielles 2002 - 1er tour;Présidentielles;2002;1;;;7;BAGNEUX;92007;18489;5873;12616;519;12097;LAGUILLER ARLETTE;F;LAGUILLER;ARLETTE;;706
Présidentielles 2002 - 1er tour;Présidentielles;2002;1;;;20;CHATILLON;92020;18067;5487;12580;295;12285;BOUTIN CHRISTINE;F;BOUTIN;CHRISTINE;;123
Présidentielles 2002 - 1er tour;Présidentielles;2002;1;;;32;FONTENAY AUX ROSES;92032;14148;4309;9839;204;9635;GLUCKSTEIN DANIEL;M;GLUCKSTEIN;DANIEL;;47
Présidentielles 2002 - 1er tour;Présidentielles;2002;1;;;35;LA GARENNE COLOMBES;92035;15006;5167;9839;227;9612;LAGUILLER ARLETTE;F;LAGUILLER;ARLETTE;;388
Présidentielles 2002 - 1er tour;Présidentielles;2002;1;;;36;GENNEVILLIERS;92036;18213;6933;11280;303;10977;CHIRAC JACQUES;M;CHIRAC;JACQUES;;1370
Présidentielles 2002 - 1er tour;Présidentielles;2002;1;;;36;GENNEVILLIERS;92036;18213;6933;11280;303;10977;TAUBIRA CHRISTIANE;F;TAUBIRA;CHRISTIANE;;645
Présidentielles 2002 - 1er tour;Présidentielles;2002;1;;;36;GENNEVILLIERS;92036;18213;6933;11280;303;10977;MADELIN ALAIN;M;MADELIN;ALAIN;;222
Présidentielles 2002 - 1er tour;Présidentielles;2002;1;;;36;GENNEVILLIERS;92036;18213;6933;11280;303;10977;LAGUILLER ARLETTE;F;LAGUILLER;ARLETTE;;796
Présidentielles 2002 - 1er tour;Présidentielles;2002;1;;;44;LEVALLOIS PERRET;92044;33618;9640;23978;575;23403;MADELIN ALAIN;M;MADELIN;ALAIN;;1920
Présidentielles 2002 - 1er tour;Présidentielles;2002;1;;;46;MALAKOFF;92046;17268;6020;11248;271;10977;LAGUILLER ARLETTE;F;LAGUILLER;ARLETTE;;609
Présidentielles 2002 - 1er tour;Présidentielles;2002;1;;;62;PUTEAUX;92062;23861;6804;17057;487;16570;LE PEN JEAN-MARIE;M;LE PEN;JEAN-MARIE;;2276
Présidentielles 2002 - 1er tour;Présidentielles;2002;1;;;62;PUTEAUX;92062;23861;6804;17057;487;16570;HUE ROBERT;M;HUE;ROBERT;;329
Présidentielles 2002 - 1er tour;Présidentielles;2002;1;;;64;SAINT CLOUD;92064;17818;6028;11790;141;11649;CHIRAC JACQUES;M;CHIRAC;JACQUES;;3814
Présidentielles 2002 - 1er tour;Présidentielles;2002;1;;;72;SEVRES;92072;13367;4140;9227;153;9074;CHIRAC JACQUES;M;CHIRAC;JACQUES;;2036
Présidentielles 2002 - 1er tour;Présidentielles;2002;1;;;72;SEVRES;92072;13367;4140;9227;153;9074;JOSPIN LIONEL;M;JOSPIN;LIONEL;;1699
Présidentielles 2002 - 1er tour;Présidentielles;2002;1;;;77;VILLE D'AVRAY;92077;7251;2486;4765;70;4695;SAINT-JOSSE JEAN;M;SAINT-JOSSE;JEAN;;38
Présidentielles 2002 - 1er tour;Présidentielles;2002;1;;;78;VILLENEUVE LA GARENNE;92078;11406;4746;6660;180;6480;MEGRET BRUNO;M;MEGRET;BRUNO;;182
Présidentielles 2007 - 1er tour;Présidentielles;2007;1;;;12;BOULOGNE BILLANCOURT;92012;64709;7685;57024;546;56478;VOYNET Dominique;F;VOYNET;Dominique;;673
Présidentielles 2007 - 1er tour;Présidentielles;2007;1;;;14;BOURG LA REINE;92014;13108;1436;11672;90;11582;BESANCENOT Olivier;M;BESANCENOT;Olivier;;223
Présidentielles 2007 - 1er tour;Présidentielles;2007;1;;;19;CHATENAY MALABRY;92019;17598;2318;15280;229;15051;BAYROU François;M;BAYROU;François;;3195
Présidentielles 2007 - 1er tour;Présidentielles;2007;1;;;24;CLICHY;92024;28539;4472;24067;245;23822;BESANCENOT Olivier;M;BESANCENOT;Olivier;;880
Présidentielles 2007 - 1er tour;Présidentielles;2007;1;;;24;CLICHY;92024;28539;4472;24067;245;23822;BAYROU François;M;BAYROU;François;;4624
Présidentielles 2007 - 1er tour;Présidentielles;2007;1;;;24;CLICHY;92024;28539;4472;24067;245;23822;de VILLIERS Philippe;M;de VILLIERS;Philippe;;261
Présidentielles 2007 - 1er tour;Présidentielles;2007;1;;;26;COURBEVOIE;92026;48308;7118;41190;456;40734;LE PEN Jean-Marie;M;LE PEN;Jean-Marie;;2161
Présidentielles 2007 - 1er tour;Présidentielles;2007;1;;;32;FONTENAY AUX ROSES;92032;15234;2027;13207;123;13084;de VILLIERS Philippe;M;de VILLIERS;Philippe;;177
Présidentielles 2007 - 1er tour;Présidentielles;2007;1;;;44;LEVALLOIS PERRET;92044;38708;4734;33974;296;33678;NIHOUS Frédéric;M;NIHOUS;Frédéric;;55
Présidentielles 2007 - 1er tour;Présidentielles;2007;1;;;47;MARNES LA COQUETTE;92047;1054;91;963;9;954;de VILLIERS Philippe;M;de VILLIERS;Philippe;;25
Présidentielles 2007 - 1er tour;Présidentielles;2007;1;;;48;MEUDON;92048;29936;4129;25807;223;25584;LAGUILLER Arlette;F;LAGUILLER;Arlette;;202
Présidentielles 2007 - 1er tour;Présidentielles;2007;1;;;51;NEUILLY SUR SEINE;92051;37647;4032;33615;154;33461;LAGUILLER Arlette;F;LAGUILLER;Arlette;;49
Présidentielles 2007 - 1er tour;Présidentielles;2007;1;;;77;VILLE D'AVRAY;92077;7253;672;6581;57;6524;LAGUILLER Arlette;F;LAGUILLER;Arlette;;26
Présidentielles 2012 - 1er tour;Présidentielles;2012;1;;;4;ASNIERES SUR SEINE;92004;45042;9279;35763;516;35247;DUPONT-AIGNAN Nicolas;M;DUPONT-AIGNAN;Nicolas;;476
Présidentielles 2012 - 1er tour;Présidentielles;2012;1;;;9;BOIS COLOMBES;92009;16746;3612;13134;231;12903;JOLY Eva;F;JOLY;Eva;;422
Présidentielles 2012 - 1er tour;Présidentielles;2012;1;;;19;CHATENAY MALABRY;92019;17914;3466;14448;325;14123;ARTHAUD Nathalie;F;ARTHAUD;Nathalie;;50
Présidentielles 2012 - 1er tour;Présidentielles;2012;1;;;25;COLOMBES;92025;44741;10181;34560;526;34034;HOLLANDE François;M;HOLLANDE;François;;12052
Présidentielles 2012 - 1er tour;Présidentielles;2012;1;;;35;LA GARENNE COLOMBES;92035;17300;3509;13791;212;13579;SARKOZY Nicolas;M;SARKOZY;Nicolas;;5412
Présidentielles 2012 - 1er tour;Présidentielles;2012;1;;;44;LEVALLOIS PERRET;92044;39497;7296;32201;438;31763;ARTHAUD Nathalie;F;ARTHAUD;Nathalie;;58
Présidentielles 2012 - 1er tour;Présidentielles;2012;1;;;46;MALAKOFF;92046;18852;4162;14690;207;14483;ARTHAUD Nathalie;F;ARTHAUD;Nathalie;;78
Présidentielles 2012 - 1er tour;Présidentielles;2012;1;;;47;MARNES LA COQUETTE;92047;1082;163;919;8;911;JOLY Eva;F;JOLY;Eva;;18
Présidentielles 2012 - 1er tour;Présidentielles;2012;1;;;47;MARNES LA COQUETTE;92047;1082;163;919;8;911;POUTOU Philippe;M;POUTOU;Philippe;;6
Présidentielles 2012 - 1er tour;Présidentielles;2012;1;;;51;NEUILLY SUR SEINE;92051;37003;5964;31039;257;30782;ARTHAUD Nathalie;F;ARTHAUD;Nathalie;;22
Présidentielles 2012 - 1er tour;Présidentielles;2012;1;;;51;NEUILLY SUR SEINE;92051;37003;5964;31039;257;30782;BAYROU François;M;BAYROU;François;;2292
Présidentielles 2012 - 1er tour;Présidentielles;2012;1;;;62;PUTEAUX;92062;28189;5597;22592;470;22122;LE PEN Marine;F;LE PEN;Marine;;2306
Présidentielles 2012 - 1er tour;Présidentielles;2012;1;;;75;VANVES;92075;17512;3079;14433;161;14272;SARKOZY Nicolas;M;SARKOZY;Nicolas;;4118
Présidentielles 2012 - 1er tour;Présidentielles;2012;1;;;77;VILLE D'AVRAY;92077;7132;1060;6072;80;5992;HOLLANDE François;M;HOLLANDE;François;;1303
Présidentielles 2012 - 1er tour;Présidentielles;2012;1;;;78;VILLENEUVE LA GARENNE;92078;12332;3328;9004;225;8779;DUPONT-AIGNAN Nicolas;M;DUPONT-AIGNAN;Nicolas;;111
Présidentielles 1995 - 1er tour;Présidentielles;1995;1;;;40;ISSY LES MOULINEAUX;92040;30054;8139;21915;444;21471;CHEMINADE JACQUES;M;CHEMINADE;JACQUES;;57
Présidentielles 1995 - 1er tour;Présidentielles;1995;1;;;46;MALAKOFF;92046;19489;5677;13812;258;13554;LE PEN J.MARIE;M;LE PEN;J.MARIE;;1596
Présidentielles 1995 - 1er tour;Présidentielles;1995;1;;;9;BOIS COLOMBES;92009;14922;3871;11051;199;10852;BALLADUR EDOUARD;M;BALLADUR;EDOUARD;;2243
Présidentielles 1995 - 1er tour;Présidentielles;1995;1;;;60;LE PLESSIS ROBINSON;92060;13056;3285;9771;199;9572;CHIRAC JACQUES;M;CHIRAC;JACQUES;;2300
Présidentielles 1995 - 1er tour;Présidentielles;1995;1;;;49;MONTROUGE;92049;22293;5924;16369;314;16055;VILLIERS DE PHILIPPE;M;VILLIERS DE;PHILIPPE;;499
Présidentielles 1995 - 1er tour;Présidentielles;1995;1;;;62;PUTEAUX;92062;24192;6165;18027;379;17648;LAGUILLER ARLETTE;F;LAGUILLER;ARLETTE;;919
Présidentielles 1995 - 1er tour;Présidentielles;1995;1;;;73;SURESNES;92073;21968;5851;16117;341;15776;CHEMINADE JACQUES;M;CHEMINADE;JACQUES;;31
Présidentielles 1995 - 1er tour;Présidentielles;1995;1;;;64;SAINT CLOUD;92064;18989;5119;13870;179;13691;LE PEN J.MARIE;M;LE PEN;J.MARIE;;1205
Présidentielles 1995 - 1er tour;Présidentielles;1995;1;;;72;SEVRES;92072;13745;2869;10876;183;10693;LE PEN J.MARIE;M;LE PEN;J.MARIE;;899
Présidentielles 2012 - 2ème tour;Présidentielles;2012;2;;;2;ANTONY;92002;40240;6143;34097;1586;32511;HOLLANDE François;M;HOLLANDE;François;;16989
Présidentielles 2012 - 2ème tour;Présidentielles;2012;2;;;7;BAGNEUX;92007;20577;4195;16382;728;15654;HOLLANDE François;M;HOLLANDE;François;;11158
Présidentielles 2012 - 2ème tour;Présidentielles;2012;2;;;12;BOULOGNE BILLANCOURT;92012;67629;11051;56578;2025;54553;HOLLANDE François;M;HOLLANDE;François;;20089
Présidentielles 2012 - 2ème tour;Présidentielles;2012;2;;;32;FONTENAY AUX ROSES;92032;15234;2790;12444;510;11934;HOLLANDE François;M;HOLLANDE;François;;6985
Présidentielles 2012 - 2ème tour;Présidentielles;2012;2;;;32;FONTENAY AUX ROSES;92032;15234;2790;12444;510;11934;SARKOZY Nicolas;M;SARKOZY;Nicolas;;4949
Présidentielles 2012 - 2ème tour;Présidentielles;2012;2;;;35;LA GARENNE COLOMBES;92035;17302;2975;14327;653;13674;SARKOZY Nicolas;M;SARKOZY;Nicolas;;7945
Présidentielles 2012 - 2ème tour;Présidentielles;2012;2;;;64;SAINT CLOUD;92064;19006;2699;16307;527;15780;HOLLANDE François;M;HOLLANDE;François;;4748
Présidentielles 2012 - 2ème tour;Présidentielles;2012;2;;;76;VAUCRESSON;92076;6099;962;5137;161;4976;HOLLANDE François;M;HOLLANDE;François;;1313
Présidentielles 1995 - 2ème tour;Présidentielles;1995;2;;;22;CHAVILLE;92022;12177;2343;9834;459;9375;JOSPIN LIONEL;M;JOSPIN;LIONEL;;3930
Législatives 2012 - 1er tour;Législatives;2012;1;8;8ème circonscription;22;CHAVILLE;92022;12808;4688;8120;75;8045;LIME-BIFFE Catherine;F;LIME-BIFFE;Catherine;SOC;2806
Législatives 2012 - 1er tour;Législatives;2012;1;8;8ème circonscription;22;CHAVILLE;92022;12808;4688;8120;75;8045;GRILLARD Jean;M;GRILLARD;Jean;AUT;4
Législatives 2012 - 1er tour;Législatives;2012;1;12;12ème circonscription;23;CLAMART;92023;34173;13440;20733;193;20540;BIERENT Rudolph;M;BIERENT;Rudolph;AUT;36
Législatives 2012 - 1er tour;Législatives;2012;1;3;3ème circonscription;26;COURBEVOIE;92026;42456;16939;25517;317;25200;DENIAU Floriane;F;DENIAU;Floriane;FN;1500
Législatives 2012 - 1er tour;Législatives;2012;1;12;12ème circonscription;32;FONTENAY AUX ROSES;92032;15230;5971;9259;85;9174;DELOM Christian;M;DELOM;Christian;CEN;349
Législatives 2012 - 1er tour;Législatives;2012;1;7;7ème circonscription;33;GARCHES;92033;12412;5093;7319;98;7221;OLLIER Patrick;M;OLLIER;Patrick;UMP;3691
Législatives 2012 - 1er tour;Législatives;2012;1;7;7ème circonscription;33;GARCHES;92033;12412;5093;7319;98;7221;LAPORTE Lucia;F;LAPORTE;Lucia;FN;555
Législatives 2012 - 1er tour;Législatives;2012;1;5;5ème circonscription;44;LEVALLOIS PERRET;92044;39546;14667;24879;238;24641;CATOIRE Gilles;M;CATOIRE;Gilles;SOC;5959
Législatives 2012 - 1er tour;Législatives;2012;1;5;5ème circonscription;44;LEVALLOIS PERRET;92044;39546;14667;24879;238;24641;DUTILLOY Marie-Catherine;F;DUTILLOY;Marie-Catherine;ECO;130
Législatives 2012 - 1er tour;Législatives;2012;1;11;11ème circonscription;46;MALAKOFF;92046;18858;7608;11250;119;11131;MARCEL Baptiste;M;MARCEL;Baptiste;AUT;163
Législatives 2012 - 1er tour;Législatives;2012;1;8;8ème circonscription;47;MARNES LA COQUETTE;92047;1085;330;755;2;753;MOGHIR Naïma;F;MOGHIR;Naïma;ECO;0
Législatives 2012 - 1er tour;Législatives;2012;1;8;8ème circonscription;47;MARNES LA COQUETTE;92047;1085;330;755;2;753;BENIERE Louise;F;BENIERE;Louise;DVD;7
Législatives 2012 - 1er tour;Législatives;2012;1;10;10ème circonscription;48;MEUDON;92048;5576;2083;3493;26;3467;SCHMID Lucile;F;SCHMID;Lucile;VEC;982
Législatives 2012 - 1er tour;Législatives;2012;1;4;4ème circonscription;50;NANTERRE;92050;44344;21046;23298;337;22961;HARE Marie-Claire;F;HARE;Marie-Claire;ECO;105
Législatives 2012 - 1er tour;Législatives;2012;1;4;4ème circonscription;50;NANTERRE;92050;44344;21046;23298;337;22961;ROSENBLATT Emmanuelle;F;ROSENBLATT;Emmanuelle;DVD;87
Législatives 2012 - 1er tour;Législatives;2012;1;4;4ème circonscription;50;NANTERRE;92050;44344;21046;23298;337;22961;STEBE Yves;M;STEBE;Yves;DVD;113
Législatives 2012 - 1er tour;Législatives;2012;1;6;6ème circonscription;51;NEUILLY SUR SEINE;92051;37031;14672;22359;177;22182;CARREAU Georges;M;CARREAU;Georges;AUT;39
Législatives 2012 - 1er tour;Législatives;2012;1;6;6ème circonscription;51;NEUILLY SUR SEINE;92051;37031;14672;22359;177;22182;HERVE Nicole;F;HERVE;Nicole;FN;1095
Législatives 2012 - 1er tour;Législatives;2012;1;7;7ème circonscription;64;SAINT CLOUD;92064;19029;7431;11598;97;11501;BLANCHARD Laurent;M;BLANCHARD;Laurent;AUT;157
Législatives 2012 - 1er tour;Législatives;2012;1;4;4ème circonscription;73;SURESNES;92073;26492;10723;15769;302;15467;MORGANT David;M;MORGANT;David;CEN;471
Législatives 2012 - 1er tour;Législatives;2012;1;10;10ème circonscription;75;VANVES;92075;17559;6347;11212;104;11108;PIEUCHOT Laurent;M;PIEUCHOT;Laurent;DVG;1395
Législatives 2012 - 1er tour;Législatives;2012;1;8;8ème circonscription;77;VILLE D'AVRAY;92077;7169;2468;4701;48;4653;HENIQUE Philippe;M;HENIQUE;Philippe;EXG;7
Législatives 2012 - 1er tour;Législatives;2012;1;8;8ème circonscription;77;VILLE D'AVRAY;92077;7169;2468;4701;48;4653;CANDELIER Catherine;F;CANDELIER;Catherine;VEC;183
Législatives 2012 - 1er tour;Législatives;2012;1;8;8ème circonscription;77;VILLE D'AVRAY;92077;7169;2468;4701;48;4653;BECQ Michel;M;BECQ;Michel;DVD;44
Législatives 2012 - 1er tour;Législatives;2012;1;1;1ère circonscription;78;VILLENEUVE LA GARENNE;92078;12349;6903;5446;131;5315;AZIZOUDINE Yasmine;F;AZIZOUDINE;Yasmine;AUT;22
Législatives 2012 - 2ème tour;Législatives;2012;2;2;2ème circonscription;4;ASNIERES SUR SEINE;92004;45108;19141;25967;1046;24921;AESCHLIMANN Manuel;M;AESCHLIMANN;Manuel;UMP;11393
Législatives 2012 - 2ème tour;Législatives;2012;2;3;3ème circonscription;35;LA GARENNE COLOMBES;92035;17314;7511;9803;208;9595;KOSSOWSKI Jacques;M;KOSSOWSKI;Jacques;UMP;5561
Législatives 2012 - 2ème tour;Législatives;2012;2;5;5ème circonscription;44;LEVALLOIS PERRET;92044;39546;14970;24576;954;23622;CATOIRE Gilles;M;CATOIRE;Gilles;SOC;8501
Législatives 2012 - 2ème tour;Législatives;2012;2;8;8ème circonscription;77;VILLE D'AVRAY;92077;7169;2709;4460;129;4331;GUILLET Jean-Jacques;M;GUILLET;Jean-Jacques;UMP;2768
Législatives 2012 - 1er tour;Législatives;2012;1;2;2ème circonscription;4;ASNIERES SUR SEINE;92004;45114;18545;26569;310;26259;TARRIN Jean-Michel;M;TARRIN;Jean-Michel;FG;978
Législatives 2012 - 1er tour;Législatives;2012;1;10;10ème circonscription;12;BOULOGNE BILLANCOURT;92012;6600;2912;3688;126;3562;SANTINI André;M;SANTINI;André;NCE;1261
Législatives 2012 - 1er tour;Législatives;2012;1;13;13ème circonscription;14;BOURG LA REINE;92014;13305;4436;8869;87;8782;LANDFRIED Julien;M;LANDFRIED;Julien;DVG;1971
Législatives 2012 - 1er tour;Législatives;2012;1;12;12ème circonscription;20;CHATILLON;92020;21681;8265;13416;122;13294;CARRASCO Julia;F;CARRASCO;Julia;DVD;103
Législatives 1993 - 1er tour;Législatives;1993;1;6;6ème circonscription;62;PUTEAUX;92062;23271;6636;16635;697;15938;JOUBERT BERTRAND;M;JOUBERT;BERTRAND;DVD;136
Législatives 1993 - 1er tour;Législatives;1993;1;6;6ème circonscription;62;PUTEAUX;92062;23271;6636;16635;697;15938;SARKOZY NICOLAS;M;SARKOZY;NICOLAS;RPR;8545
Législatives 1993 - 1er tour;Législatives;1993;1;1;1ère circonscription;36;GENNEVILLIERS;92036;19185;6818;12367;395;11972;MUSSAT PHILIPPE;M;MUSSAT;PHILIPPE;EXG;82
Législatives 1993 - 1er tour;Législatives;1993;1;11;11ème circonscription;46;MALAKOFF;92046;19559;6951;12608;416;12192;POUSSIER MARTIAL;M;POUSSIER;MARTIAL;MAJ;37
Législatives 1993 - 1er tour;Législatives;1993;1;7;7ème circonscription;63;RUEIL MALMAISON;92063;42219;12104;30115;1049;29066;MICHAELY GUY;M;MICHAELY;GUY;EXD;128
Législatives 1993 - 1er tour;Législatives;1993;1;13;13ème circonscription;71;SCEAUX;92071;13127;3574;9553;306;9247;CAILLAULT JACQUES;M;CAILLAULT;JACQUES;MAJ;145
Législatives 1993 - 1er tour;Législatives;1993;1;7;7ème circonscription;64;SAINT CLOUD;92064;19166;6250;12916;429;12487;MICHAELY GUY;M;MICHAELY;GUY;EXD;35
Législatives 2002 - 1er tour;Législatives;2002;1;2;2ème circonscription;4;ASNIERES SUR SEINE;92004;44110;17783;26327;312;26015;SEMOUN Jean-Jacques;M;SEMOUN;Jean-Jacques;DVD;218
Législatives 2002 - 1er tour;Législatives;2002;1;3;3ème circonscription;9;BOIS COLOMBES;92009;16245;6561;9684;288;9396;CARILLON Rémi;M;CARILLON;Rémi;FN;247
Législatives 2002 - 1er tour;Législatives;2002;1;9;9ème circonscription;12;BOULOGNE BILLANCOURT;92012;60773;22422;38351;535;37816;COTTEN Christian;M;COTTEN;Christian;DIV;199
Législatives 2002 - 1er tour;Législatives;2002;1;13;13ème circonscription;19;CHATENAY MALABRY;92019;17835;6584;11251;211;11040;IORIO Catherine;F;IORIO;Catherine;FN;285
Législatives 2002 - 1er tour;Législatives;2002;1;12;12ème circonscription;23;CLAMART;92023;32916;11487;21429;154;21275;BENARD Paul;M;BENARD;Paul;EXG;71
Législatives 2002 - 1er tour;Législatives;2002;1;12;12ème circonscription;23;CLAMART;92023;32916;11487;21429;154;21275;PEMEZEC Philippe;M;PEMEZEC;Philippe;UMP;9267
Législatives 2002 - 1er tour;Législatives;2002;1;2;2ème circonscription;25;COLOMBES;92025;18336;7144;11192;207;10985;ECH-CHETOUANI Zouhairr;M;ECH-CHETOUANI;Zouhairr;DIV;32
Législatives 2002 - 1er tour;Législatives;2002;1;2;2ème circonscription;25;COLOMBES;92025;18336;7144;11192;207;10985;SALLES Laurent;M;SALLES;Laurent;FN;340
Législatives 2002 - 1er tour;Législatives;2002;1;3;3ème circonscription;26;COURBEVOIE;92026;49151;19345;29806;541;29265;DORE Patricia;F;DORE;Patricia;ECO;258
Législatives 2002 - 1er tour;Législatives;2002;1;5;5ème circonscription;44;LEVALLOIS PERRET;92044;39466;14724;24742;404;24338;LAMBERT Mireille;F;LAMBERT;Mireille;EXG;80
Législatives 2002 - 1er tour;Législatives;2002;1;5;5ème circonscription;44;LEVALLOIS PERRET;92044;39466;14724;24742;404;24338;MENDEZ Annie;F;MENDEZ;Annie;COM;409
Législatives 2002 - 1er tour;Législatives;2002;1;5;5ème circonscription;44;LEVALLOIS PERRET;92044;39466;14724;24742;404;24338;DUTILLOY Marie-Catherine;F;DUTILLOY;Marie-Catherine;ECO;191
Législatives 2002 - 1er tour;Législatives;2002;1;11;11ème circonscription;46;MALAKOFF;92046;18478;7045;11433;204;11229;SAUVANAUD Juliette;F;SAUVANAUD;Juliette;EXG;54
Législatives 2002 - 1er tour;Législatives;2002;1;11;11ème circonscription;46;MALAKOFF;92046;18478;7045;11433;204;11229;BARBEROUSSE Olivier;M;BARBEROUSSE;Olivier;EXG;208
Législatives 2002 - 1er tour;Législatives;2002;1;8;8ème circonscription;48;MEUDON;92048;25427;9683;15744;202;15542;ROY Caroline;F;ROY;Caroline;RDG;3546
Législatives 2002 - 1er tour;Législatives;2002;1;4;4ème circonscription;50;NANTERRE;92050;42631;18721;23910;314;23596;DUPUY Christian;M;DUPUY;Christian;UMP;6409
Législatives 2002 - 1er tour;Législatives;2002;1;7;7ème circonscription;64;SAINT CLOUD;92064;19115;6812;12303;93;12210;BRISON Christian;M;BRISON;Christian;EXG;30
Législatives 2002 - 1er tour;Législatives;2002;1;7;7ème circonscription;64;SAINT CLOUD;92064;19115;6812;12303;93;12210;BORNETTE Bernard;M;BORNETTE;Bernard;EXD;47
Législatives 2002 - 1er tour;Législatives;2002;1;13;13ème circonscription;71;SCEAUX;92071;14129;4679;9450;74;9376;RIEUX Françoise;F;RIEUX;Françoise;EXD;36
Législatives 2002 - 1er tour;Législatives;2002;1;8;8ème circonscription;72;SEVRES;92072;14460;5279;9181;151;9030;RAFFALI Danielle;F;RAFFALI;Danielle;ECO;81
Législatives 2002 - 1er tour;Législatives;2002;1;8;8ème circonscription;77;VILLE D'AVRAY;92077;7475;2429;5046;60;4986;GONNET Nicolas;M;GONNET;Nicolas;COM;37
Législatives 2002 - 2ème tour;Législatives;2002;2;12;12ème circonscription;32;FONTENAY AUX ROSES;92032;14272;4933;9339;309;9030;BAVAY FRANCINE;F;BAVAY;FRANCINE;VEC;4698
Législatives 2002 - 2ème tour;Législatives;2002;2;11;11ème circonscription;46;MALAKOFF;92046;17391;6936;10455;265;10190;METTON JEAN-LOUP;M;METTON;JEAN-LOUP;UDF;3452
Législatives 2002 - 2ème tour;Législatives;2002;2;8;8ème circonscription;48;MEUDON;92048;24187;9753;14434;776;13658;GUILLET J.JACQUES;M;GUILLET;J.JACQUES;UMP;7495
Législatives 2002 - 2ème tour;Législatives;2002;2;8;8ème circonscription;72;SEVRES;92072;13545;4911;8634;353;8281;LEVAIN JEAN - MARIE;M;LEVAIN;JEAN - MARIE;PRG;3622
Législatives 2002 - 2ème tour;Législatives;2002;2;8;8ème circonscription;72;SEVRES;92072;13545;4911;8634;353;8281;GUILLET J.JACQUES;M;GUILLET;J.JACQUES;UMP;4659
Législatives 1997 - 2ème tour;Législatives;1997;2;4;4ème circonscription;50;NANTERRE;92050;38533;12430;26103;1248;24855;DUPUY CHRISTIAN;M;DUPUY;CHRISTIAN;RPR;10085
Législatives 1997 - 2ème tour;Législatives;1997;2;10;10ème circonscription;75;VANVES;92075;15446;4123;11323;419;10904;SANTINI ANDRE;M;SANTINI;ANDRE;UDF;5927
Législatives 1997 - 2ème tour;Législatives;1997;2;11;11ème circonscription;7;BAGNEUX;92007;20284;7017;13267;700;12567;JAMBU JANINE;F;JAMBU;JANINE;COM;7819
Législatives 1993 - 2ème tour;Législatives;1993;2;12;12ème circonscription;23;CLAMART;92023;30899;10423;20476;1217;19259;BUCHET PASCAL;M;BUCHET;PASCAL;SOC;7625
Législatives 1993 - 2ème tour;Législatives;1993;2;13;13ème circonscription;71;SCEAUX;92071;13127;4093;9034;536;8498;DEVEDJIAN PATRICK;M;DEVEDJIAN;PATRICK;RPR;5507
Législatives 1997 - 1er tour;Législatives;1997;1;7;7ème circonscription;64;SAINT CLOUD;92064;18908;7095;11813;417;11396;CABOT DOMINIQUE;M;CABOT;DOMINIQUE;DIV;77
Législatives 1997 - 1er tour;Législatives;1997;1;6;6ème circonscription;62;PUTEAUX;92062;24329;8862;15467;635;14832;SAS CATHERINE;F;SAS;CATHERINE;DVD;239
Législatives 1997 - 1er tour;Législatives;1997;1;4;4ème circonscription;73;SURESNES;92073;20985;7217;13768;441;13327;FRAYSSE JACQUELINE;F;FRAYSSE;JACQUELINE;COM;1776
Législatives 1997 - 1er tour;Législatives;1997;1;8;8ème circonscription;72;SEVRES;92072;13776;4413;9363;352;9011;GUILLET J.JACQUES;M;GUILLET;J.JACQUES;RPR;3355
Législatives 1997 - 1er tour;Législatives;1997;1;4;4ème circonscription;73;SURESNES;92073;20985;7217;13768;441;13327;DELUME FLAVIEN;M;DELUME;FLAVIEN;DIV;0
Législatives 1993 - 1er tour;Législatives;1993;1;13;13ème circonscription;19;CHATENAY MALABRY;92019;17809;6223;11586;435;11151;CAILLAULT JACQUES;M;CAILLAULT;JACQUES;MAJ;244
Législatives 1993 - 1er tour;Législatives;1993;1;13;13ème circonscription;14;BOURG LA REINE;92014;12754;4085;8669;303;8366;DEVEDJIAN PATRICK;M;DEVEDJIAN;PATRICK;RPR;4162
Législatives 1993 - 1er tour;Législatives;1993;1;9;9ème circonscription;12;BOULOGNE BILLANCOURT;92012;53509;17387;36122;1224;34898;FRADIN YANN;M;FRADIN;YANN;VEC;2913
Législatives 1993 - 1er tour;Législatives;1993;1;2;2ème circonscription;25;COLOMBES;92025;18324;5870;12454;434;12020;FRAGER DOMINIQUE;M;FRAGER;DOMINIQUE;GEC;1238
Législatives 1993 - 1er tour;Législatives;1993;1;12;12ème circonscription;23;CLAMART;92023;30899;9896;21003;704;20299;DUMAS J.FRANCOIS;M;DUMAS;J.FRANCOIS;VEC;1778
Législatives 1993 - 1er tour;Législatives;1993;1;1;1ère circonscription;25;COLOMBES;92025;26594;9512;17082;693;16389;PREVOT ALAIN;M;PREVOT;ALAIN;DIV;741
Législatives 1997 - 1er tour;Législatives;1997;1;12;12ème circonscription;20;CHATILLON;92020;16406;5234;11172;367;10805;LE BERRE ALAIN;M;LE BERRE;ALAIN;FRN;1338
Législatives 1997 - 1er tour;Législatives;1997;1;12;12ème circonscription;23;CLAMART;92023;30471;10310;20161;590;19571;LECOMTE HERVE;M;LECOMTE;HERVE;EXG;114
Législatives 1997 - 1er tour;Législatives;1997;1;11;11ème circonscription;49;MONTROUGE;92049;21975;7943;14032;388;13644;BAUDRY D'ASSON DE ROLAND;M;BAUDRY D'ASSON DE;ROLAND;DVD;309
Législatives 1997 - 1er tour;Législatives;1997;1;8;8ème circonscription;47;MARNES LA COQUETTE;92047;985;289;696;19;677;ETILE L.CHRISTOPHE;M;ETILE;L.CHRISTOPHE;DVD;12
Législatives 1997 - 1er tour;Législatives;1997;1;8;8ème circonscription;47;MARNES LA COQUETTE;92047;985;289;696;19;677;GUILLET J.JACQUES;M;GUILLET;J.JACQUES;RPR;373
Législatives 1997 - 1er tour;Législatives;1997;1;11;11ème circonscription;46;MALAKOFF;92046;19124;7233;11891;338;11553;PRUNIER ROBERT;M;PRUNIER;ROBERT;DVD;4
Législatives 1997 - 1er tour;Législatives;1997;1;11;11ème circonscription;49;MONTROUGE;92049;21975;7943;14032;388;13644;DEISS A.MARIE;F;DEISS;A.MARIE;DIV;73
Législatives 1997 - 1er tour;Législatives;1997;1;10;10ème circonscription;48;MEUDON;92048;4118;1375;2743;67;2676;VIDAL ISABELLE;F;VIDAL;ISABELLE;EXG;10
Législatives 1997 - 1er tour;Législatives;1997;1;1;1ère circonscription;25;COLOMBES;92025;26238;10153;16085;513;15572;LECLERCQ ARNAUD;M;LECLERCQ;ARNAUD;DVD;152
Législatives 1997 - 1er tour;Législatives;1997;1;5;5ème circonscription;44;LEVALLOIS PERRET;92044;28281;9315;18966;650;18316;ALFARROBA CATHERINE;F;ALFARROBA;CATHERINE;DVG;253
Législatives 1997 - 1er tour;Législatives;1997;1;5;5ème circonscription;44;LEVALLOIS PERRET;92044;28281;9315;18966;650;18316;CHAZEAUX DE OLIVIER;M;CHAZEAUX DE;OLIVIER;RPR;4262
Législatives 1997 - 1er tour;Législatives;1997;1;5;5ème circonscription;44;LEVALLOIS PERRET;92044;28281;9315;18966;650;18316;BALKANY ISABELLE;F;BALKANY;ISABELLE;DVD;3992
Législatives 1997 - 1er tour;Législatives;1997;1;11;11ème circonscription;46;MALAKOFF;92046;19124;7233;11891;338;11553;BATIFOL JEROME;M;BATIFOL;JEROME;DVD;110
Législatives 1997 - 1er tour;Législatives;1997;1;3;3ème circonscription;26;COURBEVOIE;92026;35738;12354;23384;653;22731;POULTIER LAURENT;M;POULTIER;LAURENT;DVD;602
Législatives 1997 - 1er tour;Législatives;1997;1;3;3ème circonscription;26;COURBEVOIE;92026;35738;12354;23384;653;22731;SCHWARTZ A.MARIE;F;SCHWARTZ;A.MARIE;EXG;553
Législatives 1997 - 1er tour;Législatives;1997;1;2;2ème circonscription;25;COLOMBES;92025;17603;6110;11493;415;11078;THOMAS CAPUCINE;F;THOMAS;CAPUCINE;ECO;0
Législatives 1997 - 1er tour;Législatives;1997;1;2;2ème circonscription;25;COLOMBES;92025;17603;6110;11493;415;11078;RENAUD GEORGES;M;RENAUD;GEORGES;DVD;0
Législatives 1997 - 1er tour;Législatives;1997;1;10;10ème circonscription;12;BOULOGNE BILLANCOURT;92012;4529;1717;2812;99;2713;WELLENSTEIN CYRIL;M;WELLENSTEIN;CYRIL;DVD;29
Législatives 1997 - 1er tour;Législatives;1997;1;9;9ème circonscription;12;BOULOGNE BILLANCOURT;92012;53287;18902;34385;948;33437;BRUNEAU CHRISTINE;F;BRUNEAU;CHRISTINE;DVD;1687
Législatives 1997 - 1er tour;Législatives;1997;1;3;3ème circonscription;9;BOIS COLOMBES;92009;14757;5447;9310;293;9017;RONDEPIERRE GILDAS;M;RONDEPIERRE;GILDAS;DVD;2
Législatives 1997 - 1er tour;Législatives;1997;1;11;11ème circonscription;7;BAGNEUX;92007;20284;7388;12896;374;12522;BAUDRY D'ASSON DE ROLAND;M;BAUDRY D'ASSON DE;ROLAND;DVD;202
Législatives 1997 - 1er tour;Législatives;1997;1;13;13ème circonscription;2;ANTONY;92002;37772;12082;25690;861;24829;LAVAL J.MARIE;M;LAVAL;J.MARIE;DVD;690
Législatives 1997 - 1er tour;Législatives;1997;1;11;11ème circonscription;7;BAGNEUX;92007;20284;7388;12896;374;12522;PIROIS LOUIS;M;PIROIS;LOUIS;EXG;333
Législatives 1997 - 1er tour;Législatives;1997;1;6;6ème circonscription;62;PUTEAUX;92062;24329;8862;15467;635;14832;FLUMIAN OLIVIER;M;FLUMIAN;OLIVIER;DIV;0
Législatives 2017 - 1er tour;Législatives;2017;1;1;1ère circonscription;36;GENNEVILLIERS;92036;22174;13223;8951;243;8708;BARON Jean-Baptiste;M;BARON;Jean-Baptiste;DIV;85
Législatives 2017 - 1er tour;Législatives;2017;1;1;1ère circonscription;36;GENNEVILLIERS;92036;22174;13223;8951;243;8708;PRUVOST Emmanuel;M;PRUVOST;Emmanuel;ECO;54
Législatives 2017 - 1er tour;Législatives;2017;1;1;1ère circonscription;25;COLOMBES;92025;27867;16420;11447;405;11042;WICQUART Emmanuelle;F;WICQUART;Emmanuelle;DLF;155
Législatives 2017 - 1er tour;Législatives;2017;1;1;1ère circonscription;25;COLOMBES;92025;27867;16420;11447;405;11042;FAUCILLON Elsa;F;FAUCILLON;Elsa;COM;671
Législatives 2017 - 1er tour;Législatives;2017;1;11;11ème circonscription;49;MONTROUGE;92049;28914;12071;16843;175;16668;TEIXEIRA Dominique;M;TEIXEIRA;Dominique;EXG;32
Législatives 2017 - 1er tour;Législatives;2017;1;11;11ème circonscription;49;MONTROUGE;92049;28914;12071;16843;175;16668;SERRE Wilfried;M;SERRE;Wilfried;DVD;99
Législatives 2017 - 1er tour;Législatives;2017;1;12;12ème circonscription;23;CLAMART;92023;35342;15954;19388;238;19150;ASCOUET Florence;F;ASCOUET;Florence;DIV;129
Législatives 2017 - 1er tour;Législatives;2017;1;12;12ème circonscription;32;FONTENAY AUX ROSES;92032;16049;7756;8293;93;8200;SÉJOURNÉ Emmanuelle;F;SÉJOURNÉ;Emmanuelle;DLF;104
Législatives 2017 - 1er tour;Législatives;2017;1;13;13ème circonscription;2;ANTONY;92002;41542;17216;24326;446;23880;DELRIEU Denis;M;DELRIEU;Denis;ECO;1140
Législatives 2017 - 1er tour;Législatives;2017;1;13;13ème circonscription;2;ANTONY;92002;41542;17216;24326;446;23880;ACHACHE Tristan;M;ACHACHE;Tristan;DIV;20
Législatives 2017 - 1er tour;Législatives;2017;1;13;13ème circonscription;14;BOURG LA REINE;92014;13736;5356;8380;81;8299;LAFFITE Agnès;F;LAFFITE;Agnès;FN;347
Législatives 2017 - 1er tour;Législatives;2017;1;13;13ème circonscription;71;SCEAUX;92071;15078;6395;8683;84;8599;LASGI Nicolas;M;LASGI;Nicolas;FI;584
Législatives 2017 - 1er tour;Législatives;2017;1;4;4ème circonscription;73;SURESNES;92073;28524;12725;15799;423;15376;BOUDJEMAÏ Zahra;F;BOUDJEMAÏ;Zahra;DVG;560
Législatives 2017 - 1er tour;Législatives;2017;1;4;4ème circonscription;73;SURESNES;92073;28524;12725;15799;423;15376;GAUHY Aristide;M;GAUHY;Aristide;DIV;7
Législatives 2017 - 1er tour;Législatives;2017;1;4;4ème circonscription;73;SURESNES;92073;28524;12725;15799;423;15376;LONC François;M;LONC;François;DIV;122
Législatives 2017 - 1er tour;Législatives;2017;1;10;10ème circonscription;75;VANVES;92075;18507;7626;10881;125;10756;VIGUIÉ Laurence;F;VIGUIÉ;Laurence;EXG;41
Législatives 2017 - 1er tour;Législatives;2017;1;11;11ème circonscription;7;BAGNEUX;92007;21911;12424;9487;167;9320;SERRE Wilfried;M;SERRE;Wilfried;DVD;17
Législatives 2017 - 1er tour;Législatives;2017;1;10;10ème circonscription;75;VANVES;92075;18507;7626;10881;125;10756;COSTE Jeremy;M;COSTE;Jeremy;UDI;1828
Législatives 2017 - 1er tour;Législatives;2017;1;10;10ème circonscription;48;MEUDON;92048;6009;2545;3464;38;3426;COSTE Jeremy;M;COSTE;Jeremy;UDI;618
Législatives 2017 - 1er tour;Législatives;2017;1;5;5ème circonscription;44;LEVALLOIS PERRET;92044;41751;17632;24119;255;23864;FOURNIER Marie-Claude;F;FOURNIER;Marie-Claude;ECO;407
Législatives 2017 - 1er tour;Législatives;2017;1;8;8ème circonscription;77;VILLE D'AVRAY;92077;7440;2857;4583;44;4539;MEROUCHI Sandra;F;MEROUCHI;Sandra;DIV;29
Législatives 2017 - 1er tour;Législatives;2017;1;3;3ème circonscription;26;COURBEVOIE;92026;44322;19890;24432;415;24017;DAHAN Isabelle;F;DAHAN;Isabelle;SOC;1059
Législatives 2017 - 1er tour;Législatives;2017;1;3;3ème circonscription;35;LA GARENNE COLOMBES;92035;18829;8238;10591;114;10477;GAULTIER Stéphane;M;GAULTIER;Stéphane;EXG;18
Législatives 2017 - 1er tour;Législatives;2017;1;5;5ème circonscription;24;CLICHY;92024;28620;14628;13992;265;13727;HERVO Xavier;M;HERVO;Xavier;DIV;61
Législatives 2017 - 1er tour;Législatives;2017;1;8;8ème circonscription;72;SEVRES;92072;15144;6343;8801;149;8652;MAIRE Jacques;M;MAIRE;Jacques;REM;4390
Législatives 2017 - 1er tour;Législatives;2017;1;7;7ème circonscription;64;SAINT CLOUD;92064;19410;7490;11920;102;11818;POIZAT Vincent;M;POIZAT;Vincent;ECO;391
Législatives 2017 - 1er tour;Législatives;2017;1;6;6ème circonscription;51;NEUILLY SUR SEINE;92051;37215;15249;21966;119;21847;BRANNENS Marie;F;BRANNENS;Marie;SOC;366
Législatives 2017 - 1er tour;Législatives;2017;1;7;7ème circonscription;33;GARCHES;92033;12777;5514;7263;115;7148;ABAD Cécile;F;ABAD;Cécile;EXG;22
Législatives 2017 - 1er tour;Législatives;2017;1;10;10ème circonscription;40;ISSY LES MOULINEAUX;92040;45375;19009;26366;517;25849;MOREAU Nicolas;M;MOREAU;Nicolas;DVG;219
Législatives 2017 - 1er tour;Législatives;2017;1;10;10ème circonscription;48;MEUDON;92048;6009;2545;3464;38;3426;VIGUIÉ Laurence;F;VIGUIÉ;Laurence;EXG;9
Législatives 2017 - 1er tour;Législatives;2017;1;10;10ème circonscription;48;MEUDON;92048;6009;2545;3464;38;3426;LECOCQ Laurence;F;LECOCQ;Laurence;DIV;19
Présidentielles 1995 - 1er tour;Présidentielles;1995;1;;;2;ANTONY;92002;37894;9274;28620;590;28030;VOYNET DOMINIQUE;F;VOYNET;DOMINIQUE;;1105
Présidentielles 1995 - 2ème tour;Présidentielles;1995;2;;;14;BOURG LA REINE;92014;12770;2754;10016;404;9612;JOSPIN LIONEL;M;JOSPIN;LIONEL;;3682
Présidentielles 1995 - 2ème tour;Présidentielles;1995;2;;;32;FONTENAY AUX ROSES;92032;14917;2889;12028;533;11495;CHIRAC JACQUES;M;CHIRAC;JACQUES;;6195
Présidentielles 1995 - 2ème tour;Présidentielles;1995;2;;;63;RUEIL MALMAISON;92063;44424;8493;35931;1578;34353;CHIRAC JACQUES;M;CHIRAC;JACQUES;;21362
Présidentielles 1995 - 2ème tour;Présidentielles;1995;2;;;72;SEVRES;92072;13745;2191;11554;433;11121;CHIRAC JACQUES;M;CHIRAC;JACQUES;;6514
Présidentielles 1995 - 1er tour;Présidentielles;1995;1;;;40;ISSY LES MOULINEAUX;92040;30054;8139;21915;444;21471;VOYNET DOMINIQUE;F;VOYNET;DOMINIQUE;;792
Présidentielles 1995 - 1er tour;Présidentielles;1995;1;;;62;PUTEAUX;92062;24192;6165;18027;379;17648;CHEMINADE JACQUES;M;CHEMINADE;JACQUES;;41
Présidentielles 1995 - 1er tour;Présidentielles;1995;1;;;71;SCEAUX;92071;13371;3073;10298;170;10128;JOSPIN LIONEL;M;JOSPIN;LIONEL;;2493
Présidentielles 1995 - 1er tour;Présidentielles;1995;1;;;4;ASNIERES SUR SEINE;92004;39050;10288;28762;594;28168;VILLIERS DE PHILIPPE;M;VILLIERS DE;PHILIPPE;;984
Présidentielles 1995 - 1er tour;Présidentielles;1995;1;;;14;BOURG LA REINE;92014;12770;3430;9340;135;9205;LAGUILLER ARLETTE;F;LAGUILLER;ARLETTE;;389
Présidentielles 1995 - 1er tour;Présidentielles;1995;1;;;72;SEVRES;92072;13745;2869;10876;183;10693;VILLIERS DE PHILIPPE;M;VILLIERS DE;PHILIPPE;;398
Présidentielles 1995 - 1er tour;Présidentielles;1995;1;;;72;SEVRES;92072;13745;2869;10876;183;10693;LAGUILLER ARLETTE;F;LAGUILLER;ARLETTE;;477
Présidentielles 1995 - 1er tour;Présidentielles;1995;1;;;75;VANVES;92075;15499;3343;12156;236;11920;JOSPIN LIONEL;M;JOSPIN;LIONEL;;3321
Présidentielles 1995 - 1er tour;Présidentielles;1995;1;;;71;SCEAUX;92071;13371;3073;10298;170;10128;HUE ROBERT;M;HUE;ROBERT;;394
Présidentielles 1995 - 1er tour;Présidentielles;1995;1;;;76;VAUCRESSON;92076;5529;1334;4195;65;4130;HUE ROBERT;M;HUE;ROBERT;;83
Présidentielles 2007 - 1er tour;Présidentielles;2007;1;;;12;BOULOGNE BILLANCOURT;92012;64709;7685;57024;546;56478;BUFFET Marie-George;F;BUFFET;Marie-George;;425
Présidentielles 2007 - 1er tour;Présidentielles;2007;1;;;14;BOURG LA REINE;92014;13108;1436;11672;90;11582;LAGUILLER Arlette;F;LAGUILLER;Arlette;;59
Présidentielles 2007 - 1er tour;Présidentielles;2007;1;;;20;CHATILLON;92020;20466;2231;18235;177;18058;de VILLIERS Philippe;M;de VILLIERS;Philippe;;243
Présidentielles 2007 - 1er tour;Présidentielles;2007;1;;;22;CHAVILLE;92022;12743;1700;11043;119;10924;SCHIVARDI Gérard;M;SCHIVARDI;Gérard;;22
Présidentielles 2007 - 1er tour;Présidentielles;2007;1;;;24;CLICHY;92024;28539;4472;24067;245;23822;LE PEN Jean-Marie;M;LE PEN;Jean-Marie;;1473
Présidentielles 2007 - 1er tour;Présidentielles;2007;1;;;33;GARCHES;92033;11957;1346;10611;106;10505;LE PEN Jean-Marie;M;LE PEN;Jean-Marie;;568
Présidentielles 2007 - 1er tour;Présidentielles;2007;1;;;36;GENNEVILLIERS;92036;19890;3536;16354;259;16095;SCHIVARDI Gérard;M;SCHIVARDI;Gérard;;53
Présidentielles 2007 - 1er tour;Présidentielles;2007;1;;;50;NANTERRE;92050;42083;6117;35966;477;35489;SARKOZY Nicolas;M;SARKOZY;Nicolas;;8282
Présidentielles 2007 - 1er tour;Présidentielles;2007;1;;;51;NEUILLY SUR SEINE;92051;37647;4032;33615;154;33461;BAYROU François;M;BAYROU;François;;4365
Présidentielles 2007 - 1er tour;Présidentielles;2007;1;;;51;NEUILLY SUR SEINE;92051;37647;4032;33615;154;33461;NIHOUS Frédéric;M;NIHOUS;Frédéric;;41
Présidentielles 2007 - 1er tour;Présidentielles;2007;1;;;63;RUEIL MALMAISON;92063;50540;5920;44620;393;44227;VOYNET Dominique;F;VOYNET;Dominique;;706
Présidentielles 2007 - 1er tour;Présidentielles;2007;1;;;72;SEVRES;92072;14178;1738;12440;129;12311;SARKOZY Nicolas;M;SARKOZY;Nicolas;;4750
Présidentielles 2007 - 1er tour;Présidentielles;2007;1;;;73;SURESNES;92073;24255;2600;21655;272;21383;LE PEN Jean-Marie;M;LE PEN;Jean-Marie;;1177
Présidentielles 2007 - 1er tour;Présidentielles;2007;1;;;75;VANVES;92075;17139;2129;15010;126;14884;BUFFET Marie-George;F;BUFFET;Marie-George;;213
Présidentielles 2007 - 1er tour;Présidentielles;2007;1;;;76;VAUCRESSON;92076;5902;781;5121;42;5079;BESANCENOT Olivier;M;BESANCENOT;Olivier;;42
Présidentielles 2007 - 1er tour;Présidentielles;2007;1;;;77;VILLE D'AVRAY;92077;7253;672;6581;57;6524;de VILLIERS Philippe;M;de VILLIERS;Philippe;;93
Présidentielles 2007 - 1er tour;Présidentielles;2007;1;;;78;VILLENEUVE LA GARENNE;92078;12897;2898;9999;145;9854;LE PEN Jean-Marie;M;LE PEN;Jean-Marie;;811
Présidentielles 2007 - 1er tour;Présidentielles;2007;1;;;78;VILLENEUVE LA GARENNE;92078;12897;2898;9999;145;9854;SARKOZY Nicolas;M;SARKOZY;Nicolas;;2868
Présidentielles 2017 - 1er tour;Présidentielles;2017;1;;;4;ASNIERES SUR SEINE;92004;48227;8578;39649;807;38842;LE PEN Marine;F;LE PEN;Marine;;2670
Présidentielles 2017 - 1er tour;Présidentielles;2017;1;;;7;BAGNEUX;92007;21873;5369;16504;428;16076;ARTHAUD Nathalie;F;ARTHAUD;Nathalie;;124
Présidentielles 2017 - 1er tour;Présidentielles;2017;1;;;14;BOURG LA REINE;92014;13769;2202;11567;212;11355;HAMON Benoît;M;HAMON;Benoît;;936
Présidentielles 2017 - 1er tour;Présidentielles;2017;1;;;25;COLOMBES;92025;47454;9714;37740;907;36833;ARTHAUD Nathalie;F;ARTHAUD;Nathalie;;133
Présidentielles 2017 - 1er tour;Présidentielles;2017;1;;;40;ISSY LES MOULINEAUX;92040;46800;9050;37750;728;37022;POUTOU Philippe;M;POUTOU;Philippe;;193
Présidentielles 2017 - 1er tour;Présidentielles;2017;1;;;46;MALAKOFF;92046;18434;3186;15248;268;14979;LASSALLE Jean;M;LASSALLE;Jean;;111
Présidentielles 2017 - 1er tour;Présidentielles;2017;1;;;47;MARNES LA COQUETTE;92047;1215;171;1044;5;1039;HAMON Benoît;M;HAMON;Benoît;;38
Présidentielles 2017 - 1er tour;Présidentielles;2017;1;;;48;MEUDON;92048;31280;5715;25565;405;25160;LASSALLE Jean;M;LASSALLE;Jean;;179
Présidentielles 2017 - 1er tour;Présidentielles;2017;1;;;50;NANTERRE;92050;47568;10655;36913;884;36029;LASSALLE Jean;M;LASSALLE;Jean;;195
Présidentielles 2017 - 1er tour;Présidentielles;2017;1;;;62;PUTEAUX;92062;28950;4530;24420;549;23871;ARTHAUD Nathalie;F;ARTHAUD;Nathalie;;75
Présidentielles 2017 - 1er tour;Présidentielles;2017;1;;;71;SCEAUX;92071;15052;2914;12138;145;11993;CHEMINADE Jacques;M;CHEMINADE;Jacques;;25
Présidentielles 2017 - 1er tour;Présidentielles;2017;1;;;75;VANVES;92075;18500;3228;15272;248;15024;CHEMINADE Jacques;M;CHEMINADE;Jacques;;17
Présidentielles 2017 - 1er tour;Présidentielles;2017;1;;;76;VAUCRESSON;92076;6176;835;5341;72;5269;HAMON Benoît;M;HAMON;Benoît;;196
Présidentielles 2017 - 1er tour;Présidentielles;2017;1;;;77;VILLE D'AVRAY;92077;7433;837;6596;89;6507;ARTHAUD Nathalie;F;ARTHAUD;Nathalie;;11
Présidentielles 2012 - 1er tour;Présidentielles;2012;1;;;2;ANTONY;92002;40169;7755;32414;674;31740;LE PEN Marine;F;LE PEN;Marine;;2586
Présidentielles 2012 - 1er tour;Présidentielles;2012;1;;;4;ASNIERES SUR SEINE;92004;45042;9279;35763;516;35247;ARTHAUD Nathalie;F;ARTHAUD;Nathalie;;112
Présidentielles 2012 - 1er tour;Présidentielles;2012;1;;;12;BOULOGNE BILLANCOURT;92012;67579;13310;54269;818;53451;ARTHAUD Nathalie;F;ARTHAUD;Nathalie;;88
Présidentielles 2012 - 1er tour;Présidentielles;2012;1;;;22;CHAVILLE;92022;12768;2527;10241;147;10094;SARKOZY Nicolas;M;SARKOZY;Nicolas;;3308
Présidentielles 2012 - 1er tour;Présidentielles;2012;1;;;26;COURBEVOIE;92026;50576;11277;39299;681;38618;CHEMINADE Jacques;M;CHEMINADE;Jacques;;116
Présidentielles 2012 - 1er tour;Présidentielles;2012;1;;;44;LEVALLOIS PERRET;92044;39497;7296;32201;438;31763;DUPONT-AIGNAN Nicolas;M;DUPONT-AIGNAN;Nicolas;;400
Présidentielles 2012 - 1er tour;Présidentielles;2012;1;;;46;MALAKOFF;92046;18852;4162;14690;207;14483;DUPONT-AIGNAN Nicolas;M;DUPONT-AIGNAN;Nicolas;;168
Présidentielles 2012 - 1er tour;Présidentielles;2012;1;;;47;MARNES LA COQUETTE;92047;1082;163;919;8;911;LE PEN Marine;F;LE PEN;Marine;;55
Présidentielles 2012 - 1er tour;Présidentielles;2012;1;;;48;MEUDON;92048;30572;6341;24231;318;23913;HOLLANDE François;M;HOLLANDE;François;;7319
Présidentielles 2012 - 1er tour;Présidentielles;2012;1;;;50;NANTERRE;92050;44307;10435;33872;654;33218;POUTOU Philippe;M;POUTOU;Philippe;;334
Présidentielles 2012 - 1er tour;Présidentielles;2012;1;;;73;SURESNES;92073;26458;5110;21348;425;20923;JOLY Eva;F;JOLY;Eva;;538
Présidentielles 2012 - 1er tour;Présidentielles;2012;1;;;73;SURESNES;92073;26458;5110;21348;425;20923;SARKOZY Nicolas;M;SARKOZY;Nicolas;;7547
Présidentielles 2012 - 1er tour;Présidentielles;2012;1;;;78;VILLENEUVE LA GARENNE;92078;12332;3328;9004;225;8779;SARKOZY Nicolas;M;SARKOZY;Nicolas;;1748
Présidentielles 2012 - 1er tour;Présidentielles;2012;1;;;78;VILLENEUVE LA GARENNE;92078;12332;3328;9004;225;8779;CHEMINADE Jacques;M;CHEMINADE;Jacques;;20
Présidentielles 2012 - 1er tour;Présidentielles;2012;1;;;78;VILLENEUVE LA GARENNE;92078;12332;3328;9004;225;8779;BAYROU François;M;BAYROU;François;;502
Présidentielles 2002 - 1er tour;Présidentielles;2002;1;;;44;LEVALLOIS PERRET;92044;33618;9640;23978;575;23403;HUE ROBERT;M;HUE;ROBERT;;438
Présidentielles 2002 - 1er tour;Présidentielles;2002;1;;;48;MEUDON;92048;28283;9341;18942;321;18621;BOUTIN CHRISTINE;F;BOUTIN;CHRISTINE;;372
Présidentielles 2002 - 1er tour;Présidentielles;2002;1;;;48;MEUDON;92048;28283;9341;18942;321;18621;CHEVENEMENT JEAN-PIERRE;M;CHEVENEMENT;JEAN-PIERRE;;1140
Présidentielles 2002 - 1er tour;Présidentielles;2002;1;;;49;MONTROUGE;92049;23382;8142;15240;301;14939;CHIRAC JACQUES;M;CHIRAC;JACQUES;;3027
Présidentielles 2002 - 1er tour;Présidentielles;2002;1;;;49;MONTROUGE;92049;23382;8142;15240;301;14939;CHEVENEMENT JEAN-PIERRE;M;CHEVENEMENT;JEAN-PIERRE;;1073
Présidentielles 2002 - 1er tour;Présidentielles;2002;1;;;51;NEUILLY SUR SEINE;92051;34066;10108;23958;309;23649;SAINT-JOSSE JEAN;M;SAINT-JOSSE;JEAN;;190
Présidentielles 2002 - 1er tour;Présidentielles;2002;1;;;62;PUTEAUX;92062;23861;6804;17057;487;16570;BAYROU FRANCOIS;M;BAYROU;FRANCOIS;;1243
Présidentielles 2002 - 1er tour;Présidentielles;2002;1;;;71;SCEAUX;92071;12917;3930;8987;154;8833;CHIRAC JACQUES;M;CHIRAC;JACQUES;;2246
Présidentielles 2002 - 1er tour;Présidentielles;2002;1;;;72;SEVRES;92072;13367;4140;9227;153;9074;GLUCKSTEIN DANIEL;M;GLUCKSTEIN;DANIEL;;28
Présidentielles 2002 - 1er tour;Présidentielles;2002;1;;;72;SEVRES;92072;13367;4140;9227;153;9074;LAGUILLER ARLETTE;F;LAGUILLER;ARLETTE;;267
Présidentielles 2002 - 1er tour;Présidentielles;2002;1;;;78;VILLENEUVE LA GARENNE;92078;11406;4746;6660;180;6480;LEPAGE CORINNE;F;LEPAGE;CORINNE;;61
Présidentielles 2002 - 1er tour;Présidentielles;2002;1;;;12;BOULOGNE BILLANCOURT;92012;57382;17570;39812;645;39167;MADELIN ALAIN;M;MADELIN;ALAIN;;3343
Présidentielles 2002 - 1er tour;Présidentielles;2002;1;;;14;BOURG LA REINE;92014;12075;3519;8556;149;8407;SAINT-JOSSE JEAN;M;SAINT-JOSSE;JEAN;;57
Législatives 2017 - 1er tour;Législatives;2017;1;2;2ème circonscription;4;ASNIERES SUR SEINE;92004;48340;22557;25783;414;25369;BARTHÉLÉMY-RUIZ Chantal;F;BARTHÉLÉMY-RUIZ;Chantal;SOC;1400
Législatives 2017 - 1er tour;Législatives;2017;1;2;2ème circonscription;4;ASNIERES SUR SEINE;92004;48340;22557;25783;414;25369;PARIS Fabienne;F;PARIS;Fabienne;EXG;127
Législatives 2017 - 1er tour;Législatives;2017;1;5;5ème circonscription;24;CLICHY;92024;28620;14628;13992;265;13727;ZIANI Mimoun;M;ZIANI;Mimoun;DIV;211
Législatives 2017 - 1er tour;Législatives;2017;1;6;6ème circonscription;26;COURBEVOIE;92026;8107;4228;3879;107;3772;LINE Michelle;F;LINE;Michelle;ECO;42
Législatives 2017 - 1er tour;Législatives;2017;1;6;6ème circonscription;26;COURBEVOIE;92026;8107;4228;3879;107;3772;KARSENTY Philippe;M;KARSENTY;Philippe;DVD;58
Législatives 2017 - 1er tour;Législatives;2017;1;6;6ème circonscription;51;NEUILLY SUR SEINE;92051;37215;15249;21966;119;21847;LANDOWSKI Sophie;F;LANDOWSKI;Sophie;DIV;227
Législatives 2017 - 1er tour;Législatives;2017;1;8;8ème circonscription;48;MEUDON;92048;25240;11059;14181;174;14007;SCHNEIDER Frédéric;M;SCHNEIDER;Frédéric;DIV;70
Législatives 2017 - 1er tour;Législatives;2017;1;8;8ème circonscription;48;MEUDON;92048;25240;11059;14181;174;14007;MAIRE Jacques;M;MAIRE;Jacques;REM;6291
Législatives 2017 - 1er tour;Législatives;2017;1;8;8ème circonscription;77;VILLE D'AVRAY;92077;7440;2857;4583;44;4539;HÉNIQUE Philippe;M;HÉNIQUE;Philippe;EXG;24
Législatives 2017 - 1er tour;Législatives;2017;1;10;10ème circonscription;12;BOULOGNE BILLANCOURT;92012;9082;4562;4520;114;4406;ATTAL Gabriel;M;ATTAL;Gabriel;REM;2227
Législatives 2017 - 1er tour;Législatives;2017;1;10;10ème circonscription;48;MEUDON;92048;6009;2545;3464;38;3426;DAHAN Gérald;M;DAHAN;Gérald;FI;299
Législatives 2017 - 1er tour;Législatives;2017;1;10;10ème circonscription;48;MEUDON;92048;6009;2545;3464;38;3426;MOREAU Nicolas;M;MOREAU;Nicolas;DVG;24
Législatives 2017 - 1er tour;Législatives;2017;1;11;11ème circonscription;7;BAGNEUX;92007;21911;12424;9487;167;9320;MARTIN Agathe;F;MARTIN;Agathe;EXG;89
Législatives 2017 - 1er tour;Législatives;2017;1;12;12ème circonscription;20;CHATILLON;92020;22311;9527;12784;186;12598;CAMARA Makhtar;M;CAMARA;Makhtar;DVD;11
Législatives 2017 - 1er tour;Législatives;2017;1;12;12ème circonscription;23;CLAMART;92023;35342;15954;19388;238;19150;PREVEL Guillaume;M;PREVEL;Guillaume;DIV;247
Législatives 2017 - 1er tour;Législatives;2017;1;12;12ème circonscription;23;CLAMART;92023;35342;15954;19388;238;19150;BUCHOT Clarisse;F;BUCHOT;Clarisse;DIV;56
Législatives 2017 - 1er tour;Législatives;2017;1;12;12ème circonscription;23;CLAMART;92023;35342;15954;19388;238;19150;PERDRIAULT Mathieu;M;PERDRIAULT;Mathieu;DIV;14
Législatives 2017 - 1er tour;Législatives;2017;1;12;12ème circonscription;60;LE PLESSIS ROBINSON;92060;19154;7496;11658;130;11528;GERMAIN Jean-Marc;M;GERMAIN;Jean-Marc;SOC;636
Législatives 2017 - 1er tour;Législatives;2017;1;12;12ème circonscription;60;LE PLESSIS ROBINSON;92060;19154;7496;11658;130;11528;PERDRIAULT Mathieu;M;PERDRIAULT;Mathieu;DIV;13
Législatives 2017 - 1er tour;Législatives;2017;1;13;13ème circonscription;2;ANTONY;92002;41542;17216;24326;446;23880;PINÇON-CHARLOT Monique;F;PINÇON-CHARLOT;Monique;DVG;949
Législatives 2017 - 2ème tour;Législatives;2017;2;2;2ème circonscription;4;ASNIERES SUR SEINE;92004;48340;25571;22769;1662;21107;TAQUET Adrien;M;TAQUET;Adrien;REM;13109
Législatives 2017 - 2ème tour;Législatives;2017;2;6;6ème circonscription;51;NEUILLY SUR SEINE;92051;37215;18361;18854;874;17980;ZAMECZKOWSKI Laurent;M;ZAMECZKOWSKI;Laurent;REM;6637
Législatives 2017 - 2ème tour;Législatives;2017;2;7;7ème circonscription;63;RUEIL MALMAISON;92063;54503;28384;26119;1539;24580;BERDOATI Eric;M;BERDOATI;Eric;LR;9568
Législatives 2017 - 2ème tour;Législatives;2017;2;7;7ème circonscription;64;SAINT CLOUD;92064;19410;8757;10653;436;10217;MARILOSSIAN Jacques;M;MARILOSSIAN;Jacques;REM;5151
Législatives 2017 - 1er tour;Législatives;2017;1;3;3ème circonscription;9;BOIS COLOMBES;92009;17921;7869;10052;437;9615;MUGERIN Richard;M;MUGERIN;Richard;DLF;77
Législatives 2017 - 1er tour;Législatives;2017;1;3;3ème circonscription;35;LA GARENNE COLOMBES;92035;18829;8238;10591;114;10477;SPIRI Jean;M;SPIRI;Jean;LR;2734
Législatives 2017 - 1er tour;Législatives;2017;1;2;2ème circonscription;25;COLOMBES;92025;19668;8354;11314;229;11085;GUILLARD Laurent;M;GUILLARD;Laurent;ECO;488
Législatives 2017 - 1er tour;Législatives;2017;1;3;3ème circonscription;26;COURBEVOIE;92026;44322;19890;24432;415;24017;BANCHET Julien;M;BANCHET;Julien;DIV;93
Législatives 2017 - 1er tour;Législatives;2017;1;3;3ème circonscription;35;LA GARENNE COLOMBES;92035;18829;8238;10591;114;10477;ALLANIC Solène;F;ALLANIC;Solène;DIV;15
Législatives 2017 - 1er tour;Législatives;2017;1;4;4ème circonscription;50;NANTERRE;92050;47651;26455;21196;432;20764;MAHMOOD Shahnissar;F;MAHMOOD;Shahnissar;DLF;149
Législatives 2017 - 1er tour;Législatives;2017;1;4;4ème circonscription;50;NANTERRE;92050;47651;26455;21196;432;20764;FANTINO Laurent;M;FANTINO;Laurent;DIV;88
Présidentielles 2017 - 1er tour;Présidentielles;2017;1;;;7;BAGNEUX;92007;21873;5369;16504;428;16076;MÉLENCHON Jean-Luc;M;MÉLENCHON;Jean-Luc;;5832
Présidentielles 2017 - 1er tour;Présidentielles;2017;1;;;14;BOURG LA REINE;92014;13769;2202;11567;212;11355;MÉLENCHON Jean-Luc;M;MÉLENCHON;Jean-Luc;;1891
Présidentielles 2017 - 1er tour;Présidentielles;2017;1;;;20;CHATILLON;92020;22292;3682;18610;351;18259;DUPONT-AIGNAN Nicolas;M;DUPONT-AIGNAN;Nicolas;;619
Présidentielles 2017 - 1er tour;Présidentielles;2017;1;;;23;CLAMART;92023;35291;6330;28961;560;28401;FILLON François;M;FILLON;François;;7116
Présidentielles 2017 - 1er tour;Présidentielles;2017;1;;;44;LEVALLOIS PERRET;92044;41716;6107;35609;511;35098;MÉLENCHON Jean-Luc;M;MÉLENCHON;Jean-Luc;;4103
Présidentielles 2017 - 1er tour;Présidentielles;2017;1;;;46;MALAKOFF;92046;18434;3186;15248;268;14979;CHEMINADE Jacques;M;CHEMINADE;Jacques;;34
Présidentielles 2017 - 1er tour;Présidentielles;2017;1;;;46;MALAKOFF;92046;18434;3186;15248;268;14979;POUTOU Philippe;M;POUTOU;Philippe;;152
Présidentielles 2017 - 1er tour;Présidentielles;2017;1;;;50;NANTERRE;92050;47568;10655;36913;884;36029;DUPONT-AIGNAN Nicolas;M;DUPONT-AIGNAN;Nicolas;;1007
Présidentielles 2017 - 1er tour;Présidentielles;2017;1;;;60;LE PLESSIS ROBINSON;92060;19141;2947;16194;344;15850;CHEMINADE Jacques;M;CHEMINADE;Jacques;;23
Présidentielles 2017 - 1er tour;Présidentielles;2017;1;;;63;RUEIL MALMAISON;92063;54426;9298;45128;713;44414;FILLON François;M;FILLON;François;;14464
Présidentielles 2017 - 1er tour;Présidentielles;2017;1;;;64;SAINT CLOUD;92064;19370;2628;16742;186;16556;ARTHAUD Nathalie;F;ARTHAUD;Nathalie;;19
Présidentielles 2017 - 1er tour;Présidentielles;2017;1;;;64;SAINT CLOUD;92064;19370;2628;16742;186;16556;FILLON François;M;FILLON;François;;7602
Présidentielles 2017 - 1er tour;Présidentielles;2017;1;;;72;SEVRES;92072;15142;2166;12976;213;12763;FILLON François;M;FILLON;François;;3883
Présidentielles 2017 - 1er tour;Présidentielles;2017;1;;;72;SEVRES;92072;15142;2166;12976;213;12763;POUTOU Philippe;M;POUTOU;Philippe;;69
Présidentielles 2017 - 1er tour;Présidentielles;2017;1;;;73;SURESNES;92073;28497;4342;24155;520;23635;LASSALLE Jean;M;LASSALLE;Jean;;156
Présidentielles 2017 - 1er tour;Présidentielles;2017;1;;;77;VILLE D'AVRAY;92077;7433;837;6596;89;6507;LASSALLE Jean;M;LASSALLE;Jean;;39
Présidentielles 2012 - 1er tour;Présidentielles;2012;1;;;7;BAGNEUX;92007;20608;4687;15921;281;15640;DUPONT-AIGNAN Nicolas;M;DUPONT-AIGNAN;Nicolas;;197
Présidentielles 2012 - 1er tour;Présidentielles;2012;1;;;12;BOULOGNE BILLANCOURT;92012;67579;13310;54269;818;53451;JOLY Eva;F;JOLY;Eva;;1290
Présidentielles 2012 - 1er tour;Présidentielles;2012;1;;;20;CHATILLON;92020;21656;4298;17358;265;17093;JOLY Eva;F;JOLY;Eva;;456
Présidentielles 2012 - 1er tour;Présidentielles;2012;1;;;23;CLAMART;92023;34131;6740;27391;417;26974;BAYROU François;M;BAYROU;François;;2881
Présidentielles 2012 - 1er tour;Présidentielles;2012;1;;;24;CLICHY;92024;29226;6786;22440;374;22066;MÉLENCHON Jean-Luc;M;MÉLENCHON;Jean-Luc;;3219
Présidentielles 2012 - 1er tour;Présidentielles;2012;1;;;47;MARNES LA COQUETTE;92047;1082;163;919;8;911;BAYROU François;M;BAYROU;François;;113
Présidentielles 2012 - 1er tour;Présidentielles;2012;1;;;60;LE PLESSIS ROBINSON;92060;18767;3621;15146;260;14886;CHEMINADE Jacques;M;CHEMINADE;Jacques;;35
Présidentielles 2012 - 1er tour;Présidentielles;2012;1;;;62;PUTEAUX;92062;28189;5597;22592;470;22122;DUPONT-AIGNAN Nicolas;M;DUPONT-AIGNAN;Nicolas;;331
Présidentielles 2012 - 1er tour;Présidentielles;2012;1;;;63;RUEIL MALMAISON;92063;52385;10540;41845;580;41265;CHEMINADE Jacques;M;CHEMINADE;Jacques;;113
Présidentielles 2012 - 1er tour;Présidentielles;2012;1;;;71;SCEAUX;92071;14355;2941;11414;118;11296;CHEMINADE Jacques;M;CHEMINADE;Jacques;;26
Présidentielles 2012 - 1er tour;Présidentielles;2012;1;;;75;VANVES;92075;17512;3079;14433;161;14272;DUPONT-AIGNAN Nicolas;M;DUPONT-AIGNAN;Nicolas;;176
Présidentielles 2012 - 1er tour;Présidentielles;2012;1;;;78;VILLENEUVE LA GARENNE;92078;12332;3328;9004;225;8779;MÉLENCHON Jean-Luc;M;MÉLENCHON;Jean-Luc;;1356
Présidentielles 2012 - 2ème tour;Présidentielles;2012;2;;;19;CHATENAY MALABRY;92019;17895;2822;15073;757;14316;HOLLANDE François;M;HOLLANDE;François;;8308
Présidentielles 2012 - 2ème tour;Présidentielles;2012;2;;;20;CHATILLON;92020;21672;3615;18057;732;17325;HOLLANDE François;M;HOLLANDE;François;;9603
Présidentielles 2012 - 2ème tour;Présidentielles;2012;2;;;60;LE PLESSIS ROBINSON;92060;18774;3079;15695;745;14950;HOLLANDE François;M;HOLLANDE;François;;7203
Présidentielles 2017 - 2ème tour;Présidentielles;2017;2;;;12;BOULOGNE BILLANCOURT;92012;74030;16351;57679;4671;53008;LE PEN Marine;F;LE PEN;Marine;;6005
Présidentielles 2017 - 2ème tour;Présidentielles;2017;2;;;73;SURESNES;92073;28496;5924;22572;2053;20519;MACRON Emmanuel;M;MACRON;Emmanuel;;17563
Législatives 2007 - 1er tour;Législatives;2007;1;3;3ème circonscription;35;LA GARENNE COLOMBES;92035;16552;5947;10605;101;10504;SOUILLART Marie-Jeanne;F;SOUILLART;Marie-Jeanne;EXD;40
Législatives 2007 - 1er tour;Législatives;2007;1;7;7ème circonscription;33;GARCHES;92033;12286;4601;7685;112;7573;DE VAUREIX Anne;F;DE VAUREIX;Anne;MPF;83
Législatives 2007 - 1er tour;Législatives;2007;1;3;3ème circonscription;26;COURBEVOIE;92026;49151;19345;29806;541;29265;SOUILLART Marie-Jeanne;F;SOUILLART;Marie-Jeanne;EXD;76
Législatives 2007 - 1er tour;Législatives;2007;1;3;3ème circonscription;26;COURBEVOIE;92026;49151;19345;29806;541;29265;TRIBOULET Catherine;F;TRIBOULET;Catherine;DIV;29
Législatives 2007 - 1er tour;Législatives;2007;1;5;5ème circonscription;24;CLICHY;92024;28799;12380;16419;297;16122;COCHEPAIN Stéphane;M;COCHEPAIN;Stéphane;UDFD;1803
Législatives 2007 - 1er tour;Législatives;2007;1;8;8ème circonscription;48;MEUDON;92048;25427;9683;15744;202;15542;CYROULNIK Marie-France;F;CYROULNIK;Marie-France;EXG;294
Législatives 2007 - 1er tour;Législatives;2007;1;8;8ème circonscription;47;MARNES LA COQUETTE;92047;1074;316;758;5;753;LUCET Francis;M;LUCET;Francis;EXG;0
Législatives 2007 - 1er tour;Législatives;2007;1;11;11ème circonscription;46;MALAKOFF;92046;18478;7045;11433;204;11229;PICARD Catherine;F;PICARD;Catherine;SOC;2441
Législatives 2007 - 1er tour;Législatives;2007;1;12;12ème circonscription;23;CLAMART;92023;32916;11487;21429;154;21275;DELOM Christian;M;DELOM;Christian;UDFD;2572
Législatives 2007 - 1er tour;Législatives;2007;1;12;12ème circonscription;23;CLAMART;92023;32916;11487;21429;154;21275;DELVITTO Denis;M;DELVITTO;Denis;DIV;0
Législatives 2007 - 1er tour;Législatives;2007;1;5;5ème circonscription;24;CLICHY;92024;28799;12380;16419;297;16122;MENDEZ Annie;F;MENDEZ;Annie;COM;528
Législatives 2007 - 1er tour;Législatives;2007;1;4;4ème circonscription;50;NANTERRE;92050;42631;18721;23910;314;23596;LE TOUZE Estelle;F;LE TOUZE;Estelle;VEC;674
Législatives 2007 - 1er tour;Législatives;2007;1;10;10ème circonscription;48;MEUDON;92048;5066;1864;3202;29;3173;VIGUIE Laurence;F;VIGUIE;Laurence;EXG;18
Législatives 2007 - 1er tour;Législatives;2007;1;11;11ème circonscription;49;MONTROUGE;92049;26595;9698;16897;213;16684;KADRI Malika;F;KADRI;Malika;DIV;72
Législatives 2007 - 1er tour;Législatives;2007;1;9;9ème circonscription;12;BOULOGNE BILLANCOURT;92012;60773;22422;38351;535;37816;THOUVENOT Mireille;F;THOUVENOT;Mireille;EXG;372
Législatives 2007 - 1er tour;Législatives;2007;1;10;10ème circonscription;12;BOULOGNE BILLANCOURT;92012;5551;2367;3184;78;3106;WOUTERS Nina;F;WOUTERS;Nina;EXG;70
Législatives 2007 - 1er tour;Législatives;2007;1;10;10ème circonscription;12;BOULOGNE BILLANCOURT;92012;5551;2367;3184;78;3106;HOCINI Malek;M;HOCINI;Malek;DIV;110
Législatives 2007 - 1er tour;Législatives;2007;1;3;3ème circonscription;9;BOIS COLOMBES;92009;16245;6561;9684;288;9396;BARNONCEL Michel;M;BARNONCEL;Michel;VEC;245
Législatives 2007 - 1er tour;Législatives;2007;1;6;6ème circonscription;51;NEUILLY SUR SEINE;92051;39134;14738;24396;185;24211;OLIVIER Pascal;M;OLIVIER;Pascal;DVG;18
Législatives 2007 - 1er tour;Législatives;2007;1;6;6ème circonscription;51;NEUILLY SUR SEINE;92051;39134;14738;24396;185;24211;GALIENNE Jean;M;GALIENNE;Jean;DIV;91
Législatives 2007 - 1er tour;Législatives;2007;1;4;4ème circonscription;50;NANTERRE;92050;42631;18721;23910;314;23596;CREUZET Pierre;M;CREUZET;Pierre;UDFD;2510
Législatives 2007 - 1er tour;Législatives;2007;1;4;4ème circonscription;50;NANTERRE;92050;42631;18721;23910;314;23596;HOUTART Arnaud;M;HOUTART;Arnaud;MPF;66
Législatives 2007 - 1er tour;Législatives;2007;1;7;7ème circonscription;63;RUEIL MALMAISON;92063;51481;18902;32579;337;32242;BORNETTE Bernard;M;BORNETTE;Bernard;EXD;86
Législatives 2007 - 1er tour;Législatives;2007;1;6;6ème circonscription;62;PUTEAUX;92062;26791;8829;17962;396;17566;EISENBERG Mathilde;F;EISENBERG;Mathilde;EXG;304
Législatives 2007 - 1er tour;Législatives;2007;1;7;7ème circonscription;63;RUEIL MALMAISON;92063;51481;18902;32579;337;32242;SAGE Julien;M;SAGE;Julien;VEC;1134
Législatives 2007 - 1er tour;Législatives;2007;1;7;7ème circonscription;64;SAINT CLOUD;92064;19115;6812;12303;93;12210;SAGE Julien;M;SAGE;Julien;VEC;331
Législatives 2007 - 1er tour;Législatives;2007;1;6;6ème circonscription;62;PUTEAUX;92062;26791;8829;17962;396;17566;JEANNE Nadine;F;JEANNE;Nadine;SOC;3422
Législatives 2007 - 1er tour;Législatives;2007;1;6;6ème circonscription;62;PUTEAUX;92062;26791;8829;17962;396;17566;GALIENNE Jean;M;GALIENNE;Jean;DIV;89
Législatives 2007 - 1er tour;Législatives;2007;1;13;13ème circonscription;14;BOURG LA REINE;92014;13381;4391;8990;78;8912;RIEUX Françoise;F;RIEUX;Françoise;EXD;29
Législatives 2007 - 1er tour;Législatives;2007;1;4;4ème circonscription;73;SURESNES;92073;24666;8949;15717;206;15511;HOUTART Arnaud;M;HOUTART;Arnaud;MPF;102
Législatives 2007 - 1er tour;Législatives;2007;1;1;1ère circonscription;78;VILLENEUVE LA GARENNE;92078;13038;7211;5827;131;5696;BINDER Sylvain;M;BINDER;Sylvain;DIV;28
Législatives 2007 - 1er tour;Législatives;2007;1;8;8ème circonscription;77;VILLE D'AVRAY;92077;7475;2429;5046;60;4986;BEZAULT Christine;F;BEZAULT;Christine;DIV;39
Législatives 2007 - 1er tour;Législatives;2007;1;10;10ème circonscription;75;VANVES;92075;17351;5929;11422;137;11285;GINISTY Christophe;M;GINISTY;Christophe;UDFD;1402
Législatives 2007 - 1er tour;Législatives;2007;1;10;10ème circonscription;75;VANVES;92075;17351;5929;11422;137;11285;BINDER Sabrina;F;BINDER;Sabrina;DIV;73
Législatives 2007 - 2ème tour;Législatives;2007;2;12;12ème circonscription;20;CHATILLON;92020;20661;7902;12759;273;12486;PEMEZEC Philippe;M;PEMEZEC;Philippe;UMP;6458
Présidentielles 2002 - 1er tour;Présidentielles;2002;1;;;7;BAGNEUX;92007;18489;5873;12616;519;12097;BESANCENOT OLIVIER;M;BESANCENOT;OLIVIER;;544
Présidentielles 2002 - 1er tour;Présidentielles;2002;1;;;20;CHATILLON;92020;18067;5487;12580;295;12285;LE PEN JEAN-MARIE;M;LE PEN;JEAN-MARIE;;1405
Présidentielles 2002 - 1er tour;Présidentielles;2002;1;;;22;CHAVILLE;92022;12122;3826;8296;162;8134;LE PEN JEAN-MARIE;M;LE PEN;JEAN-MARIE;;924
Présidentielles 2002 - 1er tour;Présidentielles;2002;1;;;22;CHAVILLE;92022;12122;3826;8296;162;8134;BOUTIN CHRISTINE;F;BOUTIN;CHRISTINE;;180
Présidentielles 2002 - 1er tour;Présidentielles;2002;1;;;32;FONTENAY AUX ROSES;92032;14148;4309;9839;204;9635;CHEVENEMENT JEAN-PIERRE;M;CHEVENEMENT;JEAN-PIERRE;;778
Présidentielles 2002 - 1er tour;Présidentielles;2002;1;;;33;GARCHES;92033;11708;3920;7788;137;7651;MEGRET BRUNO;M;MEGRET;BRUNO;;131
Présidentielles 2002 - 1er tour;Présidentielles;2002;1;;;33;GARCHES;92033;11708;3920;7788;137;7651;JOSPIN LIONEL;M;JOSPIN;LIONEL;;986
Présidentielles 2002 - 1er tour;Présidentielles;2002;1;;;33;GARCHES;92033;11708;3920;7788;137;7651;HUE ROBERT;M;HUE;ROBERT;;110
Présidentielles 2002 - 1er tour;Présidentielles;2002;1;;;36;GENNEVILLIERS;92036;18213;6933;11280;303;10977;JOSPIN LIONEL;M;JOSPIN;LIONEL;;1964
Présidentielles 2002 - 1er tour;Présidentielles;2002;1;;;44;LEVALLOIS PERRET;92044;33618;9640;23978;575;23403;SAINT-JOSSE JEAN;M;SAINT-JOSSE;JEAN;;233
Présidentielles 2002 - 1er tour;Présidentielles;2002;1;;;44;LEVALLOIS PERRET;92044;33618;9640;23978;575;23403;BOUTIN CHRISTINE;F;BOUTIN;CHRISTINE;;461
Présidentielles 2002 - 1er tour;Présidentielles;2002;1;;;44;LEVALLOIS PERRET;92044;33618;9640;23978;575;23403;BESANCENOT OLIVIER;M;BESANCENOT;OLIVIER;;550
Présidentielles 2002 - 1er tour;Présidentielles;2002;1;;;62;PUTEAUX;92062;23861;6804;17057;487;16570;TAUBIRA CHRISTIANE;F;TAUBIRA;CHRISTIANE;;501
Présidentielles 2002 - 1er tour;Présidentielles;2002;1;;;62;PUTEAUX;92062;23861;6804;17057;487;16570;CHEVENEMENT JEAN-PIERRE;M;CHEVENEMENT;JEAN-PIERRE;;1068
Présidentielles 2002 - 1er tour;Présidentielles;2002;1;;;63;RUEIL MALMAISON;92063;48302;17158;31144;693;30451;LE PEN JEAN-MARIE;M;LE PEN;JEAN-MARIE;;3615
Présidentielles 2002 - 1er tour;Présidentielles;2002;1;;;73;SURESNES;92073;22099;7156;14943;329;14614;LAGUILLER ARLETTE;F;LAGUILLER;ARLETTE;;570
Présidentielles 2002 - 1er tour;Présidentielles;2002;1;;;78;VILLENEUVE LA GARENNE;92078;11406;4746;6660;180;6480;BOUTIN CHRISTINE;F;BOUTIN;CHRISTINE;;29
Présidentielles 2007 - 1er tour;Présidentielles;2007;1;;;7;BAGNEUX;92007;20438;2809;17629;261;17368;LE PEN Jean-Marie;M;LE PEN;Jean-Marie;;1192
Présidentielles 2007 - 1er tour;Présidentielles;2007;1;;;22;CHAVILLE;92022;12743;1700;11043;119;10924;BESANCENOT Olivier;M;BESANCENOT;Olivier;;266
Présidentielles 2007 - 1er tour;Présidentielles;2007;1;;;22;CHAVILLE;92022;12743;1700;11043;119;10924;LAGUILLER Arlette;F;LAGUILLER;Arlette;;62
Présidentielles 2007 - 1er tour;Présidentielles;2007;1;;;23;CLAMART;92023;32539;3879;28660;293;28367;BOVÉ José;M;BOVÉ;José;;302
Présidentielles 2007 - 1er tour;Présidentielles;2007;1;;;44;LEVALLOIS PERRET;92044;38708;4734;33974;296;33678;BUFFET Marie-George;F;BUFFET;Marie-George;;300
Présidentielles 2007 - 1er tour;Présidentielles;2007;1;;;48;MEUDON;92048;29936;4129;25807;223;25584;BESANCENOT Olivier;M;BESANCENOT;Olivier;;711
Présidentielles 2007 - 1er tour;Présidentielles;2007;1;;;50;NANTERRE;92050;42083;6117;35966;477;35489;BESANCENOT Olivier;M;BESANCENOT;Olivier;;1546
Présidentielles 2007 - 1er tour;Présidentielles;2007;1;;;50;NANTERRE;92050;42083;6117;35966;477;35489;BAYROU François;M;BAYROU;François;;6718
Présidentielles 2007 - 1er tour;Présidentielles;2007;1;;;71;SCEAUX;92071;13824;1539;12285;86;12199;VOYNET Dominique;F;VOYNET;Dominique;;200
Présidentielles 2007 - 1er tour;Présidentielles;2007;1;;;75;VANVES;92075;17139;2129;15010;126;14884;BAYROU François;M;BAYROU;François;;3580
Présidentielles 1995 - 1er tour;Présidentielles;1995;1;;;48;MEUDON;92048;29714;7851;21863;352;21511;BALLADUR EDOUARD;M;BALLADUR;EDOUARD;;4399
Présidentielles 1995 - 1er tour;Présidentielles;1995;1;;;49;MONTROUGE;92049;22293;5924;16369;314;16055;JOSPIN LIONEL;M;JOSPIN;LIONEL;;4315
Présidentielles 1995 - 1er tour;Présidentielles;1995;1;;;51;NEUILLY SUR SEINE;92051;35904;7798;28106;261;27845;JOSPIN LIONEL;M;JOSPIN;LIONEL;;2860
Présidentielles 1995 - 1er tour;Présidentielles;1995;1;;;51;NEUILLY SUR SEINE;92051;35904;7798;28106;261;27845;BALLADUR EDOUARD;M;BALLADUR;EDOUARD;;9243
Présidentielles 1995 - 1er tour;Présidentielles;1995;1;;;72;SEVRES;92072;13745;2869;10876;183;10693;BALLADUR EDOUARD;M;BALLADUR;EDOUARD;;2223
Présidentielles 1995 - 1er tour;Présidentielles;1995;1;;;9;BOIS COLOMBES;92009;14922;3871;11051;199;10852;CHIRAC JACQUES;M;CHIRAC;JACQUES;;2885
Présidentielles 1995 - 1er tour;Présidentielles;1995;1;;;44;LEVALLOIS PERRET;92044;29477;6881;22596;402;22194;VILLIERS DE PHILIPPE;M;VILLIERS DE;PHILIPPE;;704
Présidentielles 1995 - 1er tour;Présidentielles;1995;1;;;47;MARNES LA COQUETTE;92047;1003;227;776;11;765;CHEMINADE JACQUES;M;CHEMINADE;JACQUES;;4
Présidentielles 1995 - 1er tour;Présidentielles;1995;1;;;44;LEVALLOIS PERRET;92044;29477;6881;22596;402;22194;CHEMINADE JACQUES;M;CHEMINADE;JACQUES;;46
Présidentielles 2007 - 2ème tour;Présidentielles;2007;2;;;35;LA GARENNE COLOMBES;92035;16356;2112;14244;525;13719;SARKOZY Nicolas;M;SARKOZY;Nicolas;;8531
Présidentielles 2007 - 2ème tour;Présidentielles;2007;2;;;40;ISSY LES MOULINEAUX;92040;37971;5265;32706;1404;31302;SARKOZY Nicolas;M;SARKOZY;Nicolas;;16727
Présidentielles 2007 - 2ème tour;Présidentielles;2007;2;;;76;VAUCRESSON;92076;5902;815;5087;175;4912;ROYAL Ségolène;F;ROYAL;Ségolène;;1128
Présidentielles 1995 - 1er tour;Présidentielles;1995;1;;;19;CHATENAY MALABRY;92019;18227;5121;13106;238;12868;CHIRAC JACQUES;M;CHIRAC;JACQUES;;2883
Présidentielles 1995 - 1er tour;Présidentielles;1995;1;;;22;CHAVILLE;92022;12177;2870;9307;170;9137;BALLADUR EDOUARD;M;BALLADUR;EDOUARD;;1903
Présidentielles 1995 - 1er tour;Présidentielles;1995;1;;;22;CHAVILLE;92022;12177;2870;9307;170;9137;VOYNET DOMINIQUE;F;VOYNET;DOMINIQUE;;340
Présidentielles 1995 - 1er tour;Présidentielles;1995;1;;;20;CHATILLON;92020;16579;4065;12514;245;12269;CHIRAC JACQUES;M;CHIRAC;JACQUES;;3082
Présidentielles 1995 - 1er tour;Présidentielles;1995;1;;;32;FONTENAY AUX ROSES;92032;14917;3559;11358;196;11162;VOYNET DOMINIQUE;F;VOYNET;DOMINIQUE;;393
Présidentielles 1995 - 1er tour;Présidentielles;1995;1;;;35;LA GARENNE COLOMBES;92035;14104;3637;10467;225;10242;CHIRAC JACQUES;M;CHIRAC;JACQUES;;2792
Présidentielles 1995 - 1er tour;Présidentielles;1995;1;;;36;GENNEVILLIERS;92036;19543;5563;13980;326;13654;CHIRAC JACQUES;M;CHIRAC;JACQUES;;1929
Présidentielles 2002 - 2ème tour;Présidentielles;2002;2;;;24;CLICHY;92024;24496;5437;19059;740;18319;LE PEN JEAN-MARIE;M;LE PEN;JEAN-MARIE;;2679
Présidentielles 2002 - 2ème tour;Présidentielles;2002;2;;;71;SCEAUX;92071;12919;1935;10984;295;10689;CHIRAC JACQUES;M;CHIRAC;JACQUES;;9713
Présidentielles 1995 - 1er tour;Présidentielles;1995;1;;;23;CLAMART;92023;31229;8419;22810;457;22353;LAGUILLER ARLETTE;F;LAGUILLER;ARLETTE;;1122
Présidentielles 1995 - 1er tour;Présidentielles;1995;1;;;25;COLOMBES;92025;44864;11966;32898;703;32195;CHIRAC JACQUES;M;CHIRAC;JACQUES;;6893
Présidentielles 1995 - 1er tour;Présidentielles;1995;1;;;24;CLICHY;92024;24688;6820;17868;364;17504;HUE ROBERT;M;HUE;ROBERT;;1426
Législatives 1993 - 1er tour;Législatives;1993;1;10;10ème circonscription;12;BOULOGNE BILLANCOURT;92012;4523;1581;2942;133;2809;KERMIN J.CHARLES;M;KERMIN;J.CHARLES;EXG;33
Législatives 1993 - 1er tour;Législatives;1993;1;3;3ème circonscription;9;BOIS COLOMBES;92009;14392;4251;10141;422;9719;BRIGAND CATHERINE;F;BRIGAND;CATHERINE;GEC;1056
Législatives 1993 - 1er tour;Législatives;1993;1;11;11ème circonscription;7;BAGNEUX;92007;21150;7754;13396;474;12922;RAKETITCH RAOUL;M;RAKETITCH;RAOUL;FRN;1501
Législatives 1993 - 2ème tour;Législatives;1993;2;12;12ème circonscription;60;LE PLESSIS ROBINSON;92060;13118;4419;8699;611;8088;BUCHET PASCAL;M;BUCHET;PASCAL;SOC;3344
Législatives 1997 - 1er tour;Législatives;1997;1;13;13ème circonscription;2;ANTONY;92002;37772;12082;25690;861;24829;DEVEDJIAN PATRICK;M;DEVEDJIAN;PATRICK;RPR;8942
Législatives 1997 - 1er tour;Législatives;1997;1;9;9ème circonscription;12;BOULOGNE BILLANCOURT;92012;53287;18902;34385;948;33437;WARNIER DE WAILLY FLORENCE;F;WARNIER DE WAILLY;FLORENCE;DVD;359
Législatives 1997 - 1er tour;Législatives;1997;1;9;9ème circonscription;12;BOULOGNE BILLANCOURT;92012;53287;18902;34385;948;33437;HERSZKOWICZ ALBERT;M;HERSZKOWICZ;ALBERT;EXG;147
Législatives 1997 - 1er tour;Législatives;1997;1;3;3ème circonscription;9;BOIS COLOMBES;92009;14757;5447;9310;293;9017;KOSSOWSKI JACQUES;M;KOSSOWSKI;JACQUES;DVD;2353
Législatives 1997 - 1er tour;Législatives;1997;1;12;12ème circonscription;20;CHATILLON;92020;16406;5234;11172;367;10805;FOUCHER J.PIERRE;M;FOUCHER;J.PIERRE;UDF;3129
Législatives 1997 - 1er tour;Législatives;1997;1;5;5ème circonscription;24;CLICHY;92024;23725;8942;14783;486;14297;ZASLAVSKY HENRI;M;ZASLAVSKY;HENRI;DVG;47
Législatives 1997 - 1er tour;Législatives;1997;1;12;12ème circonscription;20;CHATILLON;92020;16406;5234;11172;367;10805;SCRIVE SIMON;M;SCRIVE;SIMON;ECO;437
Législatives 1997 - 1er tour;Législatives;1997;1;13;13ème circonscription;19;CHATENAY MALABRY;92019;17859;6462;11397;367;11030;LETTRON J.PIERRE;M;LETTRON;J.PIERRE;DVG;210
Législatives 1997 - 1er tour;Législatives;1997;1;10;10ème circonscription;12;BOULOGNE BILLANCOURT;92012;4529;1717;2812;99;2713;LOUSTAU AXEL;M;LOUSTAU;AXEL;FRN;388
Législatives 1997 - 1er tour;Législatives;1997;1;13;13ème circonscription;14;BOURG LA REINE;92014;12587;4431;8156;266;7890;GESLAIN A.MARIE;F;GESLAIN;A.MARIE;COM;355
Législatives 1997 - 1er tour;Législatives;1997;1;13;13ème circonscription;14;BOURG LA REINE;92014;12587;4431;8156;266;7890;PARLANGE AGNES;F;PARLANGE;AGNES;EXG;29
Législatives 1997 - 1er tour;Législatives;1997;1;1;1ère circonscription;36;GENNEVILLIERS;92036;19277;7226;12051;295;11756;ROBERT ALAIN;M;ROBERT;ALAIN;RPR;1277
Législatives 1997 - 1er tour;Législatives;1997;1;5;5ème circonscription;24;CLICHY;92024;23725;8942;14783;486;14297;DESMOULIN CHRISTINE;F;DESMOULIN;CHRISTINE;DVD;370
Législatives 1997 - 1er tour;Législatives;1997;1;3;3ème circonscription;26;COURBEVOIE;92026;35738;12354;23384;653;22731;PEREZ CHRISTIAN;M;PEREZ;CHRISTIAN;FRN;2747
Législatives 1997 - 1er tour;Législatives;1997;1;3;3ème circonscription;35;LA GARENNE COLOMBES;92035;13992;5163;8829;294;8535;DENJEAN NAVAILLE J.MARC;M;DENJEAN NAVAILLE;J.MARC;EXG;120
Législatives 1997 - 1er tour;Législatives;1997;1;8;8ème circonscription;47;MARNES LA COQUETTE;92047;985;289;696;19;677;LEVAIN JEAN;M;LEVAIN;JEAN;PRS;87
Législatives 1993 - 1er tour;Législatives;1993;1;12;12ème circonscription;60;LE PLESSIS ROBINSON;92060;13118;4266;8852;315;8537;LEGOEUIL ANNETTE;F;LEGOEUIL;ANNETTE;SOC;130
Législatives 1993 - 1er tour;Législatives;1993;1;8;8ème circonscription;77;VILLE D'AVRAY;92077;7199;1786;5413;149;5264;GUILLET J.JACQUES;M;GUILLET;J.JACQUES;RPR;1846
Législatives 1993 - 1er tour;Législatives;1993;1;8;8ème circonscription;76;VAUCRESSON;92076;5515;1574;3941;93;3848;FIEVET ALAIN;M;FIEVET;ALAIN;SOC;30
Législatives 1993 - 1er tour;Législatives;1993;1;5;5ème circonscription;44;LEVALLOIS PERRET;92044;27392;7486;19906;624;19282;CREMIEUX ROBERT;M;CREMIEUX;ROBERT;EXG;337
Législatives 1993 - 1er tour;Législatives;1993;1;11;11ème circonscription;46;MALAKOFF;92046;19559;6951;12608;416;12192;JAMBU JANINE;F;JAMBU;JANINE;COM;4346
Législatives 1993 - 1er tour;Législatives;1993;1;8;8ème circonscription;22;CHAVILLE;92022;12345;3904;8441;296;8145;LAURENT AMSALLEM EDDY;M;LAURENT AMSALLEM;EDDY;DIV;73
Législatives 1993 - 1er tour;Législatives;1993;1;12;12ème circonscription;20;CHATILLON;92020;15705;4455;11250;435;10815;BURGAUD CHRISTINE;F;BURGAUD;CHRISTINE;DIV;77
Législatives 1993 - 1er tour;Législatives;1993;1;8;8ème circonscription;22;CHAVILLE;92022;12345;3904;8441;296;8145;GODICHEAU PIERRE;M;GODICHEAU;PIERRE;DVD;95
Législatives 1993 - 1er tour;Législatives;1993;1;12;12ème circonscription;23;CLAMART;92023;30899;9896;21003;704;20299;LARCHER ROBERT;M;LARCHER;ROBERT;EXG;382
Législatives 1993 - 1er tour;Législatives;1993;1;4;4ème circonscription;50;NANTERRE;92050;38007;11484;26523;795;25728;FRAYSSE JACQUELINE;F;FRAYSSE;JACQUELINE;COM;7283
Législatives 1993 - 1er tour;Législatives;1993;1;11;11ème circonscription;49;MONTROUGE;92049;22632;7554;15078;554;14524;JAMBU JANINE;F;JAMBU;JANINE;COM;1064
Législatives 1993 - 1er tour;Législatives;1993;1;10;10ème circonscription;48;MEUDON;92048;4225;1396;2829;92;2737;DENIAU RAYMOND;M;DENIAU;RAYMOND;EXG;43
Législatives 1993 - 1er tour;Législatives;1993;1;11;11ème circonscription;49;MONTROUGE;92049;22632;7554;15078;554;14524;BOURDIN YVES;M;BOURDIN;YVES;EXG;104
Législatives 1993 - 1er tour;Législatives;1993;1;4;4ème circonscription;50;NANTERRE;92050;38007;11484;26523;795;25728;SCHWARTZ ANNE;F;SCHWARTZ;ANNE;EXG;352
Législatives 1993 - 1er tour;Législatives;1993;1;8;8ème circonscription;48;MEUDON;92048;25126;7628;17498;529;16969;SUCHIER ANDRE;M;SUCHIER;ANDRE;DIV;94
Législatives 1997 - 1er tour;Législatives;1997;1;12;12ème circonscription;60;LE PLESSIS ROBINSON;92060;13002;3860;9142;204;8938;BUCHET PASCAL;M;BUCHET;PASCAL;SOC;2131
Législatives 1997 - 1er tour;Législatives;1997;1;6;6ème circonscription;51;NEUILLY SUR SEINE;92051;35571;12347;23224;570;22654;SAS CATHERINE;F;SAS;CATHERINE;DVD;252
Législatives 1997 - 1er tour;Législatives;1997;1;11;11ème circonscription;49;MONTROUGE;92049;21975;7943;14032;388;13644;BOURGES BRIGITTE;F;BOURGES;BRIGITTE;EXG;537
Législatives 1997 - 1er tour;Législatives;1997;1;10;10ème circonscription;48;MEUDON;92048;4118;1375;2743;67;2676;BELLAIRE VALERIE;F;BELLAIRE;VALERIE;DIV;0
Législatives 1997 - 1er tour;Législatives;1997;1;11;11ème circonscription;49;MONTROUGE;92049;21975;7943;14032;388;13644;METTON J.LOUP;M;METTON;J.LOUP;UDF;4777
Législatives 1997 - 1er tour;Législatives;1997;1;6;6ème circonscription;62;PUTEAUX;92062;24329;8862;15467;635;14832;ANSART DE LESSAN FRANCOISE;F;ANSART DE LESSAN;FRANCOISE;DVD;391
Législatives 1997 - 1er tour;Législatives;1997;1;7;7ème circonscription;63;RUEIL MALMAISON;92063;44715;14813;29902;1094;28808;PEYRILLER PAUL;M;PEYRILLER;PAUL;ECO;180
Législatives 1997 - 1er tour;Législatives;1997;1;4;4ème circonscription;73;SURESNES;92073;20985;7217;13768;441;13327;FERHAT TOUATI;M;FERHAT;TOUATI;ECO;174
Législatives 1997 - 1er tour;Législatives;1997;1;1;1ère circonscription;78;VILLENEUVE LA GARENNE;92078;11471;4645;6826;211;6615;LECLERCQ ARNAUD;M;LECLERCQ;ARNAUD;DVD;46
Législatives 2002 - 1er tour;Législatives;2002;1;12;12ème circonscription;20;CHATILLON;92020;20661;7083;13578;137;13441;DELVITTO Denis;M;DELVITTO;Denis;DIV;0
Législatives 2002 - 1er tour;Législatives;2002;1;8;8ème circonscription;22;CHAVILLE;92022;12928;4682;8246;120;8126;LEHIDEUX Bernard;M;LEHIDEUX;Bernard;UDFD;1167
Législatives 2002 - 1er tour;Législatives;2002;1;1;1ère circonscription;25;COLOMBES;92025;26192;12273;13919;366;13553;MOURRE Odile;F;MOURRE;Odile;EXG;35
Législatives 2002 - 1er tour;Législatives;2002;1;2;2ème circonscription;25;COLOMBES;92025;18336;7144;11192;207;10985;FRAGER Dominique;M;FRAGER;Dominique;VEC;468
Législatives 2002 - 1er tour;Législatives;2002;1;7;7ème circonscription;33;GARCHES;92033;12286;4601;7685;112;7573;BORNETTE Bernard;M;BORNETTE;Bernard;EXD;25
Législatives 2002 - 1er tour;Législatives;2002;1;1;1ère circonscription;36;GENNEVILLIERS;92036;20048;9522;10526;189;10337;DENJEAN Jean-Marc;M;DENJEAN;Jean-Marc;VEC;189
Législatives 2002 - 1er tour;Législatives;2002;1;1;1ère circonscription;36;GENNEVILLIERS;92036;20048;9522;10526;189;10337;KADUR Alexandre;M;KADUR;Alexandre;DVD;28
Législatives 2002 - 1er tour;Législatives;2002;1;10;10ème circonscription;40;ISSY LES MOULINEAUX;92040;38520;14017;24503;359;24144;ARIPA Alain;M;ARIPA;Alain;MPF;218
Législatives 2002 - 1er tour;Législatives;2002;1;10;10ème circonscription;48;MEUDON;92048;5066;1864;3202;29;3173;HOCINI Malek;M;HOCINI;Malek;DIV;20
Législatives 2002 - 1er tour;Législatives;2002;1;11;11ème circonscription;49;MONTROUGE;92049;26595;9698;16897;213;16684;METTON Jean-Loup;M;METTON;Jean-Loup;MAJ;8030
Législatives 2002 - 1er tour;Législatives;2002;1;4;4ème circonscription;50;NANTERRE;92050;42631;18721;23910;314;23596;FRANCOIS Jean-Michel;M;FRANCOIS;Jean-Michel;EXG;62
Législatives 2017 - 1er tour;Législatives;2017;1;5;5ème circonscription;24;CLICHY;92024;28620;14628;13992;265;13727;DE COURSON Arnaud;M;DE COURSON;Arnaud;LR;1385
Législatives 2017 - 1er tour;Législatives;2017;1;4;4ème circonscription;73;SURESNES;92073;28524;12725;15799;423;15376;MORAIN Rossana;F;MORAIN;Rossana;FI;1110
Législatives 2017 - 1er tour;Législatives;2017;1;5;5ème circonscription;44;LEVALLOIS PERRET;92044;41751;17632;24119;255;23864;TOBIANO Michel;M;TOBIANO;Michel;ECO;37
Législatives 2017 - 1er tour;Législatives;2017;1;6;6ème circonscription;26;COURBEVOIE;92026;8107;4228;3879;107;3772;LE GRIP Constance;F;LE GRIP;Constance;LR;543
Législatives 2017 - 1er tour;Législatives;2017;1;6;6ème circonscription;26;COURBEVOIE;92026;8107;4228;3879;107;3772;DE CHOISY Hugo;M;DE CHOISY;Hugo;DIV;4
Législatives 2017 - 1er tour;Législatives;2017;1;3;3ème circonscription;26;COURBEVOIE;92026;44322;19890;24432;415;24017;ALLANIC Solène;F;ALLANIC;Solène;DIV;25
Législatives 2017 - 1er tour;Législatives;2017;1;10;10ème circonscription;75;VANVES;92075;18507;7626;10881;125;10756;MALEYRE Anne-Laure;F;MALEYRE;Anne-Laure;FN;408
Législatives 2017 - 1er tour;Législatives;2017;1;10;10ème circonscription;75;VANVES;92075;18507;7626;10881;125;10756;FOSSAERT Michel;M;FOSSAERT;Michel;ECO;20
Législatives 2017 - 1er tour;Législatives;2017;1;10;10ème circonscription;75;VANVES;92075;18507;7626;10881;125;10756;COUR Philippine;F;COUR;Philippine;DLF;87
Législatives 2017 - 1er tour;Législatives;2017;1;11;11ème circonscription;7;BAGNEUX;92007;21911;12424;9487;167;9320;CARRASCO Julia;F;CARRASCO;Julia;FN;665
Législatives 2017 - 1er tour;Législatives;2017;1;12;12ème circonscription;20;CHATILLON;92020;22311;9527;12784;186;12598;LEROY Christophe;M;LEROY;Christophe;COM;166
Législatives 2017 - 1er tour;Législatives;2017;1;12;12ème circonscription;20;CHATILLON;92020;22311;9527;12784;186;12598;TEXIER Damien;M;TEXIER;Damien;ECO;95
Législatives 2017 - 1er tour;Législatives;2017;1;12;12ème circonscription;23;CLAMART;92023;35342;15954;19388;238;19150;GERMAIN Jean-Marc;M;GERMAIN;Jean-Marc;SOC;1906
Législatives 2017 - 1er tour;Législatives;2017;1;12;12ème circonscription;32;FONTENAY AUX ROSES;92032;16049;7756;8293;93;8200;GERMAIN Jean-Marc;M;GERMAIN;Jean-Marc;SOC;997
Législatives 2017 - 1er tour;Législatives;2017;1;12;12ème circonscription;60;LE PLESSIS ROBINSON;92060;19154;7496;11658;130;11528;BUCHOT Clarisse;F;BUCHOT;Clarisse;DIV;5
Législatives 2017 - 1er tour;Législatives;2017;1;13;13ème circonscription;71;SCEAUX;92071;15078;6395;8683;84;8599;ROLLOT Franck;M;ROLLOT;Franck;EXG;16
Législatives 2017 - 2ème tour;Législatives;2017;2;10;10ème circonscription;48;MEUDON;92048;6011;3166;2845;253;2592;ATTAL Gabriel;M;ATTAL;Gabriel;REM;1691
Législatives 2017 - 2ème tour;Législatives;2017;2;11;11ème circonscription;7;BAGNEUX;92007;21911;12848;9063;516;8547;ROSSI Laurianne;F;ROSSI;Laurianne;REM;3744
Législatives 2017 - 1er tour;Législatives;2017;1;7;7ème circonscription;63;RUEIL MALMAISON;92063;54498;24335;30163;377;29786;CAZENEUVE Pierre;M;CAZENEUVE;Pierre;DIV;335
Législatives 2017 - 1er tour;Législatives;2017;1;7;7ème circonscription;64;SAINT CLOUD;92064;19410;7490;11920;102;11818;HANNOUF Noureddine;M;HANNOUF;Noureddine;DVD;94
Législatives 2017 - 1er tour;Législatives;2017;1;7;7ème circonscription;33;GARCHES;92033;12777;5514;7263;115;7148;MARILOSSIAN Jacques;M;MARILOSSIAN;Jacques;REM;3475
Législatives 2017 - 1er tour;Législatives;2017;1;2;2ème circonscription;25;COLOMBES;92025;19668;8354;11314;229;11085;RUEL-RADIGUE Philippe;M;RUEL-RADIGUE;Philippe;DVG;9
Législatives 2017 - 1er tour;Législatives;2017;1;1;1ère circonscription;78;VILLENEUVE LA GARENNE;92078;12445;8430;4015;143;3872;GRIMAL Jean;M;GRIMAL;Jean;EXG;5
Législatives 2017 - 1er tour;Législatives;2017;1;1;1ère circonscription;36;GENNEVILLIERS;92036;22174;13223;8951;243;8708;TOUMI Délia;F;TOUMI;Délia;ECO;166
Législatives 2017 - 1er tour;Législatives;2017;1;9;9ème circonscription;12;BOULOGNE BILLANCOURT;92012;64984;30321;34663;987;33676;SMARANDI Nina;F;SMARANDI;Nina;FN;1081
Législatives 2017 - 1er tour;Législatives;2017;1;8;8ème circonscription;76;VAUCRESSON;92076;6187;2474;3713;42;3671;CHETAILLE Romain;M;CHETAILLE;Romain;DVD;84
Législatives 2017 - 1er tour;Législatives;2017;1;8;8ème circonscription;77;VILLE D'AVRAY;92077;7440;2857;4583;44;4539;DUBOIS Renaud;M;DUBOIS;Renaud;ECO;189
Législatives 2017 - 1er tour;Législatives;2017;1;8;8ème circonscription;76;VAUCRESSON;92076;6187;2474;3713;42;3671;PASQUELIN Nelly;F;PASQUELIN;Nelly;FI;114
Législatives 2017 - 1er tour;Législatives;2017;1;8;8ème circonscription;72;SEVRES;92072;15144;6343;8801;149;8652;HÉNIQUE Philippe;M;HÉNIQUE;Philippe;EXG;53
Législatives 2017 - 1er tour;Législatives;2017;1;8;8ème circonscription;48;MEUDON;92048;25240;11059;14181;174;14007;MEROUCHI Sandra;F;MEROUCHI;Sandra;DIV;109
Législatives 2017 - 1er tour;Législatives;2017;1;6;6ème circonscription;51;NEUILLY SUR SEINE;92051;37215;15249;21966;119;21847;BOUGHERARA Zohra;F;BOUGHERARA;Zohra;COM;25
Législatives 2017 - 1er tour;Législatives;2017;1;6;6ème circonscription;62;PUTEAUX;92062;28983;11794;17189;436;16753;ETZENBACH Nathalie;F;ETZENBACH;Nathalie;DVD;814
Législatives 2017 - 1er tour;Législatives;2017;1;7;7ème circonscription;33;GARCHES;92033;12777;5514;7263;115;7148;CAZENEUVE Pierre;M;CAZENEUVE;Pierre;DIV;248
Présidentielles 2002 - 1er tour;Présidentielles;2002;1;;;2;ANTONY;92002;36989;11047;25942;517;25425;LEPAGE CORINNE;F;LEPAGE;CORINNE;;624
Présidentielles 2002 - 1er tour;Présidentielles;2002;1;;;2;ANTONY;92002;36989;11047;25942;517;25425;SAINT-JOSSE JEAN;M;SAINT-JOSSE;JEAN;;195
Présidentielles 2002 - 1er tour;Présidentielles;2002;1;;;7;BAGNEUX;92007;18489;5873;12616;519;12097;MADELIN ALAIN;M;MADELIN;ALAIN;;324
Présidentielles 2002 - 1er tour;Présidentielles;2002;1;;;19;CHATENAY MALABRY;92019;15965;4483;11482;241;11241;LE PEN JEAN-MARIE;M;LE PEN;JEAN-MARIE;;1269
Présidentielles 2002 - 1er tour;Présidentielles;2002;1;;;20;CHATILLON;92020;18067;5487;12580;295;12285;HUE ROBERT;M;HUE;ROBERT;;359
Présidentielles 2002 - 1er tour;Présidentielles;2002;1;;;22;CHAVILLE;92022;12122;3826;8296;162;8134;JOSPIN LIONEL;M;JOSPIN;LIONEL;;1512
Présidentielles 2002 - 1er tour;Présidentielles;2002;1;;;22;CHAVILLE;92022;12122;3826;8296;162;8134;BESANCENOT OLIVIER;M;BESANCENOT;OLIVIER;;263
Présidentielles 2002 - 1er tour;Présidentielles;2002;1;;;25;COLOMBES;92025;39608;13654;25954;571;25383;CHEVENEMENT JEAN-PIERRE;M;CHEVENEMENT;JEAN-PIERRE;;1772
Présidentielles 2002 - 1er tour;Présidentielles;2002;1;;;26;COURBEVOIE;92026;39941;11959;27982;520;27462;LE PEN JEAN-MARIE;M;LE PEN;JEAN-MARIE;;3409
Présidentielles 2002 - 1er tour;Présidentielles;2002;1;;;33;GARCHES;92033;11708;3920;7788;137;7651;MAMERE NOEL;M;MAMERE;NOEL;;343
Présidentielles 2002 - 1er tour;Présidentielles;2002;1;;;44;LEVALLOIS PERRET;92044;33618;9640;23978;575;23403;LEPAGE CORINNE;F;LEPAGE;CORINNE;;571
Présidentielles 2002 - 1er tour;Présidentielles;2002;1;;;44;LEVALLOIS PERRET;92044;33618;9640;23978;575;23403;GLUCKSTEIN DANIEL;M;GLUCKSTEIN;DANIEL;;59
Présidentielles 2002 - 1er tour;Présidentielles;2002;1;;;46;MALAKOFF;92046;17268;6020;11248;271;10977;BAYROU FRANCOIS;M;BAYROU;FRANCOIS;;533
Présidentielles 2002 - 1er tour;Présidentielles;2002;1;;;46;MALAKOFF;92046;17268;6020;11248;271;10977;HUE ROBERT;M;HUE;ROBERT;;1590
Présidentielles 2002 - 1er tour;Présidentielles;2002;1;;;46;MALAKOFF;92046;17268;6020;11248;271;10977;BESANCENOT OLIVIER;M;BESANCENOT;OLIVIER;;500
Présidentielles 2002 - 1er tour;Présidentielles;2002;1;;;50;NANTERRE;92050;37590;13303;24287;669;23618;TAUBIRA CHRISTIANE;F;TAUBIRA;CHRISTIANE;;1194
Présidentielles 2002 - 1er tour;Présidentielles;2002;1;;;50;NANTERRE;92050;37590;13303;24287;669;23618;BESANCENOT OLIVIER;M;BESANCENOT;OLIVIER;;1035
Présidentielles 2002 - 1er tour;Présidentielles;2002;1;;;64;SAINT CLOUD;92064;17818;6028;11790;141;11649;LE PEN JEAN-MARIE;M;LE PEN;JEAN-MARIE;;1326
Présidentielles 2002 - 1er tour;Présidentielles;2002;1;;;71;SCEAUX;92071;12917;3930;8987;154;8833;LEPAGE CORINNE;F;LEPAGE;CORINNE;;262
Présidentielles 2002 - 1er tour;Présidentielles;2002;1;;;71;SCEAUX;92071;12917;3930;8987;154;8833;CHEVENEMENT JEAN-PIERRE;M;CHEVENEMENT;JEAN-PIERRE;;691
Présidentielles 2002 - 1er tour;Présidentielles;2002;1;;;71;SCEAUX;92071;12917;3930;8987;154;8833;BESANCENOT OLIVIER;M;BESANCENOT;OLIVIER;;248
Présidentielles 2002 - 1er tour;Présidentielles;2002;1;;;72;SEVRES;92072;13367;4140;9227;153;9074;BESANCENOT OLIVIER;M;BESANCENOT;OLIVIER;;254
Présidentielles 2002 - 1er tour;Présidentielles;2002;1;;;73;SURESNES;92073;22099;7156;14943;329;14614;LE PEN JEAN-MARIE;M;LE PEN;JEAN-MARIE;;1773
Présidentielles 2002 - 1er tour;Présidentielles;2002;1;;;73;SURESNES;92073;22099;7156;14943;329;14614;MAMERE NOEL;M;MAMERE;NOEL;;908
Présidentielles 2002 - 1er tour;Présidentielles;2002;1;;;76;VAUCRESSON;92076;5861;2048;3813;62;3751;MAMERE NOEL;M;MAMERE;NOEL;;162
Présidentielles 2007 - 1er tour;Présidentielles;2007;1;;;2;ANTONY;92002;39316;4695;34621;413;34208;SARKOZY Nicolas;M;SARKOZY;Nicolas;;11922
Présidentielles 2007 - 1er tour;Présidentielles;2007;1;;;12;BOULOGNE BILLANCOURT;92012;64709;7685;57024;546;56478;SARKOZY Nicolas;M;SARKOZY;Nicolas;;27848
Présidentielles 2007 - 1er tour;Présidentielles;2007;1;;;20;CHATILLON;92020;20466;2231;18235;177;18058;BOVÉ José;M;BOVÉ;José;;151
Présidentielles 2007 - 1er tour;Présidentielles;2007;1;;;20;CHATILLON;92020;20466;2231;18235;177;18058;NIHOUS Frédéric;M;NIHOUS;Frédéric;;69
Présidentielles 2007 - 1er tour;Présidentielles;2007;1;;;23;CLAMART;92023;32539;3879;28660;293;28367;BUFFET Marie-George;F;BUFFET;Marie-George;;455
Présidentielles 2007 - 1er tour;Présidentielles;2007;1;;;25;COLOMBES;92025;44025;7536;36489;501;35988;LAGUILLER Arlette;F;LAGUILLER;Arlette;;296
Présidentielles 2007 - 1er tour;Présidentielles;2007;1;;;32;FONTENAY AUX ROSES;92032;15234;2027;13207;123;13084;BAYROU François;M;BAYROU;François;;3050
Présidentielles 2007 - 1er tour;Présidentielles;2007;1;;;35;LA GARENNE COLOMBES;92035;16350;1826;14524;117;14407;ROYAL Ségolène;F;ROYAL;Ségolène;;3067
Présidentielles 2007 - 1er tour;Présidentielles;2007;1;;;44;LEVALLOIS PERRET;92044;38708;4734;33974;296;33678;de VILLIERS Philippe;M;de VILLIERS;Philippe;;374
Présidentielles 2007 - 1er tour;Présidentielles;2007;1;;;63;RUEIL MALMAISON;92063;50540;5920;44620;393;44227;BUFFET Marie-George;F;BUFFET;Marie-George;;458
Présidentielles 2007 - 1er tour;Présidentielles;2007;1;;;63;RUEIL MALMAISON;92063;50540;5920;44620;393;44227;de VILLIERS Philippe;M;de VILLIERS;Philippe;;612
Présidentielles 2007 - 1er tour;Présidentielles;2007;1;;;71;SCEAUX;92071;13824;1539;12285;86;12199;BUFFET Marie-George;F;BUFFET;Marie-George;;138
Présidentielles 1995 - 1er tour;Présidentielles;1995;1;;;19;CHATENAY MALABRY;92019;18227;5121;13106;238;12868;VOYNET DOMINIQUE;F;VOYNET;DOMINIQUE;;529
Présidentielles 1995 - 1er tour;Présidentielles;1995;1;;;20;CHATILLON;92020;16579;4065;12514;245;12269;VOYNET DOMINIQUE;F;VOYNET;DOMINIQUE;;437
Présidentielles 1995 - 1er tour;Présidentielles;1995;1;;;35;LA GARENNE COLOMBES;92035;14104;3637;10467;225;10242;CHEMINADE JACQUES;M;CHEMINADE;JACQUES;;30
Présidentielles 1995 - 1er tour;Présidentielles;1995;1;;;36;GENNEVILLIERS;92036;19543;5563;13980;326;13654;CHEMINADE JACQUES;M;CHEMINADE;JACQUES;;21
Présidentielles 1995 - 1er tour;Présidentielles;1995;1;;;40;ISSY LES MOULINEAUX;92040;30054;8139;21915;444;21471;HUE ROBERT;M;HUE;ROBERT;;1563
Présidentielles 1995 - 1er tour;Présidentielles;1995;1;;;44;LEVALLOIS PERRET;92044;29477;6881;22596;402;22194;VOYNET DOMINIQUE;F;VOYNET;DOMINIQUE;;628
Présidentielles 1995 - 1er tour;Présidentielles;1995;1;;;63;RUEIL MALMAISON;92063;44438;10571;33867;718;33149;VILLIERS DE PHILIPPE;M;VILLIERS DE;PHILIPPE;;1413
Présidentielles 1995 - 1er tour;Présidentielles;1995;1;;;75;VANVES;92075;15499;3343;12156;236;11920;BALLADUR EDOUARD;M;BALLADUR;EDOUARD;;2183
Présidentielles 1995 - 1er tour;Présidentielles;1995;1;;;77;VILLE D'AVRAY;92077;7139;1490;5649;74;5575;VILLIERS DE PHILIPPE;M;VILLIERS DE;PHILIPPE;;242
Présidentielles 2002 - 2ème tour;Présidentielles;2002;2;;;20;CHATILLON;92020;18070;3136;14934;517;14417;LE PEN JEAN-MARIE;M;LE PEN;JEAN-MARIE;;1650
Présidentielles 2002 - 2ème tour;Présidentielles;2002;2;;;40;ISSY LES MOULINEAUX;92040;32093;5437;26656;863;25793;CHIRAC JACQUES;M;CHIRAC;JACQUES;;23083
Présidentielles 2002 - 2ème tour;Présidentielles;2002;2;;;46;MALAKOFF;92046;17268;3858;13410;529;12881;LE PEN JEAN-MARIE;M;LE PEN;JEAN-MARIE;;1519
Présidentielles 2002 - 2ème tour;Présidentielles;2002;2;;;51;NEUILLY SUR SEINE;92051;34164;5372;28792;508;28284;CHIRAC JACQUES;M;CHIRAC;JACQUES;;25051
Présidentielles 2002 - 2ème tour;Présidentielles;2002;2;;;62;PUTEAUX;92062;23868;4202;19666;726;18940;LE PEN JEAN-MARIE;M;LE PEN;JEAN-MARIE;;2634
Présidentielles 2002 - 2ème tour;Présidentielles;2002;2;;;64;SAINT CLOUD;92064;17822;3470;14352;330;14022;LE PEN JEAN-MARIE;M;LE PEN;JEAN-MARIE;;1792
Présidentielles 1995 - 2ème tour;Présidentielles;1995;2;;;23;CLAMART;92023;31217;7177;24040;1175;22865;CHIRAC JACQUES;M;CHIRAC;JACQUES;;12772
Présidentielles 1995 - 2ème tour;Présidentielles;1995;2;;;44;LEVALLOIS PERRET;92044;29477;5994;23483;907;22576;CHIRAC JACQUES;M;CHIRAC;JACQUES;;14628
Présidentielles 1995 - 2ème tour;Présidentielles;1995;2;;;46;MALAKOFF;92046;19489;5567;13922;872;13050;CHIRAC JACQUES;M;CHIRAC;JACQUES;;5562
Présidentielles 1995 - 2ème tour;Présidentielles;1995;2;;;63;RUEIL MALMAISON;92063;44424;8493;35931;1578;34353;JOSPIN LIONEL;M;JOSPIN;LIONEL;;12991
Présidentielles 1995 - 2ème tour;Présidentielles;1995;2;;;76;VAUCRESSON;92076;5527;921;4606;147;4459;JOSPIN LIONEL;M;JOSPIN;LIONEL;;1005
Présidentielles 1995 - 1er tour;Présidentielles;1995;1;;;4;ASNIERES SUR SEINE;92004;39050;10288;28762;594;28168;BALLADUR EDOUARD;M;BALLADUR;EDOUARD;;5352
Présidentielles 1995 - 1er tour;Présidentielles;1995;1;;;7;BAGNEUX;92007;20166;5090;15076;308;14768;BALLADUR EDOUARD;M;BALLADUR;EDOUARD;;1767
Législatives 2007 - 2ème tour;Législatives;2007;2;1;1ère circonscription;78;VILLENEUVE LA GARENNE;92078;13038;7480;5558;140;5418;MUZEAU Roland;M;MUZEAU;Roland;COM;2886
Présidentielles 2017 - 1er tour;Présidentielles;2017;1;;;2;ANTONY;92002;41488;6486;35002;776;34226;ASSELINEAU François;M;ASSELINEAU;François;;312
Présidentielles 2017 - 1er tour;Présidentielles;2017;1;;;2;ANTONY;92002;41488;6486;35002;776;34226;DUPONT-AIGNAN Nicolas;M;DUPONT-AIGNAN;Nicolas;;1168
Présidentielles 2017 - 1er tour;Présidentielles;2017;1;;;4;ASNIERES SUR SEINE;92004;48227;8578;39649;807;38842;DUPONT-AIGNAN Nicolas;M;DUPONT-AIGNAN;Nicolas;;892
Présidentielles 2017 - 1er tour;Présidentielles;2017;1;;;9;BOIS COLOMBES;92009;17896;3242;14654;318;14336;CHEMINADE Jacques;M;CHEMINADE;Jacques;;24
Présidentielles 2017 - 1er tour;Présidentielles;2017;1;;;9;BOIS COLOMBES;92009;17896;3242;14654;318;14336;LASSALLE Jean;M;LASSALLE;Jean;;84
Présidentielles 2017 - 1er tour;Présidentielles;2017;1;;;12;BOULOGNE BILLANCOURT;92012;77303;15227;62076;919;61157;ASSELINEAU François;M;ASSELINEAU;François;;501
Présidentielles 2017 - 1er tour;Présidentielles;2017;1;;;12;BOULOGNE BILLANCOURT;92012;77303;15227;62076;919;61157;LE PEN Marine;F;LE PEN;Marine;;3106
Présidentielles 2017 - 1er tour;Présidentielles;2017;1;;;20;CHATILLON;92020;22292;3682;18610;351;18259;ARTHAUD Nathalie;F;ARTHAUD;Nathalie;;71
Présidentielles 2017 - 1er tour;Présidentielles;2017;1;;;20;CHATILLON;92020;22292;3682;18610;351;18259;HAMON Benoît;M;HAMON;Benoît;;1569
Présidentielles 2017 - 1er tour;Présidentielles;2017;1;;;22;CHAVILLE;92022;13493;2042;11451;183;11267;MACRON Emmanuel;M;MACRON;Emmanuel;;4016
Présidentielles 2017 - 1er tour;Présidentielles;2017;1;;;23;CLAMART;92023;35291;6330;28961;560;28401;DUPONT-AIGNAN Nicolas;M;DUPONT-AIGNAN;Nicolas;;895
Présidentielles 2017 - 1er tour;Présidentielles;2017;1;;;24;CLICHY;92024;28553;5564;22989;498;22491;POUTOU Philippe;M;POUTOU;Philippe;;231
Présidentielles 2017 - 1er tour;Présidentielles;2017;1;;;25;COLOMBES;92025;47454;9714;37740;907;36833;DUPONT-AIGNAN Nicolas;M;DUPONT-AIGNAN;Nicolas;;955
Présidentielles 2017 - 1er tour;Présidentielles;2017;1;;;26;COURBEVOIE;92026;52391;9609;42782;817;41965;MACRON Emmanuel;M;MACRON;Emmanuel;;14624
Présidentielles 2017 - 1er tour;Présidentielles;2017;1;;;26;COURBEVOIE;92026;52391;9609;42782;817;41965;POUTOU Philippe;M;POUTOU;Philippe;;216
Présidentielles 2017 - 1er tour;Présidentielles;2017;1;;;33;GARCHES;92033;12767;1975;10792;194;10598;MACRON Emmanuel;M;MACRON;Emmanuel;;3314
Présidentielles 2017 - 1er tour;Présidentielles;2017;1;;;33;GARCHES;92033;12767;1975;10792;194;10598;POUTOU Philippe;M;POUTOU;Philippe;;43
Présidentielles 2017 - 1er tour;Présidentielles;2017;1;;;35;LA GARENNE COLOMBES;92035;18828;3121;15707;289;15418;ARTHAUD Nathalie;F;ARTHAUD;Nathalie;;48
Présidentielles 2017 - 1er tour;Présidentielles;2017;1;;;35;LA GARENNE COLOMBES;92035;18828;3121;15707;289;15418;LE PEN Marine;F;LE PEN;Marine;;1226
Présidentielles 2017 - 1er tour;Présidentielles;2017;1;;;36;GENNEVILLIERS;92036;22149;5526;16623;490;16133;LASSALLE Jean;M;LASSALLE;Jean;;92
Présidentielles 2017 - 1er tour;Présidentielles;2017;1;;;40;ISSY LES MOULINEAUX;92040;46800;9050;37750;728;37022;LASSALLE Jean;M;LASSALLE;Jean;;195
Présidentielles 2017 - 1er tour;Présidentielles;2017;1;;;46;MALAKOFF;92046;18434;3186;15248;268;14979;ASSELINEAU François;M;ASSELINEAU;François;;167
Présidentielles 2017 - 1er tour;Présidentielles;2017;1;;;63;RUEIL MALMAISON;92063;54426;9298;45128;713;44414;MÉLENCHON Jean-Luc;M;MÉLENCHON;Jean-Luc;;6132
Présidentielles 2017 - 1er tour;Présidentielles;2017;1;;;71;SCEAUX;92071;15052;2914;12138;145;11993;LE PEN Marine;F;LE PEN;Marine;;612
Présidentielles 2017 - 1er tour;Présidentielles;2017;1;;;72;SEVRES;92072;15142;2166;12976;213;12763;MACRON Emmanuel;M;MACRON;Emmanuel;;4639
Présidentielles 2017 - 1er tour;Présidentielles;2017;1;;;76;VAUCRESSON;92076;6176;835;5341;72;5269;ARTHAUD Nathalie;F;ARTHAUD;Nathalie;;2
Présidentielles 2017 - 1er tour;Présidentielles;2017;1;;;77;VILLE D'AVRAY;92077;7433;837;6596;89;6507;MACRON Emmanuel;M;MACRON;Emmanuel;;2348
Présidentielles 2012 - 1er tour;Présidentielles;2012;1;;;19;CHATENAY MALABRY;92019;17914;3466;14448;325;14123;DUPONT-AIGNAN Nicolas;M;DUPONT-AIGNAN;Nicolas;;213
Présidentielles 2012 - 1er tour;Présidentielles;2012;1;;;20;CHATILLON;92020;21656;4298;17358;265;17093;HOLLANDE François;M;HOLLANDE;François;;5805
Présidentielles 2012 - 1er tour;Présidentielles;2012;1;;;24;CLICHY;92024;29226;6786;22440;374;22066;LE PEN Marine;F;LE PEN;Marine;;1993
Présidentielles 2012 - 1er tour;Présidentielles;2012;1;;;26;COURBEVOIE;92026;50576;11277;39299;681;38618;BAYROU François;M;BAYROU;François;;4571
Présidentielles 2012 - 1er tour;Présidentielles;2012;1;;;32;FONTENAY AUX ROSES;92032;15217;3289;11928;161;11767;BAYROU François;M;BAYROU;François;;1376
Présidentielles 2012 - 1er tour;Présidentielles;2012;1;;;33;GARCHES;92033;12388;2501;9887;167;9720;JOLY Eva;F;JOLY;Eva;;204
Présidentielles 2012 - 1er tour;Présidentielles;2012;1;;;36;GENNEVILLIERS;92036;20990;5264;15726;342;15384;JOLY Eva;F;JOLY;Eva;;307
Présidentielles 2012 - 1er tour;Présidentielles;2012;1;;;50;NANTERRE;92050;44307;10435;33872;654;33218;LE PEN Marine;F;LE PEN;Marine;;3546
Présidentielles 2012 - 1er tour;Présidentielles;2012;1;;;60;LE PLESSIS ROBINSON;92060;18767;3621;15146;260;14886;JOLY Eva;F;JOLY;Eva;;346
Présidentielles 2012 - 1er tour;Présidentielles;2012;1;;;60;LE PLESSIS ROBINSON;92060;18767;3621;15146;260;14886;ARTHAUD Nathalie;F;ARTHAUD;Nathalie;;50
Présidentielles 2012 - 1er tour;Présidentielles;2012;1;;;77;VILLE D'AVRAY;92077;7132;1060;6072;80;5992;CHEMINADE Jacques;M;CHEMINADE;Jacques;;7
Présidentielles 2017 - 2ème tour;Présidentielles;2017;2;;;26;COURBEVOIE;92026;52391;12550;39841;3469;36372;LE PEN Marine;F;LE PEN;Marine;;5135
Présidentielles 2017 - 2ème tour;Présidentielles;2017;2;;;33;GARCHES;92033;12767;2732;10035;916;9119;LE PEN Marine;F;LE PEN;Marine;;1349
Présidentielles 2017 - 2ème tour;Présidentielles;2017;2;;;50;NANTERRE;92050;47571;13323;34248;3029;31219;MACRON Emmanuel;M;MACRON;Emmanuel;;25960
Présidentielles 2017 - 2ème tour;Présidentielles;2017;2;;;72;SEVRES;92072;15143;2971;12172;998;11174;LE PEN Marine;F;LE PEN;Marine;;1341
Présidentielles 2012 - 2ème tour;Présidentielles;2012;2;;;36;GENNEVILLIERS;92036;20990;4770;16220;758;15462;HOLLANDE François;M;HOLLANDE;François;;11850
Présidentielles 2012 - 2ème tour;Présidentielles;2012;2;;;78;VILLENEUVE LA GARENNE;92078;12332;3034;9298;486;8812;HOLLANDE François;M;HOLLANDE;François;;5914
Présidentielles 2007 - 2ème tour;Présidentielles;2007;2;;;26;COURBEVOIE;92026;48313;7148;41165;1673;39492;ROYAL Ségolène;F;ROYAL;Ségolène;;15345
Présidentielles 2007 - 2ème tour;Présidentielles;2007;2;;;33;GARCHES;92033;11961;1553;10408;396;10012;SARKOZY Nicolas;M;SARKOZY;Nicolas;;7010
Législatives 2007 - 1er tour;Législatives;2007;1;2;2ème circonscription;4;ASNIERES SUR SEINE;92004;44110;17783;26327;312;26015;POURBAGHER Francis;M;POURBAGHER;Francis;DVD;647
Législatives 2007 - 1er tour;Législatives;2007;1;11;11ème circonscription;7;BAGNEUX;92007;20520;8538;11982;178;11804;GALATEAU Marie-Thérèse;F;GALATEAU;Marie-Thérèse;EXD;88
Législatives 2007 - 1er tour;Législatives;2007;1;4;4ème circonscription;50;NANTERRE;92050;42631;18721;23910;314;23596;BOUKHEDIMI Yvonne;F;BOUKHEDIMI;Yvonne;EXG;59
Législatives 2007 - 1er tour;Législatives;2007;1;8;8ème circonscription;48;MEUDON;92048;25427;9683;15744;202;15542;BLANCHARD Luc;M;BLANCHARD;Luc;VEC;635
Législatives 2007 - 1er tour;Législatives;2007;1;5;5ème circonscription;44;LEVALLOIS PERRET;92044;39466;14724;24742;404;24338;BALKANY Patrick;M;BALKANY;Patrick;UMP;13328
Législatives 2007 - 1er tour;Législatives;2007;1;11;11ème circonscription;46;MALAKOFF;92046;18478;7045;11433;204;11229;METTON Jean-Loup;M;METTON;Jean-Loup;MAJ;2855
Législatives 2007 - 1er tour;Législatives;2007;1;12;12ème circonscription;32;FONTENAY AUX ROSES;92032;15468;5605;9863;84;9779;ANTZENBERGER Philippe;M;ANTZENBERGER;Philippe;EXG;218
Législatives 2007 - 1er tour;Législatives;2007;1;3;3ème circonscription;26;COURBEVOIE;92026;49151;19345;29806;541;29265;KOSSOWSKI Jacques;M;KOSSOWSKI;Jacques;UMP;17108
Législatives 2007 - 1er tour;Législatives;2007;1;7;7ème circonscription;33;GARCHES;92033;12286;4601;7685;112;7573;INDJIAN Patrick;M;INDJIAN;Patrick;DVG;20
Législatives 2007 - 1er tour;Législatives;2007;1;12;12ème circonscription;20;CHATILLON;92020;20661;7083;13578;137;13441;DELMATTO Geneviève;F;DELMATTO;Geneviève;EXD;51
Législatives 2007 - 1er tour;Législatives;2007;1;8;8ème circonscription;22;CHAVILLE;92022;12928;4682;8246;120;8126;FILLOUX Delphine;F;FILLOUX;Delphine;DIV;94
Législatives 2007 - 1er tour;Législatives;2007;1;8;8ème circonscription;22;CHAVILLE;92022;12928;4682;8246;120;8126;DEQUEANT Annie;F;DEQUEANT;Annie;FN;247
Législatives 2007 - 1er tour;Législatives;2007;1;5;5ème circonscription;24;CLICHY;92024;28799;12380;16419;297;16122;REBATO Stéphanie;F;REBATO;Stéphanie;DIV;76
Législatives 2007 - 1er tour;Législatives;2007;1;1;1ère circonscription;25;COLOMBES;92025;26192;12273;13919;366;13553;DARRACQ Michel;M;DARRACQ;Michel;DIV;8
Législatives 2007 - 1er tour;Législatives;2007;1;5;5ème circonscription;24;CLICHY;92024;28799;12380;16419;297;16122;GOUDAL Emilie;F;GOUDAL;Emilie;EXG;532
Législatives 2007 - 1er tour;Législatives;2007;1;6;6ème circonscription;62;PUTEAUX;92062;26791;8829;17962;396;17566;CORTI Martine;F;CORTI;Martine;ECO;162
Législatives 2007 - 1er tour;Législatives;2007;1;1;1ère circonscription;78;VILLENEUVE LA GARENNE;92078;13038;7211;5827;131;5696;BRETON Michel;M;BRETON;Michel;EXG;57
Législatives 1993 - 1er tour;Législatives;1993;1;1;1ère circonscription;36;GENNEVILLIERS;92036;19185;6818;12367;395;11972;PREVOT ROGER;M;PREVOT;ROGER;UDF;1626
Législatives 1993 - 1er tour;Législatives;1993;1;1;1ère circonscription;36;GENNEVILLIERS;92036;19185;6818;12367;395;11972;PREVOT ALAIN;M;PREVOT;ALAIN;DIV;174
Législatives 1993 - 1er tour;Législatives;1993;1;12;12ème circonscription;32;FONTENAY AUX ROSES;92032;15091;4963;10128;341;9787;GRIELEN ALAIN;M;GRIELEN;ALAIN;MAJ;287
Législatives 1993 - 1er tour;Législatives;1993;1;3;3ème circonscription;26;COURBEVOIE;92026;34737;9916;24821;828;23993;POYER DIDIER;M;POYER;DIDIER;DVD;120
Législatives 1993 - 1er tour;Législatives;1993;1;8;8ème circonscription;77;VILLE D'AVRAY;92077;7199;1786;5413;149;5264;FIEVET ALAIN;M;FIEVET;ALAIN;SOC;32
Législatives 1993 - 1er tour;Législatives;1993;1;2;2ème circonscription;25;COLOMBES;92025;18324;5870;12454;434;12020;LE GUERNEVE SERGE;M;LE GUERNEVE;SERGE;COM;1216
Législatives 1993 - 1er tour;Législatives;1993;1;1;1ère circonscription;25;COLOMBES;92025;26594;9512;17082;693;16389;MOURRE DOMINIQUE;M;MOURRE;DOMINIQUE;EXG;153
Législatives 1993 - 2ème tour;Législatives;1993;2;10;10ème circonscription;12;BOULOGNE BILLANCOURT;92012;4523;2047;2476;163;2313;SANTINI ANDRE;M;SANTINI;ANDRE;UDF;1310
Législatives 1993 - 1er tour;Législatives;1993;1;11;11ème circonscription;49;MONTROUGE;92049;22632;7554;15078;554;14524;MACHEREY MONIQUE;F;MACHEREY;MONIQUE;GEC;1429
Législatives 1993 - 1er tour;Législatives;1993;1;8;8ème circonscription;48;MEUDON;92048;25126;7628;17498;529;16969;GUILLET J.JACQUES;M;GUILLET;J.JACQUES;RPR;4732
Législatives 1993 - 1er tour;Législatives;1993;1;10;10ème circonscription;48;MEUDON;92048;4225;1396;2829;92;2737;WALLE JOCELYNE;F;WALLE;JOCELYNE;DIV;79
Législatives 1993 - 1er tour;Législatives;1993;1;8;8ème circonscription;76;VAUCRESSON;92076;5515;1574;3941;93;3848;MARGUERITES HARRY;M;MARGUERITES;HARRY;MAJ;11
Législatives 1993 - 1er tour;Législatives;1993;1;6;6ème circonscription;62;PUTEAUX;92062;23271;6636;16635;697;15938;GARCIA ACEBEDO NADINE;F;GARCIA ACEBEDO;NADINE;COM;950
Législatives 1993 - 1er tour;Législatives;1993;1;2;2ème circonscription;4;ASNIERES SUR SEINE;92004;37314;11544;25770;852;24918;MONEL MARTINE;F;MONEL;MARTINE;DIV;710
Législatives 1993 - 1er tour;Législatives;1993;1;8;8ème circonscription;22;CHAVILLE;92022;12345;3904;8441;296;8145;JASSERAND BERNARD;M;JASSERAND;BERNARD;COM;540
Législatives 1993 - 1er tour;Législatives;1993;1;1;1ère circonscription;36;GENNEVILLIERS;92036;19185;6818;12367;395;11972;GUICHARROUSSE HUBERT;M;GUICHARROUSSE;HUBERT;VEC;666
Législatives 1993 - 1er tour;Législatives;1993;1;6;6ème circonscription;51;NEUILLY SUR SEINE;92051;35806;10146;25660;620;25040;BLANCHARD MICHEL;M;BLANCHARD;MICHEL;DIV;278
Législatives 1993 - 1er tour;Législatives;1993;1;6;6ème circonscription;51;NEUILLY SUR SEINE;92051;35806;10146;25660;620;25040;GRANGER J.MICHEL;M;GRANGER;J.MICHEL;DVD;0
Législatives 1993 - 1er tour;Législatives;1993;1;4;4ème circonscription;50;NANTERRE;92050;38007;11484;26523;795;25728;KERSUZAN NICOLE;F;KERSUZAN;NICOLE;DIV;742
Législatives 1993 - 1er tour;Législatives;1993;1;5;5ème circonscription;44;LEVALLOIS PERRET;92044;27392;7486;19906;624;19282;CATOIRE GILLES;M;CATOIRE;GILLES;SOC;2953
Législatives 1993 - 2ème tour;Législatives;1993;2;8;8ème circonscription;77;VILLE D'AVRAY;92077;7197;3404;3793;1026;2767;GUILLET J.JACQUES;M;GUILLET;J.JACQUES;RPR;2767
Législatives 2012 - 1er tour;Législatives;2012;1;13;13ème circonscription;2;ANTONY;92002;40941;15088;25853;361;25492;DEVEDJIAN Patrick;M;DEVEDJIAN;Patrick;UMP;10517
Législatives 2012 - 1er tour;Législatives;2012;1;2;2ème circonscription;4;ASNIERES SUR SEINE;92004;45114;18545;26569;310;26259;POURBAGHER Francis;M;POURBAGHER;Francis;DVD;345
Législatives 2012 - 1er tour;Législatives;2012;1;3;3ème circonscription;9;BOIS COLOMBES;92009;16783;6763;10020;331;9689;NATUREL Adélaïde;F;NATUREL;Adélaïde;FG;388
Législatives 2012 - 1er tour;Législatives;2012;1;9;9ème circonscription;12;BOULOGNE BILLANCOURT;92012;61020;24579;36441;340;36101;BOUKTIT Sofiane;M;BOUKTIT;Sofiane;AUT;87
Législatives 2012 - 1er tour;Législatives;2012;1;10;10ème circonscription;12;BOULOGNE BILLANCOURT;92012;6600;2912;3688;126;3562;GAMBIEZ Fabienne;F;GAMBIEZ;Fabienne;CEN;105
Législatives 2012 - 1er tour;Législatives;2012;1;13;13ème circonscription;14;BOURG LA REINE;92014;13305;4436;8869;87;8782;CADORET Mannone;M;CADORET;Mannone;AUT;26
Législatives 2012 - 1er tour;Législatives;2012;1;13;13ème circonscription;14;BOURG LA REINE;92014;13305;4436;8869;87;8782;THIRIEZ Duncan;M;THIRIEZ;Duncan;AUT;86
Législatives 2012 - 1er tour;Législatives;2012;1;12;12ème circonscription;20;CHATILLON;92020;21681;8265;13416;122;13294;GERMAIN Jean-Marc;M;GERMAIN;Jean-Marc;SOC;5312
Législatives 2012 - 1er tour;Législatives;2012;1;8;8ème circonscription;22;CHAVILLE;92022;12808;4688;8120;75;8045;BOUCHARD Renaud;M;BOUCHARD;Renaud;DVD;1
Législatives 2012 - 1er tour;Législatives;2012;1;2;2ème circonscription;25;COLOMBES;92025;18458;7115;11343;114;11229;GOISET Philippe;M;GOISET;Philippe;EXG;34
Législatives 2012 - 1er tour;Législatives;2012;1;2;2ème circonscription;25;COLOMBES;92025;18458;7115;11343;114;11229;BENTEBRA Mohamed;M;BENTEBRA;Mohamed;ECO;71
Législatives 2012 - 1er tour;Législatives;2012;1;1;1ère circonscription;36;GENNEVILLIERS;92036;20795;10523;10272;192;10080;LE GAL Anna;F;LE GAL;Anna;ECO;93
Législatives 2012 - 1er tour;Législatives;2012;1;8;8ème circonscription;48;MEUDON;92048;25002;9709;15293;150;15143;HENIQUE Philippe;M;HENIQUE;Philippe;EXG;44
Législatives 2012 - 1er tour;Législatives;2012;1;6;6ème circonscription;51;NEUILLY SUR SEINE;92051;37031;14672;22359;177;22182;NEKKAZ Rachid;M;NEKKAZ;Rachid;DVG;0
Législatives 2012 - 1er tour;Législatives;2012;1;12;12ème circonscription;60;LE PLESSIS ROBINSON;92060;18785;6274;12511;101;12410;LARCHER Robert;M;LARCHER;Robert;EXG;41
Législatives 2012 - 1er tour;Législatives;2012;1;12;12ème circonscription;60;LE PLESSIS ROBINSON;92060;18785;6274;12511;101;12410;BIERENT Rudolph;M;BIERENT;Rudolph;AUT;13
Législatives 2012 - 1er tour;Législatives;2012;1;7;7ème circonscription;63;RUEIL MALMAISON;92063;52518;20526;31992;298;31694;BARRE Camille;F;BARRE;Camille;FG;997
Législatives 2012 - 1er tour;Législatives;2012;1;7;7ème circonscription;63;RUEIL MALMAISON;92063;52518;20526;31992;298;31694;OLLIER Patrick;M;OLLIER;Patrick;UMP;14452
Législatives 2012 - 1er tour;Législatives;2012;1;7;7ème circonscription;64;SAINT CLOUD;92064;19029;7431;11598;97;11501;CHAUDON Anne-Laure;F;CHAUDON;Anne-Laure;EXG;16
Législatives 2012 - 1er tour;Législatives;2012;1;13;13ème circonscription;71;SCEAUX;92071;14395;5253;9142;70;9072;DEBISSCHOP Magalie;F;DEBISSCHOP;Magalie;EXG;25
Législatives 2012 - 1er tour;Législatives;2012;1;13;13ème circonscription;71;SCEAUX;92071;14395;5253;9142;70;9072;DE LAMBILLY Gaëtan;M;DE LAMBILLY;Gaëtan;DVD;76
Législatives 2012 - 1er tour;Législatives;2012;1;4;4ème circonscription;73;SURESNES;92073;26492;10723;15769;302;15467;BOUKHEDIMI Yvonne;F;BOUKHEDIMI;Yvonne;EXG;19
Législatives 2012 - 1er tour;Législatives;2012;1;4;4ème circonscription;73;SURESNES;92073;26492;10723;15769;302;15467;SCHOUMAKER Aurélien;M;SCHOUMAKER;Aurélien;EXG;27
Législatives 2012 - 1er tour;Législatives;2012;1;4;4ème circonscription;73;SURESNES;92073;26492;10723;15769;302;15467;HARE Marie-Claire;F;HARE;Marie-Claire;ECO;63
Législatives 2012 - 1er tour;Législatives;2012;1;4;4ème circonscription;73;SURESNES;92073;26492;10723;15769;302;15467;ROSENBLATT Emmanuelle;F;ROSENBLATT;Emmanuelle;DVD;75
Législatives 2012 - 1er tour;Législatives;2012;1;8;8ème circonscription;76;VAUCRESSON;92076;6093;2463;3630;39;3591;LIME-BIFFE Catherine;F;LIME-BIFFE;Catherine;SOC;680
Législatives 2012 - 1er tour;Législatives;2012;1;8;8ème circonscription;76;VAUCRESSON;92076;6093;2463;3630;39;3591;CASTERA Stéphane;M;CASTERA;Stéphane;AUT;24
Législatives 2012 - 1er tour;Législatives;2012;1;8;8ème circonscription;77;VILLE D'AVRAY;92077;7169;2468;4701;48;4653;CHETAILLE Romain;M;CHETAILLE;Romain;DVD;341
Législatives 2002 - 1er tour;Législatives;2002;1;2;2ème circonscription;4;ASNIERES SUR SEINE;92004;44110;17783;26327;312;26015;TRUPIN Laurent;M;TRUPIN;Laurent;UDFD;2648
Législatives 2002 - 1er tour;Législatives;2002;1;11;11ème circonscription;7;BAGNEUX;92007;20520;8538;11982;178;11804;TEIXEIRA Dominique;M;TEIXEIRA;Dominique;EXG;52
Législatives 2002 - 1er tour;Législatives;2002;1;11;11ème circonscription;7;BAGNEUX;92007;20520;8538;11982;178;11804;KADRI Malika;F;KADRI;Malika;DIV;103
Législatives 2002 - 1er tour;Législatives;2002;1;10;10ème circonscription;12;BOULOGNE BILLANCOURT;92012;5551;2367;3184;78;3106;VENTURINI Jean-Michel;M;VENTURINI;Jean-Michel;DIV;7
Législatives 2002 - 1er tour;Législatives;2002;1;8;8ème circonscription;22;CHAVILLE;92022;12928;4682;8246;120;8126;ROY Caroline;F;ROY;Caroline;RDG;2073
Législatives 2002 - 1er tour;Législatives;2002;1;12;12ème circonscription;23;CLAMART;92023;32916;11487;21429;154;21275;ZANOLIN Ludovic;F;ZANOLIN;Ludovic;COM;383
